abduzir	crime/ofensa
absorção	quimica/química
acta	jurisprudência/lei
actuar	dramaturgia/teatro
acusado	jurisprudência/lei
adoção	jurisprudência/jurisprudência/lei/lei
adquirir	comercialismo/mercantilismo/comércio
advogado	jurisprudência/lei
advogar	jurisprudência/lei
alistamento	exército
amputar	incisão/medicina/medicina/remédio
angústia	psicopatologia/psicopatologias/psiquiatria
anistia	jurisprudência/lei
ansiedade	psicopatologia/psicopatologias/psiquiatria
apagar	gravação
aprisionar	jurisprudência/lei
arapuca	criatura/animal/besta/bicho/ser
argüido	jurisprudência/lei
armada	exército
armadilha	criatura/animal/besta/bicho/ser
articulação	anatomia
articulações	anatomia
ascender	astronomia/astronomia
assento	dramaturgia/aeroplano/avião/teatro
assédio	exército
ataque	exército
atestar	jurisprudência/lei
atingir	comercialismo/mercantilismo/comércio
ato	jurisprudência/lei
atractivo	drama
atuar	dramaturgia/teatro
aumentar	fotografia
autoridades	governação/governo/administração
baixa	exército
bancarrota	jurisprudência/lei
batalha	exército/exército
bater	culinária/cozinha/preparação
bombardeiro	exército
cadeia	industria/empresa/negócio/comércio
cadeira	dramaturgia/aeroplano/avião/teatro
calculadora	informática
caminhar	esporte
campanha	exército
canal	rio
cantar	música
capitão	exército
casal	jurisprudência/lei
casamento	jurisprudência/lei
causa	jurisprudência/jurisprudência/lei/lei
cavalo	xadrez
cepa	biologia
cerco	exército
chamar	telefonia
chinês	industria/empresa/negócio/arte/comércio
cine	industria/empresa/negócio/arte/comércio
cinema	industria/empresa/negócio/arte/comércio
civilização	arqueologia/arqueologia/política
clima	meteorologia/meteorologia
coima	jurisprudência/lei
coluna	arquitetura/arquitetura/arquitectura/arquitectura
combate	exército/exército
comercializar	comercialismo/mercantilismo/comércio
cometa	astronomia/astronomia
cometas	astronomia/astronomia
compor	música
comprar	comercialismo/mercantilismo/comércio
computador	informática
condenar	jurisprudência/lei
condutas	anatomia
conjuração	política
conscrição	exército
conspiração	política
constituição	jurisprudência/lei
construir	edificação/construção
consumo	economia
contagem	eleição
contradição	lógica
contrato	jurisprudência/lei
conúbio	jurisprudência/lei
corpo	criatura/animal/besta/bicho/humano/ser
costela	vertebrado
costume	psicologia
crescimento	biologia
cronista	história/história
cruza	genetica/genética/genética
crónica	história/história
crônica	história/história
cultivar	flora/planta/vegetal
cultura	arqueologia/arqueologia/biologia
curador	jurisprudência/lei
curar	incisão/medicina/medicina/remédio
curva	rio
célula	biologia
código	informática
dançar	dança/baile
decreto	jurisprudência/lei
deletar	gravação
demonstração	matematica/matemática/lógica
dependência	narcótico
descer	astronomia/astronomia
desenhar	arte
desvio	aeroplano/avião/embarcação/navios/navio/barco
direito	jurisprudência/lei
dirigir	condução
divorcio	jurisprudência/lei
divórcio	jurisprudência/lei
domar	flora/planta/vegetal
domesticar	flora/planta/vegetal
dono	jurisprudência/lei
dopar	incisão/medicina/medicina/remédio
drogar	incisão/medicina/medicina/remédio
duradouro	biologia
empenhar	comercialismo/mercantilismo/comércio
emprisonar	jurisprudência/lei
encarcerar	jurisprudência/lei
engaiolar	jurisprudência/lei
ensaio	concertos/concerto/show
equaçao	matematica/matemática
equação	matematica/matemática
equações	matematica/matemática
erigir	edificação/construção
escavação	arqueologia/arqueologia
escrever	música
espião	exército
espécie	biologia/biologia
espécies	biologia
estacionar	condução
estirpe	biologia
evidenciar	jurisprudência/lei
evidência	matematica/matemática/lógica
evolução	biologia/biologia
exportar	comercialismo/mercantilismo/comércio
exposição	arte
exposições	arte
fadiga	psicologia
falência	jurisprudência/lei
fazer	dramaturgia/agricultura/pecuária/cultivo/teatro
federal	governação/governo/administração
federativo	governação/governo/administração
fiança	jurisprudência/lei
filogenia	biologia
filogênese	biologia
filósofo	filosofia
flora	planta/vegetal/botanica/botânica/botânica
formatação	calculadora/computador
formato	calculadora/computador
fronte	meteorologia/meteorologia
função	matematica/matemática
fórmula	matematica/matemática
galáxia	astronomia/astronomia
gene	genetica/genética/genética
general	exército
genes	genetica/genetica/genética/genética/genética/genética
governo	governação/administração
gramática	lingüística/linguística/lingüística
gravidade	física
gravitação	física
gregário	criatura/animal/besta/bicho/ser
guen	genetica/genética/genética
hardware	informática
historiador	história/história
historiografo	história/história
hábito	psicologia
híbrido	genetica/genética/genética
igreja	serviço
igrejas	serviço
importar	comercialismo/mercantilismo/comércio
impressora	informática
incarcerar	jurisprudência/lei
inferno	religião/fé
informática	calculadora/computador
inibição	psicologia
inimigo	exército
instructor	canção/canto
isotropia	física
iteração	informática
jogada	jogo
judiciário	jurisprudência/lei
juiz	esporte
julgamento	jurisprudência/jurisprudência/lei/lei
jurisdição	jurisprudência/lei
jurista	jurisprudência/lei
juízo	jurisprudência/lei
legislação	jurisprudência/lei
licenciamentos	jurisprudência/lei
licença	jurisprudência/lei
litígio	jurisprudência/lei
lugar	dramaturgia/aeroplano/avião/teatro
luta	exército
maior	jurisprudência/lei
maioria	eleição
mandado	jurisprudência/lei
manifestação	política
manobra	exército
marcha	exército
marinha	exército
matematica	ciência
matemática	ciência
matrimónio	jurisprudência/lei
matrimônio	jurisprudência/lei
matriz	matematica/matemática
matrizes	matematica/matemática
menu	informática
mesquita	islamismo/islamismo
mesquitas	islamismo
mestiço	genetica/genética/genética
molecular	psicologia
molécula	quimica/física/química
mostrar	jurisprudência/lei
multa	jurisprudência/lei
multiplicar	aritmética/aritmética
murro	boxe/pugilismo
musico	música
mutação	genetica/genetica/genética/genética/genética/genética
média	estatística/estatísticas/estatística
músico	música/música
narcotizar	incisão/medicina/medicina/remédio
naturalizar	flora/planta/vegetal
nebulosa	astronomia/astronomia
norma	estatística/estatísticas/estatística
nítido	meteorologia/meteorologia
obter	comercialismo/mercantilismo/comércio
oferecer	almoeda/arrematação/hasta/leilão
ontogenia	biologia
ontogénese	biologia
operação	cirurgia/exército
oral	anatomia
paradoxo	lógica
parentesco	antropologia/antropologia
passageiro	auto/autocarro/batel/caminhos-de-ferro/ônibus/aeroplano/automóvel/bote/escaler/locomotivas/avião/trem/viatura/barco/carro/comboio/veículo
passaporte	jurisprudência/lei
passaportes	jurisprudência/lei
passear	esporte
pastar	criatura/animal/besta/bicho/ser
patinar	esporte
perdão	jurisprudência/lei
pilar	arquitetura/arquitectura
piloto	aeronave/aeroplano/avião
pincelar	arte
pintar	arte
plagiar	crime/ofensa
planeta	astronomia/astronomia
planta	botanica/botânica/botânica
plantar	agricultura/pecuária/cultivo
pleitear	jurisprudência/lei
pleito	jurisprudência/lei
preceptor	canção/canto
pregação	serviço
prender	jurisprudência/lei
preparação	exército
processo	jurisprudência/jurisprudência/jurisprudência/lei/lei/lei
produzir	agricultura/pecuária/cultivo
programa	informática/informática
prontidão	exército
proposição	lógica
proprietário	jurisprudência/lei
prova	matematica/matemática/lógica
provar	jurisprudência/lei
prédica	serviço
pôr	astronomia/astronomia
quadrado	geometria/geometria
querelante	jurisprudência/lei
raiz	botanica/botânica/botânica
rapidez	exército
raptar	crime/ofensa
raíz	botanica/botânica/botânica
reactor	física
reactores	física
reação	mecânica/mecânica
rede	criatura/animal/besta/bicho/ser/broadcast/broadcast
regime	governação/governo/administração
registro	jurisprudência/lei
regra	matematica/matemática
rei	xadrez
relação	antropologia/antropologia
remir	crime/ofensa
repetição	informática
representar	dramaturgia/teatro
resgatar	crime/ofensa
rápido	música
réu	jurisprudência/lei
sacrificio	criatura/animal/besta/bicho/ser
sacrifício	criatura/animal/besta/bicho/ser
sanar	incisão/medicina/medicina/remédio
sangue	vertebrado/vertebrado
sarar	incisão/medicina/medicina/remédio
semear	agricultura/pecuária/cultivo
sentença	jurisprudência/lei
sequestrar	crime/ofensa
seqüestrar	crime/ofensa
sermão	serviço
signo	astrologia/astrologia
soco	boxe/pugilismo
software	informática
stress	psicologia
subir	astronomia/astronomia
submundo	religião/fé
sufrágio	jurisprudência/lei
suspeito	jurisprudência/lei
sítio	exército
tanque	exército
tanques	exército
teatro	drama
tecer	artesanato
telefonar	telefonia
televisor	tv/televisão/tevê
televisão	tv/tv/tevê/tevê
tema	música
templo	serviço
tempo	meteorologia/meteorologia
tensão	psicologia
terrorista	terrorismo
testamento	jurisprudência/lei
testemunha	jurisprudência/lei
testemunhar	jurisprudência/lei
testificar	jurisprudência/lei
tevê	tv/tv/televisão/televisão
teórico	ciência/arte
tocar	música
tracção	auto/automóvel/viatura/carro/veículo
transmitir	radiodifusão
tração	auto/automóvel/viatura/carro/veículo
tricotar	artesanato
trilha	informática
tubo	anatomia
tumores	patologia
tutor	canção/canto
tv	televisão/tevê
título	jurisprudência/lei
túnel	auto/automóvel/viatura/carro/veículo
urdir	artesanato
variante	biologia
vegetal	botanica/botânica/botânica
vegetação	flora/planta/vegetal
velejar	pilotagem/navegação
vender	comercialismo/mercantilismo/comércio
veredicto	jurisprudência/lei
veredito	jurisprudência/lei
voto	jurisprudência/lei
vírus	virologia/virologia
xeque	xadrez
árbitro	esporte
átomo	quimica/física/química

