abadia	monastério/mosteiro/convento
abanar	sacudir/tremer/agitar
abatimento	alteração/modificação/redução/variação/diminuição/mudança
aboboreira	verdura/hortaliça/legume/vegetal
aborrecer	agastar/aporrinhar/vexar/chatear/amolar/molestar/importunar/perturbar/irritar/incomodar
aborto	abortação/abortamento
abranger	abarcar/incluir/conter
abreviar	reduzir/diminuir
abrigo	alojamento/edifício/tecido/estrutura/casa
abusar	tratar
abóbora	verdura/hortaliça/legume/vegetal
acalmar	consolar/reconfortar/confortar/aliviar
acampamento	locação/sítio/lugar
acatar	obedecer
aceitar	aturar/tolerar/consentir/aguentar/permitir/suportar/deixar
aceitação	aprovaçã0/aprovação
acender	queimar
aceno	sinal
acepção	significância/significação/significado/intenção
acertar	modificar/alterar/mudar
achado	epifania/insight/lampejo
acocorar	sentar-se/sentar
acocorar-se	sentar-se/sentar
acompanhar	viajar/caminhar/ir/andar
acontecer	transmutar/transformar/mudar
acorde	tom/nota
acordes	tom/nota
acordo	consenso
acréscimo	incremento/crescimento/aumento
actor	intérprete
actuar	desempenhar/apresentar/fazer
acumular	dispor/arranjar/reter/guardar/segurar/manter
acumulação	incremento/acréscimo/crescimento/aumento
acusar	clamar/declarar
acusação	asserção
acúmulo	colecção/coleção/aglomeração
adicionar	enumerar/contar
adivinhar	aventurar/supor/pretender
adição	componente/parte
adjudicar	resolver/decidir
administrador	líder/gerente/cabeça/chefe/liderança/responsável
admirar	prezar/respeitar/venerar
admitir	consentir/permitir/deixar
adopção	aprovaçã0/aprovação
adoção	aprovaçã0/aprovação
adquirir	comprar/obter/receber
adulto	alguém/indivíduo/alma/pessoa
adversário	alguém/indivíduo/alma/pessoa
advogado	alguém/indivíduo/alma/pessoa/profissional
afagar	tratar/tocar/bater
aferroar	lesionar/lesar/ferir/machucar
afetar	modificar/alterar/mudar
aficionado	alguém/indivíduo/alma/pessoa
afinar	acertar/ajustar/corrigir
afinidade	atratividade/atração
afirmação	asserção
afogar	perecer/falecer/expirar/morrer
afogar-se	perecer/falecer/expirar/morrer
agachar	sentar-se/sentar
agarrar	capturar/segurar/pegar
agavelar	dispor/arranjar
agenda	listagem/lista
agente	representante
agitar	deslocar/mover/mexer
agonia	dor/tormento/tortura/angústia/martírio/dor
agouro	mensagem/comunicação
aguentar	virar-se/consentir/lidar/sobreviver/permitir/deixar
ajuda	dádiva/auxílio/brinde/dom/socorro/doação/assistência/presente
ajudante	trabalhador
ajudar	acorrer/socorrer/assistir/auxiliar
ajustar	modificar/acertar/alterar/corrigir/mudar
ala	órgão
alagar	completar/encher
alargar	modificar/alterar/mudar
albergaria	hotel
albergue	hotel
albufeira	lago
album	livros/livro
aldeã	habitante/morador
aldeão	habitante/morador
alegria	abalo/comoção/emoção/sentimento
alfabetismo	meta/técnica/habilidade/talento
alfabetização	meta/técnica/habilidade/talento
algodão	têxteis/pano/tecido/fazenda
alguém	causador/causa
aliado	país/república/nação
alma	causador/causa
almoeda	venda
almoço	repasto/refeição
alojamento	edifício/tecido/estrutura
alongar	deslocar/mover/mexer
alpercata	sapato/calçado
altar	edifício/tecido/estrutura
aluguel	contrato/acordo
aluminio	metal/metais
alumnus	estudioso/erudito/especialista/acadêmico
alumínio	metal/metais
aluno	alguém/indivíduo/alma/pessoa
alvo	referência
alvorada	hora
alívio	conforto
amador	alguém/indivíduo/alma/pessoa
amadora	alguém/indivíduo/alma/pessoa
amanhecer	hora
amante	mulher
ambição	apetite/pretensão/anseio/disposição/desejo
ambiência	estado/situação/condição/estado
ambulancia	auto/automóvel/viatura/carro/veículo
ambulância	auto/automóvel/viatura/carro/veículo
ameaçar	alertar/avisar/advertir
amigo	alguém/indivíduo/alma/pessoa
amimar	tratar
amizade	alguém/indivíduo/alma/pessoa
amontoado	massa
amostra	instância/exemplo/representante
amplidão	grandeza/magnitude/número
amuleto	objeto
analisar	seleccionar/selecionar/escolher
anatomia	corpo
anca	membro/perna
ancestral	parente
anchura	amplidão/dimensão/magnitude/extensão
andar	edifício/tecido/estrutura/viajar/caminhar/ir
andróide	mecanismo
anel	cabelo
anexo	adição/melhoria
anfitrião	adulto
anistia	mandado
aniversario	aniversário
ano	etapa/tempo/período
anoitecer	hora
ansiar	querer/desejar
antagonista	alguém/indivíduo/alma/pessoa
antecessor	parente
antecâmara	aposento/quarto/sala
antepassado	parente
antessala	aposento/quarto/sala
análogo	similardidade/semelhança
anúncio	propaganda/promoção/publicidade
apanhar	comprar/agarrar/capturar/obter/adquirir/receber/segurar/pegar
apara	fragmento
aparato	equipamento/ferramenta
aparelhador	alfaia/movéis/mobília/mobiliário/móvel
aparelhar	prover/abastecer/fornecer/suprir
aparelho	equipamento/ferramenta
aparição	psiquê/alma
apartamento	alojamento/abrigo/casa
aparência	semblante/aspecto
apelação	abaixo-assinado/postulação/requerimento/requisição/solicitação/petição/apelo
apelo	abaixo-assinado/postulação/requerimento/requisição/solicitação/petição
aperfeiçoar	modificar/alterar/mudar
apertar	prensar/pressionar/tocar/bater
apetrechar	prover/abastecer/fornecer/suprir
aplicacao	abaixo-assinado/postulação/requerimento/requisição/solicitação/petição/apelo
apoio	auxílio/socorro/ajuda/assistência
aposentar-se	demitir-se/quitar/resignar/renunciar/abandonar
aposento	alojamento/abrigo/casa
apostar	pressentir/prognosticar/adivinhar/predizer/prever
apostila	livro
apoteose	exemplo/modelo
apreender	agarrar/capturar/segurar/pegar
apressar	viajar/caminhar/ir/andar
aprimorar	aperfeiçoar/melhorar
aprisionar	deter/confinar/prender
aprovaçã0	apoio/suporte
aprovação	apoio/suporte
aproximação	cálculo
apunhalar	lesionar/lesar/ferir/machucar
apólice	contrato/acordo
aquietar	consolar/reconfortar/confortar/acalmar/aliviar
ar	estado/situação/condição/estado
aragem	vento
archote	luz
arco	curva/armamento/arma/boca/entrada
areia	solo/terra
arena	edifício/tecido/estrutura
argila	solo/terra
aria	música
arma	aparelho/armamento/instrumento/ferramenta
armadilha	arapuca/rede
armamento	aparelho/instrumento/ferramenta
armazenar	reter/guardar/segurar/manter
armário	alfaia/movéis/mobília/mobiliário/móvel
arquitectura	disciplina/campo/domínio
arquitetura	disciplina/campo/domínio
arranjar	botar/pôr/colocar/carregar
arrastar	arredar/puxar/tirar
arrecadação	abaixo-assinado/postulação/requerimento/requisição/solicitação/petição/apelo
arrematação	venda
arremessar	arremeter/deslocar/mover/mexer/atirar/jogar/lançar
arremeter	atirar/jogar/lançar
arrepender	sentir/experimentar
arrepender-se	sentir/experimentar
arriscar	tentar/procurar
arroz	farinhas/cereal
arte	meta/ofício/técnica/profissão/ocupação/criação/emprego/função/habilidade/talento/serviço/trabalho/lugar
articular	contar/falar/dizer
artigo	notícia/notícias/informação
artista	intérprete
arvoredo	chão/relevo/solo/terra
asa	adição/melhoria/órgão
ascendencia	estado/situação/condição/estado
ascender	viajar/caminhar/ir/andar/subir
asfixiar	comprimir/contrair
asilo	enfermaria/hospital
aspecto	semblante/aparência
aspiração	apetite/pretensão/anseio/disposição/desejo
assalariado	trabalhador
assaltar	agredir/atacar
assalto	furto/roubo
assassino	alguém/indivíduo/alma/pessoa
assediar	agastar/aporrinhar/vexar/chatear/aborrecer/amolar/molestar/importunar/perturbar/irritar/incomodar
assegurar	proteger/defender
assembléia	legislatura
assemelhar	corresponder/combinar/concordar
assemelhar-se	corresponder/combinar/concordar
assento	alfaia/movéis/mobília/mobiliário/móvel/cadeira
asserção	declaração
assessor	autoridade
assinante	freguês/cliente/comprador/consumidor
assinar	redigir/escrever
assinatura	antenome/prenome/nome
assistente	trabalhador
assistir	acorrer/socorrer/auxiliar/ajudar
associar	raciocinar/cogitar/refletir/pensar
associação	organização
assombração	psiquê/alma
assumir	antecipar
asterisco	grafema/letra
atacar	agredir/assaltar
atadura	curativo
ataque	criticismo/crítica/julgamento/manobra/operação
atar	modelar/formar
ataúde	caixa
aterrorizar	atemorizar/amedrontar/assustar/intimidar
atestado	documentação/documento
atingir	comprar/obter/adquirir/receber/tocar/bater
atirar	jogar/lançar
atitude	cognição/noção/conhecimento/compreensão
ativar	modificar/alterar/mudar
atividade	feição/peculiaridade
atmosfera	ambiência/estado/ar/situação/condição/estado
ator	intérprete
atrair	arredar/puxar/tirar
atrapalhar	impossibilitar/obstar/estorvar/impedir/proibir/bloquear/evitar
atrasar	adiar
atravessar	viajar/caminhar/ir/andar
atração	espectáculo/show
atribuição	alocação
atributo	conceito/concepção/idéia/ideia
atrito	recontro/confronto/conflito
atuar	desempenhar/apresentar/fazer
aturar	consentir/permitir/deixar
auferir	comprar/obter/adquirir/receber
aula	didáctica/ensinamento/ensino/pedagogia/educação/instrução/formação
aumentar	desinformar/enganar
aumento	acrescentamento
aurora	hora
ausência	necessidade/carência
auto-alimentação	resposta/resultado
automobilista	conductor/chofer/condutor/motorista
autoridade	alguém/especialista/indivíduo/alma/pessoa
autômato	mecanismo
auxilio	ajuda
avaria	alteração/modificação/variação/mudança
aventura	industria/empresa/negócio/comércio/projeto/tarefa
azar	fenómeno/fenômeno
azul-ferrete	azul
azul-marinho	azul
açoite	aparelho/instrumento/ferramenta
ação	enredo/argumento
bagageira	compartimento
bagunça	estado/situação/condição/estado
baixa	vítima
baixada	depressão
baixar-se	sentar-se/sentar
bala	projéctil/míssil/projétil
balanço	brinquedo
balconista	assalariado/empregado/operário
balcão	edifício/tecido/estrutura
balde	vasilhame/vasilha/vaso
baldeação	transporte/transferência
balear	atirar
baloiço	brinquedo
balsa	batel/bote/escaler/barco
balão	brinquedo
banco	assento/cadeira
bandeira	pendão/estandarte/pavilhão
bangalô	vivenda/habitação/casa
banheira	vasilhame/vasilha/vaso
banheiro	aposento/quarto/sala
banir	expulsar
banqueta	assento/cadeira
banquete	repasto/refeição
banquinho	assento/cadeira
bar	aposento/quarto/sala
barao	homemdenegócios/empresário/negociante/comerciante
barco	embarcações/embarcação/navios/navio
barra	encosto/apoio/suporte
barranco	declive/declives/subida/encosta/costa/ladeira
barril	vasilhame/vasilha/vaso
barro	matéria/substância
base	encosto/apoio/escritório/suporte/fundo
batalha	combate
batel	embarcações/embarcação/navios/navio/barco
bater	cerrar/golpear/deslocar/fechar/mover/mexer/tocar
baterpalmas	ruído
bebericar	beber/tomar
bebida	nutriente/comida/alimento
bebé	criança/filho/menino
bebê	criança/filho/menino
beijar	tocar/bater
beijocar	tocar/bater
bem	possessão/propriedade
bem-estar	eudemonismo/saúde
bem-vindo	saudação
beneficiar	comprar/obter/adquirir/receber
beneficiar-se	comprar/obter/adquirir/receber
benefício	bem
benzina	carburante/combustível
berlinde	bola
berrar	emitir/soltar/gritar
biberão	vasilhame/vasilha/vaso
biblioteca	prédio/edifício
bicha	fila/linha
bife	vianda/carne
biografia	crónica/crônica
biologia	colecção/coleção/aglomeração/acúmulo
biota	colecção/coleção/aglomeração/acúmulo
biscate	ofício/profissão/ocupação/emprego/função/serviço/trabalho/lugar
biscoito	bolo
bloquear	impossibilitar/obstar/estorvar/impedir/proibir/evitar
boato	bisbilhotice/bisbolhetice/fofoca
bocejar	bafejar/espirar/respirar
bochecha	traço
boda	cerimónia/cerimônia/festa
boiar	viajar/caminhar/ir/andar
bola	brinquedo
bolacha	bolo
bolbo	caule/tronco
boleia	passeio
boletim	estória/relato/artigo
bolsa	ajuda
bombardeiro	aeroplano/avião
bombear	alçar/elevar/erguer/levantar
boneca	brinquedo
boneco	brinquedo
boom	prosperidade
borrifar	salpicar/espalhar
bosque	chão/relevo/solo/terra
bote	embarcações/embarcação/navios/navio/barco
botelha	vasilhame/vasilha/vaso
botão	interruptor/chave
boutique	shopping
bradar	berrar/gritar
bramir	emitir/soltar
braço	membro/perna
brilho	inteligência
brincar	jogar
brinde	aquisição
brisa	vento
britar	arrombar/arrebentar
brochura	livro
bronze	escultura
bruma	nevoeiro/névoa/neblina
buffet	repasto/refeição
bule	pote
buzina	alarme
cabana	vivenda/habitação/casa
cabeça	cognição/líder/noção/chefe/conhecimento/compreensão
cabimento	intercorrência/opção/alternativa/eleição/escolha
cabo	toa/corda
cabrita	bode/cabrito/cabra/bode
cabrito	bode/cabra/bode
cache	cobre/divisa/moeda/dinheiro
cacho	cabelo
cachorro-quente	enchidos/lingüiça/salsicha
cadeira	alfaia/movéis/mobília/mobiliário/assento/móvel
cadeirão	assento/cadeira
caderno	livros/livro
cadáver	defunto/morto/corpo
cafeteria	restaurante
café	restaurante/bebida
cafés	restaurante
cair	viajar/caminhar/ir/andar
caixeiro	assalariado/empregado/operário
caixão	caixa
calabouço	aposento/quarto/sala
calculadora	maquinaria/máquina
caldear	sumir/desaparecer
caldeiras	pote
calibre	grau
camarote	compartimento
cambial	locução/provérbio/ditado/expressão/idioma
caminhar	viajar/ir/andar
caminho	trâmite/conduta/via/rodovia/corrente/curso/estrada
camiseta	camisa
campainha	botão
campanha	manobra/operação
campismo	locação/sítio/lugar
canapé	assento/cadeira
candeeiro	alfaia/movéis/mobília/mobiliário/móvel
candidato	alguém/indivíduo/político/alma/pessoa
candidatura	abaixo-assinado/postulação/requerimento/requisição/solicitação/petição/apelo
canteiro	campos
capacidade	volume/habilidade
capataz	orientador/supervisor
capricho	apetite/pretensão/anseio/desejo
caprichoso	apetite/pretensão/anseio/desejo
capturar	comprar/obter/adquirir/receber
cara	ambiência/ar/atmosfera
caracter	grafema/letra
característica	conceito/atributo/concepção/idéia/propriedade/qualidade/ideia
caractér	grafema/letra
cargo	ofício/profissão/ocupação/emprego/função/serviço/trabalho/lugar
caridade	estabelecimento/instituição/instituto
carne	vianda/corpo
carona	passeio
carpir	emitir/soltar
carregador	obreiro/trabalhador/operário
carregar	botar/prover/abastecer/fornecer/suprir/transportar/pôr/levar/colocar
carta	texto/papel
cartão	correspondência/papel
cartão-postal	cartão
carvalho	árvore
carvalho-vermelho	árvore
carácter	grafema/letra
carência	estado/ausência/escassez/necessidade/deficiência/situação/condição/estado/falta
casa	endereço/morada/alojamento/aposento/moradia/prédio/domicílio/residência/edifício/abrigo/habitação/tecido/estrutura/lar
casademoinho	fábrica/usina/planta
casal	dupla/par
casamento	cerimónia/rito/cerimônia/promessa/ritual/festa
casinha	vivenda/habitação/casa
casinhola	vivenda/habitação/casa
caso	alguém/indivíduo/alma/pessoa
catedral	igrejas/igreja/templo
categoria	conceito/concepção/idéia/ideia
cativar	atrair
catálogo	livro
causar	modificar/alterar/mudar
cavalheiro	homem
cave	pavimento/piso/andar
caveira	osso
cavilha	tarraxa/parafuso
caçamba	vasilhame/vasilha/vaso
caçoar	comportar-se/agir/atuar/parecer
cebola	bolbo/caule/tronco
ceia	repasto/refeição
cela	aposento/quarto/sala
celebridade	honra
cemitério	locação/sítio/lugar
cemitérios	locação/sítio/lugar
cenoura	raíz/raiz
centavo	divisa/peça/moeda/prata
centrar	raciocinar/cogitar/refletir/pensar
centro	prédio/edifício
centúria	etapa/tempo/período
cenário	cerque/entorno/premissa/pressuposto/envolvente/ambiente/meio
cercado	terreno/campo
cereal	farinhas
cerimónia	acontecimento/festa
cerimônia	acontecimento/festa
certeza	convicção/crença/fé/opinião
certidão	documentação/documento
certificado	documentação/documento
cervejaria	fábrica/usina/planta
chacota	comentário/observação
chaleira	pote
chalé	vivenda/habitação/casa
chapa	organização
chave	listagem/lista
chefe	alguém/líder/orientador/supervisor/indivíduo/alma/pessoa
cheirar	aperceber/aperceber-se/perceber/entender
cheiro	ambiência/ar/atmosfera
chibata	aparelho/instrumento/ferramenta
chicote	aparelho/instrumento/ferramenta
chinchilla	traço
chinelo	sapato/calçado
chofer	conductor/condutor/motorista
choça	vivenda/habitação/casa
chumbo	metal/metais
chutar	golpear/bater
chuvisco	chuva
chá	bebida
chácara	laboratório/oficina/emprego/trabalho
chão	objeto
ciclo	repetição
cientista	alguém/indivíduo/alma/pessoa
cima	área/região
cinema	espectáculo/show
cintilar	parecer
circulação	colecção/coleção/aglomeração/acúmulo
circunscrição	regiões/região
cirurgião	dr./doutor/médico
citação	apontamento/excerto/extrato/trecho/anotação/passagem/nota
civil	cidadã/cidadão
civilização	sociedade
ciência	disciplina/campo/domínio
clareira	terreno/campo
classe	status/aposento/conceito/hierarquia/concepção/idéia/população/quarto/condição/estado/gente/pessoal/posto/sala/ideia/povo/jogo/grupo/posição
clava	bastão/pau/vara
cliente	consumidor
clima	tempo
clube	associação/sociedade/união/organização/ordem
cobaia	alguém/indivíduo/alma/pessoa
cobrança	abaixo-assinado/postulação/requerimento/requisição/solicitação/petição/apelo
cobre	metal/metais/condutor
cobrir	tampar
cogitar	raciocinar/refletir/pensar
coincidir	ocorrer/suceder/acontecer/passar
coincidência	acidente
colecionar	comprar/obter/adquirir/receber
coletar	comprar/obter/adquirir/receber
colheita	sazão/estação/tempo/período
colidir	tocar/bater
colo	coxa/anca
colocar	botar/pôr/carregar
colégio	prédio/edifício
comarca	regiões/região
combate	certame/concurso/competição/torneio/partida/batalha/jogo
combinar	confromar-se/adaptar-se/adequar-se/ajustar
combinação	colecção/coleção/aglomeração/acúmulo
comemoração	reconhecimento/crédito
comentar	contar/falar/dizer
comercialismo	transação
comercializar	modificar/alterar/mudar
comerciante	mercador/negociante
comerembanquete	repasto/refeição
comichão	apetite/pretensão/anseio/desejo
comissão	estipêndio/encargo/remuneração/taxa/custo/organização
comité	junta/comissão/comitê/organização
comitê	junta/comissão/comité/organização
compacto	auto/automóvel/viatura/carro/veículo
companheiro	parente
companherismo	amizade
companhia	organização
compartimento	aposento/quarto/sala
compensar	balancear/equilibrar/pagar
compensação	retificação/correção
competição	certame/concurso/torneio/partida/jogo
competência	habilidade
completar	modificar/alterar/mudar
complicação	situação/condição
componente	categoria/porção/parte
compositor	musico/músico
comprador	consumidor
comprar	obter/adquirir/receber
compreender	abarcar/incluir/conter
compreensão	influência/força/tendência
comprimido	dose
computador	maquinaria/máquina
compêndio	livro
comunista	político
comércio	comercialismo/mercantilismo/transação
conceito	idéia/pensamento/opinião
concentrar	raciocinar/cogitar/refletir/pensar
concentração	atenção
concepção	conceito/idéia/pensamento/opinião
condensar	reduzir/diminuir
condizer	confromar-se/adaptar-se/adequar-se/ajustar
condição	premissa/pressuposto
condutor	conductor/materiais/chofer/motorista
conectar	raciocinar/cogitar/refletir/pensar
conexão	conhecida/transporte/conhecido/transferência/amizade/amigo
conferência	ensino/pedagogia/educação
confirmação	evidência/prova
confissão	admissão
conformar	obedecer
conforto	estado/situação/condição/estado
confusão	equívoco/engano/falha/erro
congresso	legislatura
conhecida	alguém/indivíduo/alma/pessoa
conhecido	alguém/indivíduo/alma/pessoa
conjectura	opinião
conjecturar	antecipar
conjuração	complô/conspiração
conselheiro	autoridade
conselho	junta/comissão/comité/comitê
consenso	acordo
consequência	fenómeno/fenômeno
conseqüência	fenómeno/fenômeno
consertar	aperfeiçoar/melhorar
conservar	cozinhar/preparar
considerar	discutir
consideração	ideia
consorte	parente
conspiração	complô
consternação	abalo/comoção/emoção/sentimento/temor/terror/medo
constrangir	limitar/restringir/conter
consultor	autoridade
consumidor	utente/utilizador/usuário
consumo	demanda/pedido
conta	extrato
contabilidade	extrato
contato	interação
contemplar	raciocinar/cogitar/refletir/pensar
contemporâneo	pário/igual/par
contenda	concorrência/competição
conter	abarcar/incluir/limitar/restringir
contestação	concorrência/competição
conteúdo	volume
continuação	duração
continuidade	etapa/tempo/período
conto	falsidade/mentira/história
contorcer	deslocar/mover/mexer
controle	estado/situação/condição/estado
controvérsia	querela/discordância/disputa/discussão
contágio	incidente/evento
convencer	persuadir
conversa	conversação/diálogo
conversação	diálogo/conversa
convicção	crença/fé/opinião
convidado	visitante/visita
convidar	solicitar/requisitar/requerer/pedir
convite	missiva/carta
convés	palanque/tablado/tribuna
cookie	bolo
cooperação	costume/hábito
coordenar	dispor/arranjar
copiar	reproduzir
copyright	documentação/documento
cor	semblante/aspecto/camada/capa/aparência
coração	premonição/intuição/centro
corpo	defunto/cadáver/morto
corredor	atleta/desportista
correio	mensagem
correr	deslocar/mover/mexer/viajar/caminhar/ir/andar
corresponder	confromar-se/adaptar-se/adequar-se/ajustar
correspondência	transporte/transferência
corretude	justeza/justiça
corrida	certame/concurso/competição/torneio/partida/jogo
corrigir	modificar/alterar/mudar
corte	autoridades/ferida/regime/ferimento/lesão/redução/governo/diminuição
costela	osso
costume	tradições/costumes/tradição/hábito
costumes	tradições/tradição/costume/hábito
cota	alocação/atribuição
coxa	membro/perna
coxim	almofada
cozinha	aposento/quarto/sala
credenciar	licenciar/autorizar/certificar
credo	doutrina/filosofia
crepúsculo	hora
cria	criatura/animal/besta/bicho/ser
criado	trabalhador
criancinha	criança/filho/menino
criança	descendência/descendente/filho
criar	produzir/construir/fazer
crisma	confirmação/prova
critica	acção/feito/ato/ação
cronista	estudioso/erudito/especialista/acadêmico
cronograma	listagem/lista
cronometrar	mensurar/quantificar
cruz	edifício/tecido/estrutura
cruzamento	junção
crâneo	osso
crânio	osso
crédito	débito/dívida/dívidas/dívida
crítico	profissional
cuba	vasilhame/vasilha/vaso
cubeta	vasilhame/vasilha/vaso
culpa	estado/situação/condição/estado
cultura	ontogenia/ontogénese/atitude/crescimento/sociedade
cume	área/região
curandeiro	especialista
curricula	informação
currículo	informação
curso	didáctica/ensinamento/ensino/pedagogia/educação/instrução/formação
curva	segmento/seção
cédula	documentação/documento
céu	ar/atmosfera
cêntimo	divisa/peça/moeda/prata
cólera	abalo/zanga/comoção/ira/emoção/sentimento/raiva
cómoda	alfaia/movéis/mobília/mobiliário/móvel
cónjuge	parente
cômoda	alfaia/movéis/mobília/mobiliário/móvel
cônjuge	cónjuge/consorte/esposa/esposo/marido/parente/companheiro
cúmulo	colecção/coleção/aglomeração/acúmulo
cúpula	telhado/teto
dama	mulher
danificar	lesionar/lesar/ferir/machucar
dano	alteração/modificação/variação/mudança
dançar	deslocar/mover/mexer
dar	regalar/oferecer/entregar
data	dia
debate	conversação/conversa
debater	discutir
debitar	pagar
decapitar	matar
decidir	seleccionar/selecionar/resolver/escolher
declividade	declive/declives/subida/encosta/costa/ladeira
declínio	declive/declives/subida/encosta/costa/ladeira
decorador	expert/experto/louvado/especialista/perito
decorar	marrar/estudar
decréscimo	alteração/modificação/variação/mudança
decênio	etapa/tempo/período
default	intercorrência/opção/alternativa/eleição/escolha
defender	proteger
defensor	alguém/indivíduo/alma/pessoa
deficit	deficiência/carência
deficiência	necessidade/carência
definição	explanação/explicação
defunto	cadáver/morto/corpo
degenerar	decair/piorar
degolar	matar
degradar	decair/piorar
degrau	encosto/apoio/suporte
deitar	botar/pôr/colocar/carregar
deixar	regalar/deslocar/mover/mexer/oferecer/entregar/dar
delapidar	despender/gastar
delegada	representante
delegado	representante
delegação	organização
deleitar	atrair
deliberar	discutir
deliciar	atrair
delinquência	estado/situação/condição/estado
delongar	adiar
demanda	abaixo-assinado/postulação/requerimento/requisição/solicitação/petição/apelo
demandar	solicitar/requisitar/requerer/pedir
demissão	notificação/comunicação/aviso/nota
demolição	chegada/conclusão/resultado/fim/final
demonstrar	revalidar/corroborar/substanciar/confirmar/sustentar/provar/suportar
dente	osso
dentes	osso
denunciar	clamar/declarar
departamento	prédio/edifício
deportar	expulsar
depressão	crise
depósito	matéria/capital/substância/fundo
derramar	manar/fluir/correr
derrapar	escorregar/deslizar
derrota	deceção/desapontamento/decepção
derrotar	ultrapassar/vencer/superar/bater
derrubar	empurrar/forçar
desacordo	recontro/confronto/conflito
desafio	situação/condição
desaparecer	sumir
descanso	almofada/interrupção/suspensão/pausa
descendente	parente
descendência	parente/parentesco/relação
descida	declive/declives/subida/encosta/costa/ladeira
descoberta	epifania/insight/lampejo
desconfiança	incerteza/dúvida
desconto	redução/diminuição
desdenhar	detestar/odiar
desejar	ansiar/querer
desejo	apetite/pretensão/anseio
desenhador	expert/experto/louvado/especialista/perito
desenvolver	criar
desfeita	conduta/comportamento
desjejum	repasto/refeição
deslizar	escorregar/viajar/caminhar/ir/andar
desolação	chegada/conclusão/resultado/fim/final
desonrar	agredir/assaltar/atacar
despedida	partida
despender	pagar
desperdiçar	despender/gastar
despertador	relógios/relógio
desprezar	detestar/odiar
destaque	elemento/componente
destratar	tratar
destroçar	arrombar/arrebentar
destruição	chegada/conclusão/resultado/fim/final
desvirar	modificar/alterar/mudar
detective	policial/polícia/agente/guarda
deteriorar	decair/piorar
detestar	antipatizar/desgostar
detetive	policial/polícia/agente/guarda
detrito	lixo/resíduo
devolver	transportar/viajar/caminhar/trazer/levar/tirar/ir/andar
diagrama	imagem/figura/ilustração/desenho
diagramar	desenhar
diamante	joia/jóia/gema
dilapidar	despender/gastar
dimensão	grandeza/magnitude/número
diminuir	modificar/alterar/reduzir/mudar
diminuição	alteração/modificação/variação/mudança
dinheiro	cobre/divisa/moeda
diplomata	funcionário/serventuário
director	administrador/gerente
direito	justeza/justiça/título
diretor	administrador/gerente
direção	tendência
dirigente	administrador/gerente
dirigir	viajar/caminhar/ir/andar
disconto	redução/diminuição
discordo	recontro/confronto/conflito
discordância	recontro/confronto/conflito
discurso	mensagem/comunicação
discussão	querela/conversação/controvérsia/conversa/discordância/disputa
disfarçar	omitir/tampar/tapar/acobertar/ocultar/encobrir/esconder
disparar	voar/atirar
dispor	botar/pôr/colocar/carregar
disposição	feição/peculiaridade
disputa	querela/controvérsia/discordância/discussão
distorção	equívoco/engano/falha/erro
distribuir	regalar/oferecer/entregar/dar
districto	regiões/região
distrito	regiões/região
divisa	cobre/moeda/dinheiro
divorcio	separação
divulgação	informação
divórcio	separação
diz-que-diz-que	bisbilhotice/bisbolhetice/fofoca
dizer	contar/falar
diálogo	conversação/conversa
doar	regalar/oferecer/entregar/dar
doação	aquisição
dobrar	deslocar/mover/mexer
doença	enfermidade
doenças	enfermidade/doença
doer	aperceber/aperceber-se/perceber/entender
dom	aquisição
domicílio	endereço/alojamento/abrigo/casa
dominancia	estado/situação/condição/estado
dominar	saber
domo	telhado/teto
domínio	ascendencia/regiões/dominancia/estado/superioridade/situação/condição/estado/região/controle
dona	mulher
dona-de-casa	esposa/mulher
dono	homemdenegócios/empresário/negociante/comerciante
dor	angústia
dormitório	aposento/prédio/edifício/quarto/sala
dose	medicamento/remédio
doutor	estudioso/erudito/especialista/acadêmico
doutrina	convicção/crença/fé/opinião
dr.	estudioso/erudito/especialista/acadêmico
dupla	par
duração	etapa/tempo/período
dádiva	aquisição
década	etapa/tempo/período
dólar	papel-moeda/cédula/nota
dúvida	precariedade/incerteza
economia	sistema/organização
edifício	tecido/estrutura
editora	empresas
educar	leccionar/lecionar/ensinar/instruir
efeito	consequência/fenómeno/fenômeno/semblante/conseqüência/aspecto/resultado/fim/aparência
efeitos	consequência/conseqüência/efeito/resultado/fim
eixo	mecanismo
elaborar	explicar
electrónica	física
eleger	seleccionar/selecionar/escolher
eleitor	cidadã/cidadão
elemento	categoria/porção/componente/parte
elenco	organização
eletronica	física
eletrónica	física
eletrônica	física
elocubrar	explicar
embaixada	organização
embaixador	funcionário/serventuário
embalagem	colecção/coleção/aglomeração/acúmulo
embalar	tampar/cobrir
embarcar	entrar
embevecimento	espírito/humor
emblema	sinal
embrião	criatura/animal/besta/bicho/ser
embriões	criatura/animal/besta/bicho/ser
embrulhar	tampar/cobrir
embrulho	colecção/coleção/aglomeração/acúmulo
emendar	aperfeiçoar/melhorar
ementa	informação
emissão	espectáculo/show
empilhar	dispor/arranjar
empreendimento	circunscrição/comarca/districto/distrito/território/domínio
empregado	trabalhador
empregador	líder/chefe
emprego	ofício/profissão/ocupação/função/serviço/trabalho/lugar
empresa	comercialismo/mercantilismo/comércio
emprisonar	deter/confinar/prender
empréstimo	débito/dívida/dívidas/dívida
empurrar	forçar
encantar	atrair
encarcerar	deter/confinar/prender
encharcar	completar/encher
encher	modificar/alterar/completar/mudar
enchido	defunto/cadáver/morto/corpo
enchidos	vianda/carne
encobrir	omitir/tampar/tapar/acobertar/ocultar/esconder
encolher	decrescer/desabar/minguar/diminuir
encontrar	comprar/obter/adquirir/receber
encontro	assembléia/reunião
encruzilhada	junção
encurtar	reduzir/diminuir
endireitar	modificar/alterar/mudar
energia	violência/força
engaiolar	deter/confinar/prender
enganar	desinformar
enganchar	fixar/prender
engatinhar	viajar/caminhar/ir/andar
engenhar	planejar
engenharia	disciplina/campo/domínio
engenheiro	alguém/indivíduo/alma/pessoa
engolir	aturar/tolerar/aguentar/suportar
engrenagem	mecanismo
enlevo	espírito/humor
enroscar	deslocar/mover/mexer
ensaio	ensaios/prática/exercício
ensejo	fenómeno/fenômeno
enterro	cerimónia/funeral/funeral/cerimônia/festa
entornar	manar/fluir/correr
entrada	estipêndio/encargo/remuneração/via/rodovia/taxa/custo/estrada/caminho
entregar	regalar/expulsar/oferecer/dar
enunciar	contar/falar/dizer
envenenar	narcotizar/dopar/drogar
enxergar	aperceber/aperceber-se/perceber/entender
enxugar	esfregar
episódio	emissão/programa
equilíbrio	espaçamento/situação/condição/posição
equipamento	ferramenta
equipar	prover/abastecer/fornecer/suprir
era	etapa/século/idade/época/tempo/período
errar	viajar/caminhar/ir/andar
esbanjar	despender/gastar
escadas	escadaria/escada
escala	critério/padrões
escaler	embarcações/embarcação/navios/navio/barco
escassez	ausência/necessidade/deficiência/falta/carência
escavação	locação/sítio/lugar
escola	prédio/edifício
escolas	prédio/edifício
escolher	seleccionar/selecionar/resolver/decidir
esconder	omitir/tampar/tapar/acobertar/ocultar/encobrir
escorraçar	expulsar
escorregador	brinquedo
escorregar	deslizar/viajar/caminhar/ir/andar
escorrego	brinquedo
escovar	enxugar/esfregar/limpar
escrava	alguém/indivíduo/alma/pessoa
escravo	alguém/indivíduo/alma/pessoa
escritura	documentação/documento
escritório	aposento/quarto/sala
escuridão	trevas
escutar	aperceber/aperceber-se/perceber/entender
escândalo	problema
esfaquear	lesionar/lesar/ferir/machucar
esmagar	prensar/pressionar/apertar
esmurrar	golpear/bater
espada	armamento/arma
esparadrapo	atadura/curativo
espaço	grafema/letra/locação/localização/ponto/lugar
especialidade	vantagem/virtude/propriedade/recurso/bem
especialista	alguém/indivíduo/alma/pessoa
espectador	alguém/indivíduo/observador/alma/pessoa
espectro	escopo/psiquê/alcance/órbita/alma/área
especular	antecipar/raciocinar/cogitar/refletir/pensar
especulação	opinião
espernear	deslocar/mover/mexer
espetador	espectador/observador
espirar	pausar/interromper/parar
espiã	espião
esposa	cónjuge/consorte/cônjuge/esposo/marido/parente/companheiro/mulher
esposo	cónjuge/consorte/cônjuge/esposa/marido/parente/companheiro
espremer	prensar/pressionar/apertar
espírito	abalo/comoção/emoção/sentimento
esquema	imagem/figura/gráfico/ilustração/desenho
esquife	caixa
estabelecimento	organização
estalar	deslocar/mover/mexer
estandarte	bandeira/pendão/bandeira/pavilhão
estanho	metal/metais
estante	alfaia/encosto/movéis/mobília/apoio/mobiliário/móvel/suporte
estatua	escultura
estação	etapa/tempo/período
estender	modificar/alterar/mudar
esticar	deslocar/mover/mexer
estilhaçar	arrombar/arrebentar
estimar	prezar/respeitar/venerar
estimativa	cálculo
estio	sazão/estação/tempo/período
estipulação	premissa/pressuposto
estofar	completar/encher
estoque	mercadoria/produto/artigo
estourar	arrebentar/explodir
estrago	alteração/modificação/variação/mudança
estrangular	comprimir/contrair
estrato	população/gente/pessoal/povo
estremecer	sacudir/tremer/agitar
estudante	alguém/indivíduo/alma/pessoa
estudio	aposento/laboratório/oficina/quarto/emprego/sala/trabalho
estudo	documentação/documento
estufa	prédio/edifício
estufar	completar/encher
estupefação	consternação/temor/terror/medo
estuprar	agredir/assaltar/atacar
estádio	edifício/tecido/estrutura
estágio	etapa/tempo/período
estátua	escultura
estória	notícia/notícias/artigo
estúdio	laboratório/oficina/emprego/trabalho
etica	filosofia
exagerar	desinformar/enganar
examinador	investigador
excedente	categoria/porção/componente/parte
exceder	ultrapassar/derrotar/vencer/superar/bater
excepção	instância/exemplo/representante
excerto	passagem
excetuar	eliminar/extinguir
exceção	instância/exemplo/representante
excluir	eliminar/extinguir
executar	penalizar/punir/castigar/matar
executivo	líder/cabeça/chefe/liderança/responsável
exemplificar	elocubrar/elaborar/expandir/expor
exemplo	líder/chefe
exercício	treinamento/treino/preparação
exigir	solicitar/requisitar/demandar/requerer/pedir
exilar	expulsar
expandir	explicar
expectativa	convicção/crença/fé/opinião
expedição	industria/empresa/negócio/comércio
experiente	especialista
experiência	educação/instrução
expert	especialista
experto	especialista
expetativa	convicção/crença/fé/opinião
explicar	esclarecer
explodir	estourar/arrebentar
explosão	ruído
expor	explicar
exposição	colecção/coleção/aglomeração/acúmulo
exposições	colecção/coleção/aglomeração/acúmulo
extensão	grandeza/magnitude/número
exterior	superfície
extorquir	roubar
extraditar	expulsar
extrato	passagem
extremo	grau
face	superfície
faceta	característica/qualidade
fachada	frente
facho	luz
falecimento	alteração/modificação/variação/mudança
falha	circunstâncias/sina/destino/sorte
falhanço	circunstâncias/sina/destino/sorte
falta	ausência/escassez/necessidade/deficiência/carência
fama	bisbilhotice/bisbolhetice/honra/fofoca
família	conceito/concepção/idéia/ideia
fanfarrear	exagerar/aumentar
fantasia	apetite/pretensão/anseio/desejo
fantasma	psiquê/alma
fardo	penca/molho/feixe/pacote
fascinar	atrair
fase	etapa/tempo/período
fato	informação
favorecer	avançar/promover
fazenda	chácara/granja/quinta/laboratório/oficina/sítio/possessão/emprego/propriedade/trabalho
fazer	desempenhar/produzir/apresentar/construir/criar
febre	sintoma
fenda	greta/racha/fresta/fissura
ferida	traumatismo/dano/machucado/lesão/mal
ferimento	traumatismo/dano/machucado/lesão/mal
ferir	lesionar/lesar/machucar
ferrar	doer
ferro	metal/metais
fervor	ardor/paixão
festa	acontecimento
festival	celebração/festividade/festa
fibra	materiais
fibras	materiais
fila	bicha/linha
filaúnica	fila/bicha/linha
filho	descendência/parente/descendente
filhote	criatura/animal/besta/bicho/ser
filipeta	reclame/reclamo/propaganda/publicidade/anúncio
filme	espectáculo/objeto/show
filosofia	convicção/crença/fé/opinião
filósofo	estudioso/erudito/especialista/acadêmico
fim	fenómeno/fenômeno/meta/alvo/objectivo/intenção
fim-de-semana	etapa/tempo/período
finalidade	meta/alvo/objectivo/intenção
finança	gestão/administração
fita	gravação
flabelar	sacudir/tremer/agitar
flecha	projéctil/míssil/projétil
flexionar	deslocar/mover/mexer
flora	colecção/coleção/aglomeração/acúmulo
floresta	chão/locação/relevo/localização/solo/terra/ponto/lugar
florestas	chão/relevo/solo/terra
fluido	matéria/substância
fluir	deslocar/mover/mexer
flutuação	alteração/modificação/variação/mudança
focar	raciocinar/cogitar/refletir/pensar
fofoca	bisbilhotice/bisbolhetice
fogo	criticismo/crítica/julgamento
foguete	viatura/veículo
foguetes	viatura/veículo
folha	folhagem/papel
folhas	papel
folheto	livro
fome	ausência/escassez/deficiência/falta/carência
formar	modificar/alterar/mudar
formatação	informação
formato	informação
formação	espaçamento/posição
formulário	documentação/documento
fornecedor	mercador/negociante/comerciante
foro	documentação/documento
fortuna	fenómeno/fenômeno
força	causador/agressão/hostilidade/causa
fotocopiar	reproduzir
fotógrafa	artista
fotógrafo	artista
fractura	traumatismo/dano/machucado/lesão/mal
frasco	vasilhame/vasilha/vaso
frase	excerto/extrato/trecho/passagem
fratura	traumatismo/dano/machucado/lesão/mal
freguês	consumidor
frente	liderança
fretamento	documentação/documento
frete	transportação/transporte/expedição
fricção	recontro/confronto/conflito
frio	temperatura
frontispício	frente
frustação	deceção/desapontamento/decepção
frustração	deceção/desapontamento/decepção
fruta	fruto/semente
fundo	vista/panorama/face/lado
funeral	cerimónia/enterro/cerimônia/festa
fura-greve	trabalhador
furadeira	implemento/instrumento/ferramenta
furtar	agarrar/capturar/segurar/pegar
fábrica	usina/planta
fèbre	sintoma
fé	convicção/crença/amizade/opinião
féretro	caixa
fórmula	procedimento/processo
fósforo	acendedor/encendedor/isqueiro
fúria	zanga/ira/cólera/raiva
galardão	dádiva/brinde/dom/doação/presente
galera	população/gente/pessoal/povo
galeria	aposento/quarto/sala
galgar	ascender/subir
galho	caule/tronco
galinha	frango/galo
galáxia	colecção/coleção/aglomeração/acúmulo
ganhar	comprar/obter/adquirir/receber
garoa	chuva
garota	mulher
garrafa	vasilhame/vasilha/vaso
gasolina	carburante/combustível
gastar	pagar
gatinhar	viajar/caminhar/ir/andar
gaveteiro	alfaia/movéis/mobília/mobiliário/móvel
geleca	matéria/substância
gemer	emitir/soltar
gemir	emitir/soltar
gene	seqüência/sequência
genealidade	inteligência
genes	seqüência/sequência
gente	população/pessoal/povo
gerar	produzir/construir/criar/fazer
geração	população/gente/pessoal/povo
gerenciar	virar-se/aguentar/lidar/sobreviver
gerente	líder/administrador/cabeça/chefe/liderança/responsável
gerir	governar/reger
gesso	esparadrapo/penso/atadura/ligadura
gesto	mudança
gestor	administrador/gerente
ghost-writer	autor/escritor
ghostwriter	autor/escritor
girar	virar-se/deslocar/mover/tornar-se/mexer/virar
gládio	armamento/arma
glória	honra
golpear	tocar/bater
gosma	matéria/substância
gotejar	entornar/verter/derramar
governar	reger
gracejo	comentário/observação
gradação	hierarquia/posto/classe/posição
graduado	estudioso/erudito/especialista/acadêmico
grama	terreno/campo
gramado	terreno/campo
grampear	ouvir/escutar
granja	chácara/quinta/laboratório/oficina/sítio/emprego/fazenda/trabalho
grau	hierarquia/grandeza/magnitude/posto/número/classe/posição
gravidade	atração
gravitação	atração
greda	solo/terra
gritar	emitir/berrar/soltar
grupo	colecção/coleção/aglomeração/acúmulo
gráfico	mapa
guarda-roupa	colecção/coleção/aglomeração/acúmulo
guardar	proteger/defender/reter/segurar/ter/manter
guen	seqüência/sequência
guerreiro	alguém/indivíduo/alma/pessoa
guerrilha	guerreiro
guerrilheiro	guerreiro
guia	líder/regulamento/norma/chefe/lei/regra
guilda	associação/sociedade/união/organização/ordem
habilidade	meta/técnica/talento
habitante	alguém/indivíduo/alma/pessoa
habitat	cerque/entorno/envolvente/ambiente/meio
habitação	morada/alojamento/aposento/moradia/prédio/domicílio/residência/edifício/abrigo/lar/casa
hall	aposento/prédio/edifício/quarto/sala
hardware	componente/parte
harmonia	música
hasta	venda
herança	possessão/propriedade
herdade	chácara/granja/quinta/sítio/fazenda
herdar	comprar/obter/adquirir/receber
herói	líder/chefe
hierarquia	status/condição/estado/organização/classe/posição
hipotetizar	antecipar
hipótese	conceito/concepção/idéia/opinião/ideia
historiador	estudioso/erudito/especialista/acadêmico
historiografo	estudioso/erudito/especialista/acadêmico
história	falsidade/mentira/passado
histórico	passado
homem	cónjuge/consorte/cônjuge/esposa/esposo/marido/adulto/companheiro
homem-bomba	alguém/indivíduo/alma/pessoa
horripilar	atemorizar/amedrontar/assustar/aterrorizar/intimidar
hortaliça	hortifruti/hortifruto
horário	listagem/cronograma/lista/agenda/programa
hospedar	divertir/entreter
hospedaria	hotel
hospedeiro	adulto
hospitalidade	recepção
hotel	prédio/edifício
humor	abalo/comoção/emoção/sentimento
hábito	tradições/costumes/tradição/costume
hóspede	visitante/visita
iate	embarcações/embarcação/navios/navio/barco
idade	etapa/século/era/época/tempo/período
ideia	conceito/concepção/idéia/pensamento/cálculo/opinião
identidade	temperamento/personalidade/pessoa
idioma	mensagem/comunicação/linguagem/discurso/língua
idéia	conceito/concepção/pensamento/opinião/ideia
igual	alguém/indivíduo/alma/pessoa
igualar	confromar-se/adaptar-se/adequar-se/ajustar
ilha	chão/relevo/solo/terra
ilustrar	elocubrar/elaborar/expandir/expor
ilusão	desempenho/performance/interpretação/apresentação
imigração	migração
imitar	reproduzir
impactar	modificar/alterar/mudar
impacto	consequência/conseqüência/efeito/resultado/fim
impertinência	apetite/pretensão/anseio/desejo
importunar	agastar/aporrinhar/vexar/chatear/aborrecer/amolar/molestar/perturbar/irritar/incomodar
imprensa	maquinaria/máquina
impressão	semblante/aspecto/aparência
impulsionar	deslocar/mover/mexer
impulso	violência/força
império	monarquia
imunidade	desistência/renúncia
inaugurar	iniciar/começar
incarcerar	deter/confinar/prender
incendiar	queimar
inclinação	gradiente
incluir	abarcar/conter
incomodar	agastar/aporrinhar/vexar/chatear/aborrecer/amolar/molestar/importunar/perturbar/irritar
incumbência	dever/obrigação
indicador	dedo
indicação	aconselhamento/mensagem/comunicação/conselho/direção
indicações	regulamento/norma/lei/regra
indiciar	clamar/declarar
indivíduo	alguém/causador/alma/pessoa/causa
indulgir	delapidar/dilapidar/esbanjar/desperdiçar
industria	comercialismo/mercantilismo/comércio
indício	mensagem/comunicação
indústria	industria/empresa/negócio/comércio
infecção	incidente/evento
influência	consequência/conseqüência/efeito/resultado/fim
informática	engenharia/tecnologia
infracção	crime/ofensa
infração	crime/ofensa
ingrediente	componente/parte
inicial	caracter/caractér/carácter/letra
inimigo	alguém/antagonista/adversário/indivíduo/opositor/alma/população/gente/pessoa/pessoal/povo
injúria	conduta/comportamento
inscrever	recrutar/registar/registrar
inspector	investigador
inspetor	investigador
instalar	botar/pôr/colocar/carregar
instituição	organização
instituto	organização
instructor	instrutor/docente/mestre/professor
instruir	leccionar/lecionar/ensinar
instrumento	documentação/documento
intento	meta/alvo/objectivo/intenção
intenção	conceito/significância/meta/significação/alvo/idéia/objectivo/pensamento/opinião/significado
interceptar	ouvir/escutar
interdição	acta/decreto
interior	campo
intermediária	representante
introduzir	iniciar/começar
introdução	apostila/sebenta/compêndio/texto
inumação	funeral/enterro/funeral
inundar	completar/encher
inventário	mercadoria/produto/artigo
inverno	sazão/estação/tempo/período
inverter	modificar/alterar/mudar
investigador	cientista/especialista
investir	modificar/alterar/mudar
invitação	missiva/carta
ir	viajar/caminhar/andar
ira	abalo/zanga/comoção/cólera/emoção/sentimento/raiva
irmão	frei/monge/frade
irritar	agastar/aporrinhar/vexar/chatear/aborrecer/amolar/molestar/importunar/perturbar/incomodar
jantar	repasto/refeição
jaqueta	casaco/sobretudo
jardim	flora/vegetação/terreno/campo
jerimum	verdura/hortaliça/legume/vegetal
joelho	coxa/anca
jogar	arremeter/competir/concorrer/atirar/lançar
jogo	certame/colecção/concurso/coleção/competição/aglomeração/torneio/acúmulo/partida
juiz	funcionário/serventuário
julgamento	acção/feito/ato/ação
julgar	resolver/decidir
junta	comissão/comité/comitê
junção	área/região
jurisprudência	colecção/coleção/aglomeração/acúmulo
jurista	funcionário/serventuário/profissional
justificativa	circunstância/consideração
justificação	circunstância/consideração
justiça	justeza
juízo	acção/feito/ato/ação
júri	junta/comissão/comité/comitê
laboratorio	laboratório/oficina/emprego/trabalho
laboratório	oficina/emprego/trabalho
laboratórios	laboratório/oficina/emprego/trabalho
lacticínios	chácara/granja/quinta/sítio/fazenda
ladeira	gradiente/inclinação
lado	superfície/opinião
ladrar	emitir/soltar
ladrilho	laje/placa
laissez-passer	consenso/consentimento/autorização/sanção/aprovação
lama	matéria/substância/solo/terra
lamber	afagar
lamentar	sentir/experimentar
lamentar-se	emitir/soltar
lanche	repasto/refeição
lanchonete	restaurante
lanterna	luz
lançar	atirar/jogar
lanígero	têxteis/pano/tecido/fazenda
lar	alojamento/abrigo/casa
largura	amplidão/dimensão/magnitude/extensão
latir	emitir/soltar
lavabo	pia
laço	adorno/ornato/ornamento/decoração
legar	regalar/oferecer/entregar/dar
legenda	título/organização
legume	hortifruti/hortifruto
lei	colecção/conceito/coleção/aglomeração/concepção/idéia/acúmulo/ideia
leilão	venda
leitaria	chácara/granja/quinta/sítio/fazenda
leite	bebida
leiteria	chácara/granja/quinta/sítio/fazenda
leitor	freguês/cliente/comprador/consumidor
lema	locução/provérbio/ditado/expressão/idioma
lemas	locução/provérbio/ditado/expressão/idioma
lenda	título
lesar	lesionar/ferir/machucar
lesão	traumatismo/dano/machucado/mal
letra	grafema
letreiro	edifício/tecido/estrutura
levar	transportar/carregar
liderança	líder/chefe
ligadura	atadura/curativo
ligação	interação
limitação	desvantagem/regulamento/norma/lei/regra
limpar	esfregar
linguagem	mensagem/comunicação/discurso/idioma/língua
lingüiça	vianda/carne
linha	texto
linhagem	parentesco/relação
lista	listagem
livreto	livro
livro	publicação/edição
lixo	materiais/resíduo
lição	ensino/pedagogia/educação
localização	objeto
locação	objeto
lodo	matéria/substância
loja	shopping
lona	têxteis/pano/tecido/fazenda
louvado	especialista
lucrar	auferir/comprar/ganhar/obter/adquirir/receber
lucro	benefício/bem
lugar	objeto
luminária	alfaia/movéis/mobília/mobiliário/móvel
lustrar	aperfeiçoar/melhorar
luta	certame/concurso/competição/torneio/combate/partida/batalha/jogo
lutar	brigar/disputar
lã	têxteis/pano/tecido/fazenda
líder	alguém/indivíduo/alma/chefe/pessoa
língua	mensagem/comunicação/linguagem/discurso/idioma/órgão
líquido	líqüido/fluido
líqüido	matéria/substância
lógica	princípio
machucar	lesionar/lesar/ferir
madrugada	hora
maestro	musico/músico
magia	desempenho/performance/interpretação/apresentação
magistrado	funcionário/serventuário
magnata	homemdenegócios/empresário/negociante/comerciante
magnitude	grandeza/número
magoar	concitar/elicitar/estimular/incitar/provocar
maiúscula	grafema/letra
mala	compartimento
maltratar	tratar
manar	deslocar/mover/mexer
manchar	modificar/alterar/mudar
mandíbula	osso
manequim	criado/ajudante/assistente/servidor
manhã	etapa/tempo/período
manicomio	enfermaria/hospital
manifestação	protesto
mansarda	pavimento/piso/andar
manter	ter
manufatura	industria/fábrica/usina/empresa/negócio/planta/comércio
maquinar	planejar
maquinaria	máquina
maquinário	maquinaria/máquina
marcha	treinamento/treino/mecanismo/preparação
marchar	caminhar/ir/andar
maresia	vento
margem	declive/declives/subida/encosta/costa/ladeira
marido	cónjuge/consorte/cônjuge/esposa/esposo/parente/companheiro
marinho	azul
marketing	comercialismo/mercantilismo/comércio
martírio	dor/angústia/dor
mascarar	omitir/tampar/tapar/acobertar/ocultar/encobrir/esconder
masmorra	aposento/quarto/sala
massacre	assassínio/assassinato/homicídio
mata	chão/relevo/solo/terra
matador	alguém/indivíduo/alma/pessoa
matematica	ciência
matemática	ciência
materiais	substância
matiz	significância/significação/significado/intenção
matriz	escritório/informação
matéria	informação
medicamento	entorpecente/droga/remédio
medida	grandeza/magnitude/número
medo	abalo/comoção/consternação/emoção/sentimento/temor/terror
meia-noite	hora
melhora	estado/situação/condição/estado
melhorar	aperfeiçoar/modificar/alterar/mudar
melhoria	estado/situação/componente/condição/estado/parte
melodia	música/texto
memorizar	marrar/estudar
memória	hardware
mencionar	contar/falar/dizer
mendigar	solicitar/requisitar/requerer/pedir
menina	mulher
menino	descendência/descendente/filho
menoridade	número
menosprezar	detestar/odiar
mensagem	comunicação
mentalidade	atitude
mente	cognição/noção/conhecimento/compreensão
mentir	desinformar/enganar
mentira	falsidade/história
mentirinha	falsidade/mentira/história
mento	traço
menu	listagem/lista
menção	apontamento/anotação/nota
mercadologia	comercialismo/mercantilismo/comércio
mercador	negociante/comerciante
mercantilismo	transação
mercearia	chácara/granja/quinta/sítio/fazenda
merenda	repasto/refeição
mesa	alfaia/movéis/mobília/mobiliário/móvel
mestre	artista
metodologia	metodo/método/métodos/técnica
metodologias	metodo/método/métodos/técnica
metodólogia	metodo/método/métodos/técnica
metro	caminho-de-ferro/ferrovia
metropolitano	caminho-de-ferro/ferrovia
metrô	caminho-de-ferro/ferrovia
mexer	deslocar/mover
milho	farinhas/cereal
mimar	tratar
mimosear	tratar
mineiro	obreiro/trabalhador/operário
mineral	materiais
minoria	número
minorias	número
minérios	materiais
missiva	texto
missão	organização
modelar	modificar/alterar/mudar
modelo	criado/líder/ajudante/assistente/chefe/servidor/exemplo
moeda	cobre/divisa/dinheiro
moinho	maquinaria/maquinário/máquina
moinhos	maquinaria/maquinário/máquina
molde	exemplo/modelo
molestar	agastar/aporrinhar/vexar/chatear/aborrecer/amolar/importunar/perturbar/irritar/incomodar
momento	actualidade/hoje/presente
monopólio	ascendencia/dominancia/superioridade/controle/domínio
montar	ascender/subir
monte	colecção/coleção/aglomeração/acúmulo/massa
montão	colecção/coleção/aglomeração/acúmulo
monumento	edifício/tecido/estrutura
monumentos	edifício/tecido/estrutura
morada	alojamento/abrigo/casa
moradia	alojamento/abrigo/casa
morador	alguém/habitante/indivíduo/alma/pessoa
morango	baga/fruto/fruta
morte	alteração/modificação/variação/mudança
mostra	instância/exemplo/representante
mote	locução/provérbio/ditado/expressão/idioma
motivação	estado/situação/condição/estado
motivo	conceito/idéia/ornamento/pensamento/opinião
motorista	conductor/chofer/condutor
mudança	alteração/modificação/variação
mulher	cónjuge/consorte/cônjuge/esposa/esposo/marido/adulto/companheiro
mundo	população/gente/pessoal/povo
murro	porrada/golpe
musico	artista
mutação	alteração/modificação/variação/mudança
máquina	maquinaria
mãe	genitor/progenitor/pai
mão	colecção/auxílio/coleção/socorro/aglomeração/ajuda/acúmulo/assistência
mês	etapa/tempo/período
míssil	armamento/arma
módulo	componente/parte
músico	artista
nacionalidade	status/condição/estado/classe/posição
nacionalismo	lealdade
nadar	viajar/caminhar/ir/andar
namorada	mulher
natureza	causador/cosmo/universo/mundo/criação/causa
naval	azul
nação	população/gente/pessoal/povo
neblina	nevoeiro/bruma/névoa
nebulosa	colecção/coleção/aglomeração/acúmulo
necessidade	estado/situação/condição/estado
necrópole	locação/sítio/lugar
negar	reter/guardar/segurar/manter
negar-sea	lixo/resíduo
negação	asserção
negociante	mercador/comerciante
negócio	comercialismo/mercantilismo/transação/comércio
nenê	criança/filho/menino
neoplasia	tumores
noitada	etapa/tempo/período
noite	etapa/tempo/período
noiva	participante
noivado	promessa
nomenclatura	verbo/vocábulo/termo/palavra
norma	critério/conceito/padrões/concepção/idéia/ideia
normas	critério/padrões
notar	contar/falar/dizer
notícia	informação
notícias	emissão/informação/programa
noz	semente/fruta
noção	conceito/concepção/idéia/ideia
numeral	simbolo/símbolos/aceno/emblema/símbolo/sinal
numerário	cobre/divisa/moeda/dinheiro
nupcias	rito/ritual
náusea	sintoma
náuseas	sintoma
névoa	nevoeiro/bruma/neblina
nível	hierarquia/posto/classe/posição
número	simbolo/símbolos/conceito/aceno/emblema/concepção/símbolo/idéia/ideia/sinal
obedecer	confromar-se/adaptar-se/adequar-se/ajustar
objectivo	meta/alvo/intenção
objetivo	meta/alvo/objectivo/intenção
observador	alguém/espectador/indivíduo/alma/pessoa
obstaculizar	impossibilitar/obstar/estorvar/impedir/proibir/bloquear/evitar
obstruir	impossibilitar/obstar/estorvar/impedir/proibir/bloquear/evitar
obter	comprar/adquirir/receber
ocidente	locação/localização/ponto/lugar
ocupante	habitante/morador
ocupação	ofício/profissão/emprego/função/serviço/trabalho/lugar
odiar	antipatizar/desgostar
ofender	concitar/elicitar/estimular/incitar/provocar
ofensa	conduta/comportamento
ofensiva	manobra/operação
oficina	laboratório/emprego/trabalho
ofício	profissão/ocupação/emprego/função/serviço/trabalho/lugar
olhar	aperceber/aperceber-se/perceber/entender
omissão	equívoco/engano/falha/erro
omitir	eliminar/extinguir
operário	obreiro/trabalhador
opositor	alguém/indivíduo/alma/pessoa
oposição	chapa/legenda/partido
opúsculo	livro
ordem	estado/associação/situação/sociedade/condição/estado/união/organização
organizar	dispor/arranjar/planejar
orgulho	satisfação
orientador	autoridade
ornamento	adorno/ornato/decoração
orquestrar	planejar
orçamento	capital/fundo
oscular	tocar/bater
ostentar	exagerar/aumentar
ostracizar	expulsar
otimismo	temperamento/disposição
outono	sazão/estação/tempo/período
ouvinte	pupilo/aluno/estudante
ouvir	aperceber/aperceber-se/perceber/entender
pacote	colecção/penca/molho/coleção/fardo/feixe/aglomeração/acúmulo
padrão	critério/intercorrência/opção/padrões/alternativa/eleição/escolha/exemplo/modelo
padrões	critério
pagamento	comercialismo/mercantilismo/comércio
pai	genitor/papai/papá/painho/progenitor/mãe
painel	edifício/tecido/estrutura
painho	genitor/papai/papá/progenitor/pai/mãe
palavra	promessa/verbo/vocábulo/termo
palco	palanque/tablado/tribuna
palestra	discurso
paleto	casaco/sobretudo
palma	árvore
palmeira	árvore
pandorga	brinquedo
panfleto	reclame/reclamo/propaganda/publicidade/livro/anúncio
papagaio	brinquedo
papai	genitor/papá/painho/progenitor/pai/mãe
papel	materiais
papá	genitor/papai/painho/progenitor/pai/mãe
par	alguém/indivíduo/alma/pessoa
parada	intervalo/pausa
paradoxo	contradição
parafuso	tarraxa
parceiro	alguém/indivíduo/alma/pessoa
parceria	contrato/acordo
parecer	corresponder/resposta/resultado/combinar/concordar
parente	alguém/indivíduo/alma/pessoa
parlamento	legislatura
partida	certame/concurso/acção/competição/feito/torneio/ato/ação/jogo
partido	adulto/organização
partir	deslocar/mover/mexer
parto	acção/feito/ato/ação
parâmetro	fator
parâmetros	fator
passar	regalar/viajar/caminhar/oferecer/entregar/ir/andar/dar
passe	consenso/consentimento/autorização/sanção/aprovação
passear	caminhar/ir/andar
pastar	alimentar
patente	documentação/documento
patinar	escorregar/deslizar
património	possessão/propriedade
patrimônio	possessão/propriedade
patriotismo	lealdade
pausa	interrupção/suspensão
pauta	listagem/lista
pavimento	edifício/tecido/estrutura
pedaço	peça
pedestal	encosto/apoio/suporte
pedir	solicitar/requisitar/requerer
pedágio	estipêndio/encargo/remuneração/taxa/custo
pegar	comprar/obter/adquirir/receber
película	espectáculo/show
pendurar	fixar/prender
peneirar	seleccionar/selecionar/escolher
penetrar	entrar
pensionista	beneficiário
penso	atadura/curativo
penúria	ausência/escassez/deficiência/falta/carência
pepineiro	verdura/hortaliça/legume/vegetal
pepino	verdura/hortaliça/legume/vegetal
pequeno-almoço	repasto/refeição
perambular	viajar/caminhar/ir/andar
percentagem	proporção
percento	proporção
perder	malograr/botar/fracassar/falhar/pôr/colocar/carregar
perdão	mandado
perfurar	entrar
perguntar	ruminar/cogitar/ponderar/especular/contemplar/refletir
perigo	estado/situação/condição/estado
perito	especialista
perno	tarraxa/parafuso
personalidade	temperamento/pessoa
perspiração	secreção
perturbar	disturbar/emocionar
período	etapa/século/era/idade/época/tempo
pesadelo	sonho
pesar	mensurar/quantificar
pesquisador	cientista
pessoa	causador/causa
pessoal	população/gente/organização/povo
ph.d.	estudioso/erudito/especialista/acadêmico
piada	comentário/observação
picada	traumatismo/dano/machucado/lesão/mal
picar	doer
pico	área/região
pigmento	camada/capa
pilha	colecção/coleção/aglomeração/acúmulo
pingar	entornar/verter/derramar
pintor	artista
pintora	artista
pintura	camada/capa
piorar	decair
pipa	brinquedo
pisar	viajar/caminhar/ir/andar
piso	edifício/tecido/estrutura
pisotear	caminhar/ir/andar
pista	evidência
pião	brinquedo
placa	edifício/tecido/estrutura
placar	chegada/edifício/tecido/estrutura/conclusão/resultado/fim/final
planejar	raciocinar/cogitar/refletir/pensar
plano	conceito/foto/retrato/idéia/pensamento/fotografia/esquema/imagem/opinião/figura/ilustração/desenho
planta	imagem/figura/ilustração/desenho
plantar	botar/pôr/colocar/carregar
plantel	prédio/edifício
plotar	desenhar
pneu	arco
poder	causador/causa
polegar	dedo
policial	polícia/agente/guarda
polir	aperfeiçoar/melhorar
poltrona	assento/cadeira
político	líder/chefe
ponderar	ruminar/raciocinar/cogitar/especular/contemplar/refletir/pensar
ponte	edifício/tecido/estrutura
ponto	objeto
população	gente/pessoal/povo
porcentagem	proporção
porquê	explanação/explicação
porrete	bastão/pau/vara
porta-bagagem	compartimento
porta-malas	compartimento
porta-voz	proponente/defensor/advogado/representante
portagem	estipêndio/encargo/remuneração/taxa/custo
porão	pavimento/piso/andar
posição	status/atitude/ofício/profissão/ocupação/condição/emprego/estado/função/opinião/serviço/trabalho/lugar/classe
pospor	adiar
possibilidade	intercorrência/opção/conceito/alternativa/concepção/eleição/escolha/idéia/ideia
postergar	adiar
posto	status/hierarquia/condição/estado/classe/posição
postura	atitude
pote	vasilhame/vasilha/vaso
poucos	elite/escol
poupar	isentar/dispensar/liberar
pousada	hotel
povo	população/gente/pessoal
prado	terreno/campo
prados	terreno/campo
prancha	madeira
prata	condutor
prateleira	encosto/apoio/suporte
precedente	instância/exemplo/representante
preceptor	instrutor/docente/mestre/professor
predadores	criatura/animal/besta/bicho/ser
predizer	aventurar/adivinhar/supor/pretender
preferir	avançar/promover
pregação	discurso
prejuízo	alteração/modificação/variação/mudança
preleção	discurso
prender	deter/confinar/agarrar/capturar/segurar/pegar
prensar	tocar/bater
preocupar	disturbar/emocionar/perturbar
preocupação	conceito/idéia/pensamento/opinião
preparar	leccionar/lecionar/ensinar/instruir
preponderância	número
presa	criatura/animal/besta/bicho/ser
presente	dádiva/brinde/dom/doação/aquisição
preservar	cozinhar/preparar
preservação	estado/situação/condição/estado
pressentir	aventurar/adivinhar/supor/pretender
pressionar	tocar/bater
pressupor	antecipar
presságio	mensagem/comunicação
presumir	antecipar
pretendente	alguém/indivíduo/alma/pessoa
pretensão	apetite/anseio/desejo
preterir	eliminar/extinguir
prevalência	número
prever	aventurar/adivinhar/supor/pretender
prima	parente
primavera	sazão/estação/tempo/período
primo	parente
processo	causa
procrastinar	adiar
produto	consequência/conseqüência/soma/efeito/quantidade/resultado/fim/número
produtos	soma/quantidade/número
produção	espectáculo/acção/feito/show/ato/ação/apresentação
profissional	adulto
profissão	ofício/ocupação/emprego/função/serviço/trabalho/lugar
progenitora	genitor/progenitor/pai/mãe
prognosticar	aventurar/adivinhar/supor/pretender
programa	espectáculo/listagem/software/conceito/lista/código/idéia/pensamento/show/informação/opinião
programação	conceito/idéia/pensamento/opinião
proibir	comandar/exigir/ordenar
proibição	acta/decreto
projecto	conceito/idéia/pensamento/opinião
projeto	conceito/idéia/pensamento/opinião
projéctil	armamento/arma
projétil	projéctil/míssil/armamento/arma
prole	criatura/animal/besta/bicho/ser
proletariado	estrato/classe
prolongamento	duração
propaganda	promoção/publicidade/informação/anúncio
proponente	alguém/indivíduo/alma/pessoa
proporção	espaçamento/grandeza/magnitude/número/posição
propriedade	conceito/concepção/idéia/possessão/ideia
proprietário	homemdenegócios/empresário/negociante/comerciante
propósito	meta/alvo/objectivo/intenção
prorrogar	adiar
proscrever	comandar/exigir/ordenar
protelar	adiar
protesto	violência/força
prova	evidência
provocar	agastar/aporrinhar/vexar/concitar/elicitar/chatear/aborrecer/amolar/molestar/importunar/estimular/incitar/perturbar/irritar/incomodar
prática	treinamento/treino/preparação
pré-condição	premissa/pressuposto
prédica	discurso
prédio	edifício/tecido/estrutura
prémio	dádiva/brinde/dom/doação/presente
prêmio	dádiva/brinde/dom/doação/presente
psicologia	ciência
psicólogo	cientista
psique	cognição/noção/conhecimento/compreensão
publicidade	propaganda/promoção/anúncio
pudim	sobremesa/doce
pugnar	brigar/disputar/lutar
pular	deslocar/mover/mexer/viajar/caminhar/ir/andar
pulsar	deslocar/mover/mexer
punho	mão/pata
punição	penalização/penalidade/castigo
pupilo	alguém/indivíduo/alma/pessoa
pário	alguém/indivíduo/alma/pessoa
pátio	terreno/campo
pânico	consternação/temor/terror/medo
pãozinho	pão
pé	encosto/apoio/suporte
pílula	dose
pônei	égua/cavalo
pôr	botar/colocar/carregar
quadrinhos	cartoon/caricatura
qualidade	conceito/atributo/concepção/característica/idéia/grau/propriedade/ideia
quantidade	conceito/concepção/idéia/ideia
quarto	aposento/sala
quebrar	romper/arremessar/atirar/lançar
queda	descenso/fallout/rebaixamento/alteração/descida/modificação/variação/mudança
queimadura	traumatismo/dano/machucado/lesão/mal
queimar	doer
queixo	traço
questionar	ruminar/cogitar/ponderar/especular/contemplar/refletir
questionário	formulário
questão	precariedade/incerteza
quinta	laboratório/oficina/emprego/trabalho
quintal	terreno/campo
quota	alocação/atribuição
química	materiais
racismo	pré-conceito/viés/preconceito
radical	alguém/indivíduo/alma/pessoa
raiva	abalo/zanga/comoção/ira/cólera/emoção/sentimento
ramal	telefone
ramerrão	procedimento/processo
ramo	caule/tronco
rancho	chácara/granja/quinta/sítio/fazenda
rapariga	mulher
rascunho	texto
rastejar	viajar/caminhar/ir/andar
rastejar-se	viajar/caminhar/ir/andar
razão	explanação/explicação
re-adquirir	comprar/obter/adquirir/receber
reactor	aparato/aparelho/equipamento
reactores	aparato/aparelho/equipamento
realçe	elemento/componente
rebordo	aresta
receber	divertir/entreter
recebimento	saudação
receio	incerteza/dúvida
recepção	saudação/festa
recessão	crise
reclame	propaganda/promoção/publicidade/anúncio
reclamo	propaganda/promoção/publicidade/anúncio
recolher	comprar/obter/adquirir/receber
recomendação	loa/louvor/glória/elogio
recomendações	loa/louvor/glória/elogio
recompensar	pagar
reconhecer	recordar-se/lembrar-se/licenciar/autorizar/recordar/certificar/lembrar
reconquistar	comprar/obter/adquirir/receber
recorte	excerto/extrato/trecho/passagem
recuar	viajar/caminhar/ir/andar
recuperar	comprar/obter/adquirir/receber
recuperação	acção/feito/ato/ação
recurso	abaixo-assinado/postulação/requerimento/requisição/solicitação/petição/vantagem/apelo/virtude/propriedade/bem
recém-nascido	criança/filho/menino
rede	sistema/organização
reduzir	modificar/alterar/mudar/diminuir
referência	apontamento/anotação/publicação/edição/nota
refinar	aperfeiçoar/melhorar
refletir	raciocinar/cogitar/pensar
reflexão	ideia
reformar	aperfeiçoar/melhorar
reforçar	leccionar/lecionar/ensinar/instruir
refém	cativo/preso/prisioneiro
reganhar	comprar/obter/adquirir/receber
regaço	coxa/anca
reger	governar
registar	recrutar/inscrever/registrar
registrar	recrutar/inscrever/registar
região	locação/localização/ponto/lugar
regiões	locação/localização/ponto/lugar
regra	conceito/concepção/idéia/procedimento/processo/ideia
regressar	viajar/caminhar/ir/andar
regulamento	conceito/concepção/idéia/ideia
regular	acertar/ajustar/corrigir
rei	monarca/suserano/soberano
reinado	continuidade/duração/era/idade/época/período
reinar	governar/reger
reino	monarquia/era/idade/época/período
reintegrar	pagar
rejeição	acção/feito/ato/ação
relacionar	raciocinar/cogitar/refletir/pensar
relato	documentação/notícia/documento/notícias/artigo
relatório	ensaios/documentação/documento/ensaio
relevo	objeto
religião	convicção/crença/fé/opinião
reluzir	parecer
relva	terreno/campo
remarcar	contar/falar/dizer
remunerar	pagar
remédio	entorpecente/droga/medicamento
renda	têxteis/pano/tecido/fazenda
renome	bisbilhotice/bisbolhetice/honra/fofoca
renovação	melhora/melhoria
rentabilizar	auferir/ganhar
renúncia	documentação/documento
repagar	pagar
reparar	aperfeiçoar/contar/melhorar/falar/dizer
repetir	reproduzir
replicar	reproduzir/contar/falar/dizer
replicação	cópia/reprodução
reportagem	notícia/notícias/artigo
reporte	documentação/documento
repouso	interrupção/suspensão/pausa
repreensão	assessoramento/conselho/recomendação
representante	alguém/proponente/indivíduo/defensor/advogado/alma/agente/pessoa
representar	desempenhar/apresentar/fazer
reproduzir	produzir/construir/criar/fazer
reprodução	cópia
repto	situação/condição
requerer	demandar/exigir
reservar	solicitar/requisitar/requerer/pedir
reservatório	lago
residente	habitante/morador
residência	endereço/alojamento/abrigo/casa
resignação	desespero
resolver	comprender/compreender/entender
resort	hotel
respirar	pausar/interromper/parar
responder	contar/falar/dizer
responsável	líder/chefe
ressentir	antipatizar/desgostar
restante	categoria/porção/componente/parte
restaurante	prédio/edifício
restauração	melhora/melhoria
restituir	pagar
resto	categoria/porção/componente/parte
restringir	limitar/conter
restrição	regulamento/norma/lei/regra/limitação
resultado	fenómeno/fenômeno/chegada/conclusão/fim/final
resumir	reduzir/diminuir
resumo	sumário
resvalar	escorregar/deslizar
resíduo	materiais/lixo/categoria/porção/componente/parte
resíduos	lixo/resíduo
retalhista	mercador/negociante/comerciante
reter	ter
retirar-se	viajar/caminhar/ir/andar
retornar	transportar/viajar/caminhar/trazer/levar/tirar/ir/andar
retorno	resposta/resultado
retribuir	pagar
retroceder	viajar/caminhar/ir/andar
retrucar	contar/falar/dizer
reunir	comprar/obter/adquirir/receber
reunião	assembléia
revisão	prática/exercício/manutenção
revólver	armamento/arma
revóvel	armamento/arma
ribeira	declive/declives/subida/encosta/costa/ladeira
ringue	palanque/tablado/tribuna
rio	córrego/corrente
rixa	recontro/confronto/conflito
robô	mecanismo
rojão	viatura/veículo
rolar	virar-se/tornar-se/virar
rolo	cilindro
romance	ficcionismo/ficção/literatura
roque	edifício/tecido/estrutura
rosa	arvoreta/arbusto/mato/moita
rosas	arvoreta/arbusto/mato/moita
rosto	semblante/aspecto/aparência
rotação	mudança
roteiro	premissa/pressuposto
rotina	procedimento/processo
roubalheira	furto/roubo
roubar	ultrapassar/derrotar/vencer/agarrar/capturar/superar/segurar/pegar/bater
roubo	furto
roça	chácara/granja/quinta/sítio/fazenda/campo
roçar	esfregar
rugir	emitir/soltar
ruminar	raciocinar/cogitar/refletir/pensar
rumor	bisbilhotice/bisbolhetice/fofoca
ruína	prédio/edifício
râguebi	futebol
réplica	cópia/reprodução
rúgbi	futebol
saber	aperceber/aperceber-se/perceber/entender
saborear	aperceber/aperceber-se/perceber/entender
sacada	edifício/tecido/estrutura
sacanear	ultrapassar/derrotar/vencer/superar/bater
sacrifício	perda
sacudir	deslocar/mover/mexer
saguão	aposento/quarto/sala
sair	deslocar/mover/mexer
sala	aposento/quarto
salada	prato
salsicha	enchidos/lingüiça/vianda/carne
saltar	deslocar/mover/mexer/viajar/caminhar/ir/andar
salvaguardar	proteger/defender
salvar	proteger/defender
salvação	segurança
salão	prédio/edifício
sandália	sapato/calçado
satélite	equipamento/ferramenta
satélites	equipamento/ferramenta
sazão	etapa/tempo/período
saúde	eudemonismo/bem-estar/estado/situação/condição/estado
sebe	estacada/paliçada/cerca/barreira
sebenta	livro
sebes	estacada/paliçada/cerca/barreira
secretária	criado/ajudante/assistente/servidor
secretário	criado/ajudante/assistente/servidor
sector	faceta
seda	têxteis/pano/tecido/fazenda
sede	escritório
sedimento	matéria/substância
segredo	informação
seguir	obedecer/viajar/caminhar/ir/andar
segundo	hierarquia/posto/classe/posição
segurança	estado/situação/condição/estado
segurar	solicitar/proteger/requisitar/requerer/agarrar/capturar/defender/pedir/ter/pegar
seguro	abrigo/proteção
seguros	abrigo/proteção
selar	cerrar/fechar
seleccionar	resolver/decidir
selecionar	seleccionar/resolver/decidir/escolher
selo	simbolo/símbolos/aceno/emblema/símbolo/sinal
selodocorreio	símbolo/selo
selos	símbolo/selo
selva	chão/locação/relevo/localização/solo/terra/ponto/lugar
semana	etapa/tempo/período
semear	botar/pôr/colocar/carregar
semente	fruto/fruta
seminário	aula/curso
senhor	homem
senhora	mulher
sensação	excitamento/percepção/excitação/percepção
sentido	significância/significação/significado/intenção
sentir	aperceber/aperceber-se/perceber/entender
separar	deslocar/mover/mexer
sepultamento	funeral/enterro/funeral
sepultura	funeral/enterro/funeral/área/região
sermão	discurso
serpear	viajar/caminhar/ir/andar
servidor	funcionário/serventuário/trabalhador
servir	acorrer/socorrer/assistir/auxiliar/ajudar
serviço	auxílio/socorro/ajuda/dever/assistência/obrigação
sessão	encontro/reunião
seta	projéctil/míssil/projétil
setor	faceta
significado	significância/significação/intenção
significação	significância/significado/intenção
signo	indício/sugestão/pista
silenciar	consolar/reconfortar/confortar/acalmar/aliviar
simbolo	sinal
simpatia	tendência
simular	reproduzir
sinal	mensagem/comunicação/mudança
sindicalismo	organização
sindicato	organização
sindicatos	organização
sinopse	sumário/resumo
sintoma	evidência
sintonizar	acertar/ajustar/corrigir
site	calculadora/computador
soberba	satisfação
sobra	categoria/porção/componente/parte
sobrancelha	cabelo
sobrepujar	ultrapassar/derrotar/vencer/superar/bater
sobrevivente	alguém/indivíduo/alma/pessoa
sobrolho	cabelo
sociedade	associação/contrato/união/organização/acordo/ordem
soco	porrada/golpe
sodio	metal/metais
software	código
sofá	assento/cadeira
solicitante	alguém/indivíduo/alma/pessoa
solicitação	abaixo-assinado/postulação/requerimento/requisição/petição/apelo
solo	objeto
solucionar	comprender/compreender/entender
soluçar	bafejar/espirar/respirar
soma	conceito/concepção/idéia/ideia
somar	enumerar/contar
sonho	imaginação
sopa	prato
sorte	fenómeno/fenômeno
sorver	beber/tomar
spillover	incidente/evento
subir	ascender/viajar/caminhar/ir/andar
subscrever	redigir/escrever
subscritor	freguês/cliente/comprador/consumidor
substituir	modificar/alterar/mudar
substituto	agente
substância	materiais/categoria/matéria/porção/componente/parte
subtítulo	título
sudorese	secreção
suma	colecção/coleção/aglomeração/acúmulo
sumário	resumo
suor	secreção
superar	ultrapassar/derrotar/vencer/bater
supercílio	cabelo
superior	face/lado
superioridade	estado/situação/condição/estado
supermarket	empório/mercado/mercadinho/quitanda/sacolão/supermercado/feira/mercado
supermercado	empório/mercado/mercadinho/quitanda/sacolão/feira/mercado
supermercados	empório/mercado/mercadinho/quitanda/sacolão/supermercado/feira/mercado
superpoder	país/república/nação
superpotência	país/república/nação
supervisor	orientador
supor	antecipar
suportar	consentir/permitir/deixar
suporte	encosto/apoio/auxílio/socorro/ajuda/assistência
suposição	conceito/concepção/idéia/opinião/ideia
supremacia	ascendencia/dominancia/superioridade/controle/domínio
suprir	prover/abastecer/fornecer
surpresa	alteração/modificação/variação/mudança
suspeito	alguém/indivíduo/alma/pessoa
suspirar	bafejar/ansiar/espirar/respirar/querer/desejar
suíte	apartamento
século	etapa/tempo/período
séculos	etapa/tempo/período
símbolo	simbolo/símbolos/aceno/emblema/sinal
símbolos	sinal
síndroma	sintoma
síndrome	sintoma
sítio	calculadora/computador/laboratório/oficina/emprego/trabalho
sócio	alguém/indivíduo/alma/pessoa
sódio	metal/metais
sósia	alguém/indivíduo/alma/pessoa
sótão	pavimento/piso/andar
t-shirt	camisa
talento	inteligência
talismã	objeto
tamanho	grandeza/magnitude/número
tamborete	assento/cadeira
tarde	etapa/tempo/período
tarefa	projeto
tato	percepção
taxi	auto/automóvel/viatura/carro/veículo
teatro	palanque/tablado/tribuna
tecnologia	disciplina/campo/domínio
telefone	sinal
telejornais	emissão/programa
telespectador	espectador/observador
tema	aria/toada/conceito/melodia/idéia/pensamento/opinião
temor	abalo/comoção/emoção/sentimento
tempo	etapa/clima/período
tendência	atitude
tensão	estado/inimizade/hostilidade/situação/condição/estado
teologia	disciplina/campo/domínio
teor	volume
teoria	conceito/concepção/possibilidade/idéia/suposição/hipótese/opinião/ideia
teorizar	antecipar
ter	abarcar/incluir/conter
terapeuta	especialista
terapia	medicamento/remédio
terminologia	verbo/vocábulo/termo/palavra
termo	verbo/vocábulo/palavra
terra	objeto
terras	chácara/granja/quinta/sítio/fazenda
terrificar	atemorizar/amedrontar/assustar/aterrorizar/intimidar
território	regiões/região
terror	abalo/comoção/consternação/emoção/sentimento/temor/medo
terrorista	radical
tesouro	colecção/coleção/aglomeração/acúmulo
testa	traço
testemunha	alguém/indivíduo/alma/pessoa
texto	livro
thread	materiais
tigela	vasilhame/vasilha/vaso
tina	vasilhame/vasilha/vaso
tinta	camada/capa
tira	policial/polícia/agente/guarda
tirar	transportar/levar/carregar
tiritar	sacudir/tremer/agitar
toada	música
tocar	desempenhar/apresentar/fazer
tocha	luz
tolerar	consentir/permitir/deixar
tolher	impossibilitar/obstar/estorvar/impedir/proibir/bloquear/evitar
tom	ambiência/fala/ar/atmosfera
tonel	vasilhame/vasilha/vaso
topo	face/lado/área/região
toque	percepção
tora	madeira
torcer-se	deslocar/mover/mexer
tormento	dor/angústia/dor
tornar-se	transmutar/deslocar/mover/mexer/transformar/mudar
torneio	certame/concurso/competição/partida/jogo
torrada	pão
torre	edifício/tecido/estrutura
torres	edifício/tecido/estrutura
tortura	dor/angústia/dor
toste	pão
trabalhador	alguém/indivíduo/alma/pessoa
trabalho	laboratório/oficina/ofício/profissão/ocupação/emprego/função/serviço/lugar
tradição	tradições/costumes/costume/hábito
trair	desinformar/enganar
trancar	fixar/prender
tranquilizar	consolar/reconfortar/confortar/acalmar/aliviar
tranqüilizar	consolar/reconfortar/confortar/acalmar/aliviar
transacção	transação
transformar	transmutar/mudar
transformar-se	transmutar/transformar/mudar
transito	colecção/coleção/aglomeração/acúmulo
transmissão	engrenagem/mensagem/marcha
transpiração	secreção
transportar	levar/carregar
transportação	industria/empresa/negócio/comércio
transporte	industria/empresa/negócio/comércio
transtornar	disturbar/emocionar/perturbar
trapacear	ultrapassar/derrotar/vencer/superar/bater
trapeira	pavimento/piso/andar
traspassar	entrar
tratamento	gestão/administração
trave	peça/pedaço
travesseiro	almofada
trazer	produzir/transportar/construir/criar/levar/carregar/fazer
trecho	passagem
treinador	líder/chefe
treinar	leccionar/lecionar/ensinar/instruir
tremer	deslocar/mover/mexer/sacudir/agitar
tremonha	sargeta
tremular	sacudir/tremer/agitar
trepar	ascender/subir
trevas	ambiência/ar/atmosfera
trilha	itinerário/itinerários/percurso/rota/evidência/linha/estrada/caminho
trimestre	etapa/tempo/período
troca	conversação/conversa
trocar	modificar/alterar/mudar
troco	cache/numerário/dinheiro
tronco	madeira
tropeçar	deslocar/mover/mexer
troçar	comportar-se/agir/atuar/parecer
truque	desempenho/performance/interpretação/apresentação
tráfego	colecção/comercialismo/mercantilismo/coleção/aglomeração/comércio/acúmulo
tráfico	comercialismo/mercantilismo/comércio
tránsito	colecção/coleção/aglomeração/acúmulo
trânsito	colecção/comercialismo/mercantilismo/coleção/aglomeração/comércio/acúmulo
tumba	área/região
tumor	tumores
tumores	enfermidade/doença
tumulto	violência/força
turismo	industria/empresa/negócio/comércio
tutor	instrutor/docente/mestre/professor
tábua	madeira
táxi	auto/automóvel/viatura/carro/veículo
técnico	líder/chefe
têmpora	traço
túmulo	área/região
ufania	satisfação
uivar	emitir/soltar
ultrapassar	derrotar/vencer/superar/bater
umapósooutro	fila/bicha/linha
união	organização
urrar	emitir/soltar
usina	fábrica/planta
usuário	alguém/indivíduo/alma/pessoa
utente	alguém/indivíduo/alma/pessoa
utilizador	alguém/indivíduo/alma/pessoa
vaca	vacas/bovinos/gado
vacância	espaço
vadiar	viajar/caminhar/ir/andar
vaga	espaço
vagabundear	viajar/caminhar/ir/andar
vagar	viajar/caminhar/ir/andar
vaguear	viajar/caminhar/ir/andar
vale	depressão
validar	revalidar/corroborar/substanciar/confirmar/sustentar/provar/suportar
van	camiões/caminhão/camião/camiões
vangloriar	exagerar/aumentar
vangloriar-se	exagerar/aumentar
varanda	edifício/tecido/estrutura
varejista	mercador/negociante/comerciante
vareta	simbolo/símbolos/aceno/emblema/símbolo/sinal
variação	alteração/modificação/mudança
variável	soma/quantidade/número
varrer	enxugar/esfregar/limpar
varão	cónjuge/consorte/cônjuge/esposa/esposo/marido/companheiro
vasilha	vasilhame/vaso
vazio	espaço
vector	variável
vectores	variável
vedar	cerrar/fechar/comandar/exigir/ordenar
vegetal	hortifruti/hortifruto
vegetação	colecção/flora/coleção/aglomeração/acúmulo
veludo	têxteis/pano/tecido/fazenda
venda	shopping
vendedor	mercador/negociante/comerciante
ventilar	sacudir/tremer/agitar
vento	clima/tempo
ver	aperceber/aperceber-se/perceber/entender
verdura	hortifruti/hortifruto
verificação	confirmação/prova
verter	manar/fluir/correr
verão	sazão/estação/tempo/período
vestíbulo	aposento/quarto/sala
vetar	comandar/exigir/ordenar
vetor	variável
video	gravação
viga	peça/pedaço
vigor	violência/força
vinho	álcoois/álcool
violentar	agredir/assaltar/atacar
violência	agressão/hostilidade
virar	transmutar/virar-se/deslocar/mover/tornar-se/mexer/transformar/mudar
virar-se	deslocar/mover/mexer
virtude	bondade
virtudes	bondade/virtude
visar	redigir/escrever
visita	encontro/reunião
visitante	visita
visitar	viajar
vislumbre	vista/panorama
visto	antenome/prenome/nome
visão	imaginação
vitória	chegada/conclusão/resultado/fim/final
viuvez	mulher
viveiro	prédio/edifício
vivenda	morada/aposento/moradia/prédio/domicílio/residência/edifício/habitação/lar/casa
vizinho	alguém/indivíduo/alma/pessoa
viúva	mulher
voar	viajar/caminhar/ir/andar
vocalizar	contar/falar/dizer
vocação	ofício/profissão/ocupação/emprego/função/serviço/trabalho/lugar
vocábulo	verbo/termo/palavra
voltar	transportar/trazer/levar/tirar
voluntário	trabalhador
votante	cidadã/cidadão
votar	seleccionar/selecionar/escolher
vulcão	montanhas/montanha/monte
vulgo	população/gente/pessoal/povo
vácuo	espaço
vídeo	gravação
vídeos	gravação
website	calculadora/computador
xerocar	reproduzir
xiste	comentário/observação
zanga	abalo/comoção/emoção/sentimento
zefir	vento
zelo	ardor/paixão
zona	área/região
zéfiro	vento
ágape	repasto/refeição
água	líquido
álbum	livros/livro
álbuns	livros/livro
álcoois	bebida
álcool	bebida
ático	pavimento/piso/andar
átomo	substância
átrio	aposento/quarto/sala
ângulo	espaço
ângulos	espaço
época	etapa/século/era/idade/tempo/período
ética	filosofia
êxtase	espírito/humor
íncubo	sonho
índex	dedo
índice	listagem/lista
órbita	itinerário/itinerários/percurso/rota/linha/estrada/caminho
