abagunçar	desordenar/bagunçar
abalroar	deslocar/mover
abandonar	descontinuar/cessar/ceder/finalizar/desistir/acabar/terminar/parar/deixar/entregar/passar/dar/descartar/alterar/mudar
abastecer	entregar/entregar/dar/dar
abater	decrescer/desabar/minguar/diminuir/dividir/cortar
abespinhar	encolerizar/irar/zangar/enraivecer
abocanhar	agarrar/segurar
abordar	discutir
aborrecer	agastar/aporrinhar/vexar/chatear/amolar/molestar/importunar/perturbar/irritar/incomodar
abortar	encerrar/finalizar/concluir/terminar
abranger	abarcar/incluir/conter
abreviar	reduzir/diminuir
abrigar	prover/abastecer/fornecer/suprir
abrilhantar	estar/ser
abrir	desfazer/tornar/virar/mudar
absolver	pronunciar/rotular/julgar
absorver	interessar
acabar	cessar/encerrar/encerrar/encerrar/encerrar/finalizar/finalizar/finalizar/finalizar/concluir/concluir/concluir/terminar/terminar/terminar/terminar/parar
acalmar-se	tornar/virar/mudar
acariciar	afagar
acasalar	juntar/unir
aceitar	consentir/comprar/permitir/obter/adquirir/receber/deixar/balizar/topar/encerrar/reagir/finalizar/responder/avaliar/estar/ser/concluir/julgar/receber/receber/terminar
acelerar	apressar/viajar/caminhar/correr/ir/andar/aprofundar/agir/intensificar/atuar/fazer
acenar	gesticular
acender	tornar/virar/mudar
acentuar	exprimir/expressar/mostrar
acercar	vir
acertar	modificar/alterar/mudar/tocar/bater/tornar/virar/mudar
acessar	re-adquirir/reconquistar/reganhar/recuperar/encontrar
achar	antecipar/comprar/obter/pensar/adquirir/receber/balizar/conceitualizar/conceber/avaliar/julgar
achatar	modelar/formar
acolher	abrigar/amparar
acomodar	estabilizar-se/satisfazer
acompanhar	viajar/caminhar/ir/andar/associar
aconselhar	declarar
acontecer	ocorrer/suceder/passar
acoplar	juntar/unir/ligar/reunir
acordar	aperfeiçoar/melhorar/tornar/virar/mudar
acorrer	apoiar/suportar/ajudar
acostar	vir
acostumar	modificar/alterar/mudar
acostumar-se	modificar/alterar/mudar
acotovelar	propulsionar/empurrar
acovardar	vergar/curvar/dobrar/torcer
acovardar-se	vergar/curvar/dobrar/torcer
acreditar	aceitar
acrescentar	acrescer/crescer/aumentar
acrescer	acrescentar/crescer/aumentar
aculturar	lustrar/polir/refinar
acumular	botar/acrescer/acrescentar/crescer/pôr/colocar/carregar/aumentar
adaptar	modificar/alterar/variar/mudar
adaptar-se	corresponder/combinar/concordar
adequar	modificar/alterar/variar/mudar
adequar-se	corresponder/combinar/concordar
aderir	encostar/grudar/juntar/tocar
adiar	aguardar/reter/esperar
adicionar	acrescer/modificar/alterar/acrescentar/crescer/mudar/aumentar/estar/ser
adivinhar	solucionar/resolver/computar/calcular
adjudicar	causar/provocar/dar
administrar	tratar/lidar/cuidar/guiar
admirar	mirar/observar/olhar/ver
admitir	consentir/consentir/confessar/permitir/permitir/reconhecer/deixar/deixar/topar/prognosticar/transferir/predizer/prever/avaliar/transmitir/trazer/aceitar/considerar/achar
adoecer	decair/piorar
adoentar	decair/piorar
adoptar	seleccionar/selecionar/escolher
adornar	ornar/empetecar/enfeitar/ornamentar/embelezar/decorar
adotar	seleccionar/selecionar/escolher
adquirir	comportar-se/agir/comprar/comprar/atuar/obter/obter/parecer/receber/receber/alterar/mudar
adular	enaltecer/elogiar/louvar
advertir	informar
advocar	aconselhar/sugerir/propor
aerotransportar	transportar/levar/carregar
afagar	tratar/tocar/bater
afastar	deslocar/mover/conservar/reter/manter
afectar	modificar/alterar/mudar
afetar	impactar/modificar/modificar/alterar/alterar/mudar/mudar
afigurar	conjeturar/conjecturar/imaginar/pensar
afirmar	declarar
afligir-se	sofrer
afogar	perecer/falecer/expirar/matar/morrer
afogar-se	perecer/falecer/expirar/morrer
afrouxar	modificar/alterar/mudar
afugentar	deslocar/mover
afundar	deslocar/mover/descer/descer/baixar/baixar/cair/cair
agarrar	capturar/capturar/segurar/segurar/pegar/pegar/tomar/pegar
agilizar	aprofundar/intensificar
agitar	deslocar/deslocar/mover/mover/mexer/mexer/deslocar/deslocar/deslocar/mover/mover/mover
aglomerar	acrescer/acrescentar/crescer/aumentar
agradar	estar/ser
agradecer	transmitir/passar
agravar	modificar/alterar/mudar
aguardar	ansiar/querer/desejar/agir/atuar/fazer
aguentar	consentir/permitir/deixar/agir/atuar/fazer
aguerrir	brigar/disputar/lutar
ajudar	provisionar/prover/abastecer/apoiar/fornecer/suportar/servir
ajustar	modificar/modificar/alterar/alterar/variar/caber/ficar/servir/mudar/mudar
alarmar	alertar/avisar/advertir
alcançar	conseguir/suceder/estar/atingir
alegrar	sentir/experimentar/regozijar/regozijar-se/alegrar-se
alegrar-se	sentir/experimentar/regozijar/regozijar-se/alegrar
aleijar	indispor
alentar	inspirar/exaltar/animar
alertar	avisar/advertir/informar
alienar	ceder/entregar/passar/dar/providenciar/arranjar
alimentar	prover/abastecer/fornecer/suprir/provisionar/prover/abastecer/fornecer/servir
alinhar	posicionar/situar
aliviar	acorrer/aperfeiçoar/socorrer/assistir/auxiliar/ajudar/melhorar
alocar	lotear/atribuir
alojar	morar/povoar/habitar/viver
alongar	estressar/tensionar/ampliar/progredir/aumentar
alugar	comprar/obter/adquirir/receber
alumiar	modificar/alterar/mudar/alterar/mudar
alçar	deslocar/mover
amadurecer	progredir/desenvolver
amainar	decrescer/desabar/minguar/diminuir
amalgamar	modificar/alterar/mudar
amanhecer	alterar/mudar
amarfanhar	mudar
amarrar	fixar/prender/conectar/deter/anexar/confinar/atar/reter/juntar/prender/unir/ligar/manter
amarrotar	mudar
amassar	dobrar/manejar/manusear/manipular
ameaçar	existir/ser
amedrontar	comover/emocionar/estimular/excitar
amenizar	aperfeiçoar/decrescer/desabar/minguar/melhorar/diminuir/alterar/mudar
amimar	tratar
amoldar	moldar/forjar/modelar/formar
amolecer	liquefazer/liquidificar
amontoar	acrescer/acrescentar/crescer/aumentar
amortecer	modificar/alterar/mudar
amortizar	liquidar
amparar	prover/abastecer/fornecer/suprir
ampliar	modificar/alterar/mudar
amputar	retirar/remover/tirar
analizar	examinar
andar	viajar/viajar/viajar/viajar/viajar/caminhar/caminhar/caminhar/caminhar/caminhar/ir/ir/ir/ir/ir/viajar
anexar	juntar/unir/ligar/reunir/juntar/unir
angustiar	desconcertar/perturbar/confundir
anilhar	anexar/juntar/unir
animar	regozijar/regozijar-se/afectar/alegrar-se/comover/comover/alegrar/emocionar/emocionar/afetar/estimular/estimular/excitar/excitar
animar-se	regozijar/regozijar-se/alegrar-se/alegrar
aniquilar	matar
anotar	registar/registrar
ansiar	querer/desejar
antecipar	balizar/avaliar/julgar
anuir	gesticular
anunciar	contar/falar/jogar/dizer/informar/informar/contar/mostrar
apagar	remover/ligar/tirar
apanhar	jogar/coligir/ajuntar/recolher/coletar/juntar/reunir
aparecer	surgir
aparelhar	prover/abastecer/fornecer/suprir
aparentar	estar/ser
apear	descer/baixar/cair
apear-se	descer/baixar/cair
aperfeiçoar	modificar/alterar/melhorar/mudar/perfazer
apertar	modificar/alterar/mudar/tocar/bater/alterar/agarrar/segurar/mudar
apetrechar	prover/abastecer/fornecer/suprir
apinhar	encontrar/reunir
apitar	ressoar/ressoar/soar/soar/fazer/fazer
aplainar	modelar/formar
aplicar	tampar/cobrir/empregar/utilizar/usar
apontar	informar/mirar/direcionar/significar/indicar
apostar	jogar/jogar
apreciar	transmitir/considerar/achar/ver/passar
apreender	agarrar/capturar/segurar/pegar
apresentar	aludir/mencionar/citar/contar/falar/dizer/recriar/informar/mostrar/representar
apressar	viajar/viajar/caminhar/caminhar/ir/ir/andar/andar/aprofundar/agir/intensificar/atuar/fazer
apressar-se	viajar/caminhar/ir/andar
aprofundar	acrescer/acrescentar/crescer/aumentar
aprontar	modificar/alterar/mudar
aprovar	balizar/reagir/responder/avaliar/julgar
aproveitar	vivenciar/experienciar/empregar/utilizar/experimentar/usar
aproximar	computar/calcular
aprumar	alterar/mudar
apurar	investigar/pesquisar/examinar
aquecer	modificar/modificar/alterar/alterar/mudar/mudar/alterar/mudar
arder	sentir/experimentar
armar	prover/abastecer/fornecer/suprir
arranhar	lesionar/lesar/ferir/machucar/encostar/tocar
arranjar	botar/pôr/colocar/carregar/acordar/concordar
arrastar	arredar/puxar/tirar
arrebentar	pular/saltar/desmoronar/dividir/separar
arrecadar	cobrar
arredar	deslocar/mover
arremeter	correr
arrepender	sentir/experimentar
arrepender-se	sentir/experimentar
arriar	deslocar/mover
arriscar	tentar/tentar/procurar/procurar/existir/ser
arruinar	malograr/fracassar/falhar/estraçalhar/destroçar/destruir
arrumar	dispor/arranjar/ordenar/organizar/organizar
arrumar-se	alterar/mudar
ascender	viajar/caminhar/ir/andar/subir
asfixiar	matar
assaltar	brigar/disputar/lutar
assassinar	matar
assear	modificar/alterar/mudar
assediar	agastar/aporrinhar/vexar/chatear/aborrecer/amolar/molestar/importunar/perturbar/irritar/incomodar
assemelhar	assemelhar-se/corresponder/combinar/concordar/parecer
assemelhar-se	corresponder/combinar/concordar
assentar	botar/pôr/colocar/carregar/tornar/virar/mudar
asseverar	teimar/insistir/comportar-se/declarar/resistir/conduzir
assinalar	informar
assistir	apoiar/suportar/ajudar
assobiar	ressoar/soar/fazer
associar	raciocinar/cogitar/refletir/pensar
assumir	antecipar
assustar	comover/emocionar/estimular/excitar
atacar	impactar/brigar/disputar/afetar/lutar
atar	fixar/fixar/prender/prender/conectar/deter/anexar/confinar/amarrar/reter/juntar/prender/unir/ligar/manter
atemorizar	comover/emocionar/estimular/excitar
atenuar	aperfeiçoar/melhorar
aterrorizar	comover/emocionar/estimular/excitar
atestar	informar
atingir	impactar/encerrar/afetar/comprar/comprar/finalizar/obter/obter/adquirir/adquirir/acabar/receber/receber/terminar/tocar/bater/ocasionar/conseguir/efetuar/suceder/produzir/provocar
atirar	lesionar/lesar/ferir/machucar/propulsar/propulsionar/impulsionar/tocar
atormentar	angustiar/doer/machucar
atrair	concitar/elicitar/estimular/incitar/provocar
atrapalhar	impedir/evitar
atrasar	adiar
atravessar	deslocar/mover/mexer/viajar/caminhar/caminhar/ir/ir/andar/andar/passar/perfurar/furar
atrever	agir/agir/atuar/atuar/fazer/fazer
atrever-se	agir/agir/atuar/atuar/fazer/fazer
atribuir	balizar/lidar/avaliar/conceder/julgar/entregar
atritar	encostar/tocar
atropelar	lesionar/lesar/ferir/machucar
atuar	recriar
aturar	consentir/permitir/deixar
auferir	comprar/comprar/obter/obter/adquirir/adquirir/receber/receber
aumentar	acrescer/modificar/alterar/acrescentar/crescer/mudar/ampliar/progredir/crescer/crescer/subir
autorizar	consentir/permitir/deixar
auxiliar	apoiar/suportar/ajudar
avaliar	raciocinar/cogitar/refletir/pensar/balizar/computar/calcular/julgar
avançar	viajar/caminhar/ir/andar/delegar/progredir/desenvolver
avariar	modificar/alterar/mudar/danificar
averiguar	investigar/pesquisar/examinar
avermelhar	descolorir/colorir
aviar	expedir/despachar/embarcar/transportar/enviar/trazer
aviltar	modificar/magoar/alterar/ofender/provocar/mudar/humilhar/mortificar/rebaixar
avionar	operar/controlar
avisar	informar
avistar	aperceber/aperceber-se/perceber/entender
avizinhar	vir
azedar	tornar/virar/mudar
bagunçar	modificar/alterar/mudar/desordenar
bailar	deslocar/mover/mexer
baixar	modificar/alterar/viajar/caminhar/mudar/ir/andar/deslocar/mover
bajular	enaltecer/elogiar/louvar
balancear	combinar
balançar	oscilar
balbuciar	proferir/proferir/verbalizar/verbalizar/conversar/conversar/falar/falar/dizer/dizer
balear	matar
balizar	raciocinar/cogitar/refletir/pensar
baptizar	denominar/chamar/nomear
bastar	cumprir/realizar/satisfazer
batalhar	brigar/disputar/lutar
bater	cerrar/colidir/deslocar/deslocar/fechar/mover/mover/mexer/mexer/atingir/tocar/tocar/tocar/propulsar/propulsionar/propulsionar/golpear/acertar/deslocar/deslocar/mover/mover/ressoar/ressoar/ressoar/impulsionar/empurrar/soar/soar/soar/tocar/fazer/fazer/fazer
batizar	denominar/chamar/nomear
batucar	ressoar/soar/fazer
beber	ingerir/ingerir/consumir/consumir/tomar/tomar
bebericar	beber/tomar
beliscar	agarrar/segurar
beneficiar	comprar/obter/adquirir/receber
beneficiar-se	comprar/obter/adquirir/receber
berrar	proferir/verbalizar/conversar/falar/dizer
bicicletar	ir
boiar	viajar/caminhar/ir/andar
boquejar	dialogar/conversar
borbulhar	ressoar/soar/fazer
borburar	ressoar/soar/fazer
borrar	malograr/fracassar/falhar
borrifar	salpicar/espalhar
botar	deslocar/mover
bradar	proferir/verbalizar/conversar/falar/dizer
brandir	deslocar/mover
brilhar	iluminar-se/iluminar/estar/ser
brocar	dividir/cortar
buscar	inspecionar/examinar/ver
buzinar	ressoar/soar/fazer
caber	ficar/servir/vestir-se/arrumar-se/vestir/estar/ser
cadastrar	assinalar/indicar
cair	perecer/falecer/expirar/modificar/alterar/morrer/viajar/caminhar/mudar/ir/andar/descolar/desgrudar/descer/baixar/separar
calcular	raciocinar
calhar	ocorrer/suceder/acontecer/passar
calotear	victimizar/vitimar
caminhar	viajar/viajar/ir/ir/ir/ir/andar/andar/andar/andar
canalizar	governar/reger
cansar-se	indispor
cantar	proferir/verbalizar/conversar/falar/dizer
cantarolar	cantar
capar	esterilizar
capotar	dormir/repousar/descansar/cochilar
capturar	agarrar/segurar/jogar/pegar/agarrar/agarrar/tomar/tomar/pegar/pegar
caracterizar	distinguir/diferenciar/lembrar/pensar
caraterizar	distinguir/diferenciar/lembrar/pensar
carburar	tornar/virar/mudar
carregar	modificar/alterar/completar/completar/transportar/encher/encher/levar/mudar/apresenta/dispõe/deslocar/deslocar/mover/mover/encher
casar	unificar/reunir
casar-se	unificar/reunir
castrar	esterilizar
catar	coligir/ajuntar/recolher/coletar/juntar/reunir
causar	criar/criar/provocar/provocar/fazer/fazer
cauterizar	tratar
cavalgar	viajar/caminhar/ir/andar
cavar	retirar/remover/dividir/tirar/cortar
caçar	perseguir
ceder	regalar/oferecer/entregar/dar/transferir/entregar/dar
celebrar	encontrar/reunir
centrar	raciocinar/cogitar/refletir/pensar
cercar	assaltar/atacar
cevar	modificar/alterar/mudar
chacinar	matar
chamar	impetrar/telecomunicar/intimar/mandar/rotular/classificar/ordenar
checar	analizar/examinar
chegar	estar/ser/vir
cheirar	aperceber/aperceber-se/recender/perceber/entender/parecer
chocalhar	ressoar/soar/fazer
chocar	colidir/atingir/bater
choramingar	chorar
chover	precipitar/cair
chupar	beber/tomar
chutar	golpear/bater/computar/propulsar/propulsionar/calcular/impulsionar/tocar
cicatrizar	melhorar
cindir	partir/dividir/separar
circular	viajar/caminhar/ir/andar
circunscrever	reduzir/diminuir
civilizar	lustrar/polir/refinar
clarear	modificar/alterar/mudar/descolorir/colorir
classificar	balizar/categorizar/denominar/designar/avaliar/julgar
co-ocorrer	acompanhar
coagir	compelir/obrigar/forçar
cobrar	contabilizar/computar/calcular/contar
cobrir	tampar/tampar/encetar/abordar/cumprir/encostar/realizar/satisfazer/iniciar/tocar
cocegar	afagar/acariciar
cochichar	proferir/verbalizar/conversar/falar/dizer
cochilar	dormir/repousar/descansar/jazer
cogitar	raciocinar/refletir/pensar
colapsar	mudar
colar	anexar/encostar/grudar/juntar/juntar/unir/tocar
coletar	cobrar
colher	coligir/coligir/ajuntar/ajuntar/recolher/recolher/coletar/coletar/juntar/juntar/reunir/reunir
colidir	atingir/tocar/bater/bater
colocar	botar/botar/botar/tampar/fixar/pôr/pôr/pôr/prender/carregar/carregar/carregar/cobrir/vestir-se/arrumar-se/deslocar/mover/vestir
colorir	ornar/empetecar/enfeitar/ornamentar/embelezar/alterar/adornar/decorar/mudar
comandar	dirigir/conduzir
combater	brigar/disputar/lutar
combinar	amalgamar/equivaler/interagir/acrescer/somar/unificar/igualar/acrescentar/adicionar/misturar/mudar
combustir	tornar/virar/mudar
comer	acasalar/ingerir/ingerir/ingerir/copular/consumir/consumir/consumir/tomar/tomar/tomar
cometer	agir/atuar/fazer
começar	iniciar/agir/atuar/fazer
comissionar	ceder/entregar/passar/dar
comover	concitar/elicitar/estimular/incitar/provocar
comparar	analizar/examinar/estar/ser
compartilhar	comunicar/agir/empregar/utilizar/atuar/transmitir/usar/fazer
compartir	comprar/obter/adquirir/receber/empregar/utilizar/usar
compatibilizar	corresponder/combinar/concordar
compelir	obrigar/induzir/forçar
compensar	pagar/combinar
completar	modificar/alterar/mudar
compor	verbalizar/representar/representar
comportar-se	agir/portar/atuar/fazer
comprar	obter/adquirir/receber/estar/ser
compreender	abarcar/comprender/comprender/comprender/incluir/conter/entender/entender/entender/conhecer/saber/entender
comprimir	estreitar/apertar
comprometer	empregar/utilizar/usar
computar	raciocinar
comunicar	interagir/enviar
conceber	imaginar
conceder	confessar/reconhecer/admitir/alocar/acordar/concordar/entregar/entregar/entregar/entregar/dar/dar/dar/dar
conceitualizar	imaginar
concentrar	raciocinar/cogitar/refletir/pensar
conciliar	acordar/concordar
concluir	modificar/alterar/mudar/encerrar/encerrar/finalizar/finalizar/terminar/terminar
concordar	corresponder/combinar/equivaler/reagir/igualar/acordar/responder
concretizar	causar/criar/provocar/fazer
condensar	reduzir/diminuir
conduzir	modificar/alterar/mudar/agir/portar/deslocar/mover/lidar/lidar/cuidar/cuidar/atuar/guiar/guiar/fazer
conectar	raciocinar/cogitar/fixar/refletir/pensar/prender
conectar-se	acessar
confabular	dialogar/dialogar/conversar/conversar
confeccionar	causar/criar/provocar/fazer
conferir	analizar/examinar
confessar	reconhecer/reconhecer/admitir/admitir
confiar	ceder/consentir/permitir/deixar/entregar/passar/dar
confidenciar	ceder/entregar/passar/dar
confinar	reduzir/diminuir/desabilitar/desativar/incapacitar
conflagrar	tornar/virar/mudar
confundir	concitar/elicitar/estimular/incitar/provocar/embaraçar/constrangir/envergonhar
congelar	padecer/solidificar/tornar/sofrer/virar/mudar
conglomerar	acrescer/acrescentar/crescer/aumentar
conjecturar	antecipar/imaginar
conjeturar	imaginar
conquistar	comportar-se/agir/atuar/parecer
consagrar	empregar/utilizar/usar
consentir	reagir/aprovar/responder/concordar/aceitar
consertar	reparar/aperfeiçoar/emendar/melhorar
conservar	cozinhar/preservar/preparar/reter/guardar/segurar/manter
considerar	sentir/experimentar/pensar/pensar/achar/achar/prognosticar/predizer/prever/avaliar/achar/achar/ver
considerar-se	estar/ser
consignar	comissionar/incumbir/confidenciar/confiar/entregar
constipar	indispor
constituir	pioneirar/empreender/iniciar/representar
construir	causar/causar/criar/criar/provocar/provocar/fazer/fazer
consultar	indagar/perguntar
consumir	despender/gastar/ingerir/tomar
contaminar	modificar/alterar/mudar
contar	proferir/exprimir/recitar/verbalizar/informar/informar/determinar/expressar/estar/ser/achar
contemplar	raciocinar/cogitar/refletir/pensar/mirar/mirar/observar/observar/olhar/olhar/ver/ver
conter	abarcar/abarcar/incluir/incluir/negar/refrear/limitar/controlar
continuar	viajar/caminhar/ir/andar/agir/atuar/estar/estar/estar/ser/ser/fazer
contorcer	deslocar/mover/mexer
contornar	encostar/tocar
contrafazer	recriar
contrair	decrescer/desabar/minguar/diminuir/estreitar/apertar/experimentar/ter
contrair-se	decrescer/desabar/minguar/diminuir
contribuir	modificar/alterar/pagar/mudar/entregar/dar
controlar	coibir/entravar/serenar/manejar/deter/manusear/manipular/moderar/conter
convalescer	melhorar
convencer	persuadir/influir/influenciar
conversar	dialogar/dialogar/proferir/comunicar/verbalizar/transmitir/falar/falar/dizer
converter	modificar/alterar/substituir/mudar
convidar	solicitar/solicitar/requisitar/requisitar/requerer/requerer/pedir/pedir/interagir/comover/requisitar/emocionar/requerer/estimular/excitar/pedir
convir	corresponder/combinar/concordar
convocar	impetrar/intimar/mandar/ordenar
copiar	assemelhar-se/assemelhar/reproduzir/parecer/causar/criar/provocar/fazer
copular	acasalar/juntar/unir
corar	descolorir/colorir
correr	manar/manar/fluir/fluir/deslocar/mover/apressar/mexer/viajar/atravessar/caminhar/ir/andar/passar/apressar-se/despachar-se/agir/acelerar/apressar/atuar/passar/fazer
corresponder	combinar/concordar/equivaler/igualar
corrigir	modificar/alterar/mudar/inverter/reverter/tornar/virar
corromper	modificar/alterar/pagar/mudar
corrugar	dobrar
cortar	descolar/desgrudar/dividir/dividir/separar
cotovelar	propulsionar/empurrar
coxear	caminhar/ir/andar
cozinhar	confeccionar/fabricar/construir/mudar
coçar	irritar/cortar
crepitar	ressoar/soar
crer	acreditar/aceitar
crescer	acrescer/acrescentar/aumentar/progredir/desenvolver/subir
criar	produzir/construir/fazer/agir/atuar/causar/causar/provocar/provocar/fazer/fazer/fazer
criptografar	codificar
cronometrar	mensurar/quantificar
cruzar	reproduzir/dobrar/criar
cuidar	governar/reger/lidar/guiar
cuidar-se	embonecar/empetecar/embelezar
cultivar	lustrar/polir/refinar
cumprimentar	acostar/vir
cumprir	encerrar/finalizar/acabar/terminar/ocasionar/efetuar/efetuar/produzir/executar/realizar/satisfazer/provocar/atingir
curar	melhorar
curtir	celebrar
curvar	virar-se/virar-se/tornar-se/tornar-se/virar/virar/deformar
curvar-se	gesticular
custar	requisitar/requisitar/demandar/demandar/precisar/precisar/exigir/exigir/requerer/requerer/estar/ser
custear	pagar
cutucar	propulsionar/empurrar
danificar	modificar/alterar/mudar
dançar	deslocar/deslocar/mover/mover/mexer/mexer
dar	regalar/regalar/ceder/prover/abastecer/fornecer/suprir/oferecer/oferecer/entregar/entregar/entregar/passar/provisionar/prover/transferir/transferir/abastecer/informar/fornecer/causar/causar/contar/criar/dirigir/provocar/provocar/servir/entregar/entregar/conduzir/fazer
debilitar	enfraquecer
debruçar	vergar/curvar/dobrar/torcer
decair	piorar/tornar/virar/mudar
decapitar	matar
decidir	seleccionar/selecionar/escolher/encerrar/finalizar/concluir/terminar
declarar	contar/falar/dizer/balizar/avaliar/julgar
declinar	decrescer/desabar/minguar/diminuir
declivar	debruçar/inclinar
decretar	resolver/decidir
dedicar	empregar/utilizar/usar
deduzir	reter/guardar/segurar/manter/computar/calcular
defender	impedir/atrapalhar/evitar
defletir	virar-se/tornar-se/virar
deformar	alterar/mudar
defraudar	victimizar/vitimar
defrontar	estar
degelar	liquefazer/liquidificar
degenerar	decair/piorar
deglutir	ingerir/consumir/tomar
degolar	matar
degradar	decair/piorar/humilhar/mortificar/aviltar/rebaixar
deitar	botar/pôr/colocar/carregar
deixar	modificar/regalar/alterar/ceder/deslocar/mover/mexer/oferecer/entregar/entregar/mudar/passar/dar/dar/alterar/consentir/prover/induzir/aprovar/concordar/sair/aceitar/partir/mudar/ir/dar
delapidar	despender/gastar
delegar	responsabilizar/nomear
deletar	remover/tirar
delimitar	limitar/restringir/conter
delinear	marcar
delongar	adiar
demandar	solicitar/requisitar/requerer/pedir
demonstrar	revalidar/corroborar/substanciar/confirmar/sustentar/provar/suportar/apresentar/mostrar/transmitir/passar
denominar	rotular/classificar
denotar	significar/informar/contar
departir	sair/sair/partir/partir/ir/ir
depender	estar/ser
depor	declarar
depositar	entregar/dar
depravar	modificar/alterar/mudar
derivar	redundar/sobrevir/resultar/suceder/seguir
derramar	prover/abastecer/fornecer/suprir/disseminar/deslocar/mover/distribuir/espalhar
derrapar	escorregar/deslizar
derreter	liquefazer/liquidificar/dissolver
derrubar	virar-se/tornar-se/virar/dividir/cortar
desabilitar	modificar/alterar/mudar
desabotoar	desfazer
desabrochar	progredir/desenvolver
desafiar	convidar/pedir
desaguar	disseminar/distribuir/espalhar
desalojar	retirar/remover/tirar
desamarrar	desfazer
desaparafusar	afrouxar
desaparecer	sumir/deslocar/mover/mexer
desatar	desfazer
desativar	modificar/alterar/mudar
descansar	jazer/estar/ser
descartar	livrar/rejeitar
descascar	retirar/remover/tirar
descer	viajar/caminhar/ir/andar
descerrar	informar/contar
descobrir	conceitualizar/conceber/apresentar/mostrar
descolar	partir/dividir/separar
descolorir	alterar/mudar
descompor	magoar/ofender/provocar
desconcertar	concitar/elicitar/estimular/incitar/provocar
desconectar	partir/dividir/separar
descongelar	liquefazer/liquidificar
desconsiderar	tratar/rejeitar
descontrair	tornar/virar/mudar
descrever	informar/explicar
desculpar	conceder
desdobrar	desfazer/operar/deformar/funcionar
desejar	ansiar/ansiar/ansiar/ansiar/ansiar/ansiar/querer/querer/querer/querer/querer/querer/proferir/exprimir/verbalizar/expressar
desembolsar	pagar
desempacotar	retirar/remover/tirar
desempenhar	recriar/cumprir/efetuar/executar/realizar/atingir
desengatar	desfazer
desenhar	figurar/representar
desenterrar	aludir/mencionar/citar
desentranhar	retirar/remover/tirar
desenvolver	progredir/alterar/crescer/mudar/aumentar
deserdar	privar
desfazer-se	desintegrar/separar
desfilar	caminhar/ir/andar
desfrutar	empregar/utilizar/usar
desgrudar	partir/dividir/separar
desinfectar	assear/purgar/limpar
desinfetar	assear/purgar/limpar
desinformar	informar
desintegrar	mudar
desistir	descontinuar/cessar/ceder/finalizar/acabar/terminar/parar/deixar/entregar/passar/dar
desligar	ligar
deslizar	escorregar/viajar/viajar/caminhar/caminhar/ir/ir/andar/andar/deslocar/mover
deslocar	mover
deslocar-se	deslocar/mover
desmantelar	retirar/remover/tirar
desmarcar	remover/tirar
desmentir	representar
desmontar	descer/baixar/cair
desmoronar	desintegrar/mudar/mudar/separar
desnudar	retirar/limpar
desobrigar	ceder/entregar/passar/dar
desobstruir	modificar/alterar/mudar
desordenar	modificar/alterar/mudar
desorganizar	desordenar/bagunçar
desovar	causar/provocar/fazer
desoxidar	alterar/mudar
despachar	matar/transmitir/expedir/deslocar/mover/embarcar/transportar/enviar/trazer
despachar-se	viajar/caminhar/ir/andar
despedaçar	mudar
despejar	prover/abastecer/fornecer/suprir
despender	pagar
desperdiçar	delapidar/despender/dilapidar/esbanjar/gastar/empregar/utilizar/usar
despertar	tornar/virar/mudar
despidir	cumprimentar/saudar
desprender	retirar/remover/tirar
destinar	planejar
destripar	retirar/remover/tirar
destruir	estraçalhar/destroçar/arruinar
desvalorizar	humilhar/mortificar/aviltar/rebaixar
desvanecer	deslocar/mover
desventrar	retirar/remover/tirar
desvirtuar	modificar/alterar/mudar
desviscerar	retirar/remover/tirar
deter	reter/guardar/segurar/manter/desabilitar/desativar/incapacitar
deteriorar	decair/piorar/avariar/danificar
devastar	matar
dever	estar/ser
devolver	transportar/trazer/levar/tirar
devotar	empregar/utilizar/usar
dialogar	comunicar/transmitir/falar
diferenciar	caracterizar/caraterizar/distinguir/identificar/qualificar/reconhecer/separar
difundir	lançar
digladiar	brigar/disputar/lutar
dilapidar	despender/gastar
diminuir	decrescer/decrescer/desabar/desabar/modificar/alterar/minguar/minguar/reduzir/reduzir/mudar
direcionar	mirar/apontar
dirigir	governar/reger/viajar/caminhar/ir/andar/lidar/cuidar/mirar/direcionar/apontar/guiar
dirigir-se	comunicar/transmitir
disconcertar	embaraçar/constrangir/envergonhar
discriminar	distinguir/diferenciar/separar
discutir	proferir/verbalizar/conversar/conversar/falar/falar/dizer
disfarçar	omitir/tampar/tapar/acobertar/ocultar/encobrir/esconder
dispensar	tratar/entregar/dar
dispersar	partir/separar
dispor	botar/despender/gastar/pôr/colocar/carregar/providenciar/arranjar
dissipar	delapidar/dilapidar/esbanjar/desperdiçar
dissolver	mudar
distanciar	conservar/reter/manter
distanciar-se	conservar/reter/manter
distinguir	caracterizar/caraterizar/identificar/qualificar/diferenciar/reconhecer/separar
disturbar	comover/agir/afetar/impressionar/atuar/parecer/fazer
ditar	proclamar
divertir	entreter/socializar
dividir	comprar/expulsar/obter/adquirir/receber/computar/calcular/alterar/deslocar/empregar/mover/utilizar/usar/partir/mudar/mudar/mudar/separar
divisar	aperceber/aperceber-se/perceber/entender
divulgar	informar/anunciar/contar/mostrar
dizer	proferir/proferir/comunicar/comunicar/exprimir/exprimir/verbalizar/verbalizar/expressar/expressar/significar/indicar/transmitir/transmitir
dizimar	matar
doar	pagar/entregar/dar
dobrar	virar-se/tornar-se/virar/deformar
doer	aperceber/aperceber-se/perceber/entender/indispor/desconcertar/perturbar/estar/ser/confundir
dormir	repousar/descansar/jazer/cochilar
dormitar	dormir/repousar/descansar/cochilar
drenar	evaziar/esvaziar
durar	medir
ebulir	tornar/virar/mudar
ecoar	emitir/soltar/ressoar/soar/fazer
edificar	causar/criar/provocar/fazer
editar	produzir/construir/criar/fazer
educar	leccionar/lecionar/ensinar/lustrar/polir/refinar/instruir
efectivar	agir/atuar/fazer
efectuar	agir/conseguir/suceder/atuar/atingir/fazer
efetivar	agir/atuar/fazer
efetuar	encerrar/finalizar/acabar/terminar/ocasionar/agir/agir/conseguir/suceder/atuar/atuar/causar/produzir/provocar/provocar/atingir/fazer/fazer/fazer
ejetar	expulsar
elaborar	explicar
eleger	seleccionar/seleccionar/selecionar/selecionar/escolher/escolher
elevar	ampliar/comover/progredir/deslocar/emocionar/mover/estimular/excitar/aumentar
elocubrar	explicar
elogiar	medir/estimar/avaliar
elucidar	explicar
emagrecer	tornar/virar/mudar
emascular	esterilizar
embalar	tampar/cobrir
embarcar	deslocar/mover
embasbacar	mirar/observar/olhar/ver
embasbacar-se	mirar/observar/olhar/ver
embelezar	aperfeiçoar/melhorar
embonecar	aperfeiçoar/melhorar
emboscar	assaltar/atacar
embrulhar	tampar/cobrir
emendar	aperfeiçoar/melhorar
emergir	ascender/subir
emocionar	concitar/elicitar/estimular/incitar/provocar/comover/afetar/impressionar/parecer
empalidecer	descolorir/colorir
empenhar	consignar
empetecar	aperfeiçoar/melhorar
empreender	causar/provocar/fazer
empregar	utilizar/obter/adquirir/usar
emprenhar	inseminar/fecundar/fertilizar
emprestar	modificar/alterar/mudar/entregar/dar
empunhar	manejar/manusear/manipular
empurrar	forçar/deslocar/deslocar/mover/mover
enaltecer	medir/estimar/avaliar
encabeçar	dirigir/conduzir
encadernar	tampar/cobrir
encarar	virar-se/tornar-se/virar/mirar/observar/estar/olhar/ver
encerrar	modificar/alterar/mudar/finalizar/concluir/terminar
encetar	discutir
encher	modificar/modificar/alterar/alterar/mudar/mudar/dilatar-se/expandir-se/tornar/virar/mudar
encobrir	omitir/omitir/tampar/tampar/tapar/tapar/acobertar/acobertar/ocultar/ocultar/esconder/esconder
encolerizar	concitar/elicitar/estimular/incitar/provocar/irar/zangar/enraivecer
encolher	decrescer/desabar/minguar/reduzir/diminuir/diminuir
encontrar	comprar/comprar/obter/obter/adquirir/adquirir/receber/receber
encorajar	inspirar/exaltar/induzir/apoiar/suportar/ajudar/animar
encostar	deslocar/mover/mexer/estar
encriptar	codificar
encurtar	reduzir/reduzir/diminuir/diminuir
endereçar	encetar/abordar/iniciar
endurecer	comportar-se/modificar/agir/alterar/atuar/parecer/mudar/alterar/mudar
energizar	afectar/afetar
enfatizar	exprimir/expressar/mostrar
enforcar	executar
enfraquecer	decrescer/desabar/modificar/modificar/alterar/alterar/minguar/mudar/mudar/diminuir
enfurecer	encolerizar/irar/zangar/enraivecer
engajar	interessar/deslocar/mover/obter/adquirir
enganar	victimizar/vitimar/informar
engatar	deslocar/mover
engatinhar	viajar/caminhar/ir/andar
engolir	ingerir/consumir/tomar
engordar	modificar/alterar/mudar/tornar/virar/mudar
engravidar	inseminar/fecundar/fertilizar
enlatar	preservar/conservar
enlistar	obter/adquirir
enquadrar	representar
enraivecer	concitar/elicitar/estimular/incitar/sentir/experimentar/provocar
enraizar	estabilizar-se
enrijecer	modificar/alterar/mudar
enrolar	enunciar/pronunciar/articular/girar/falar/dizer
enroscar	deslocar/mover/mexer
enrubescer	descolorir/colorir
enrugar	decrescer/desabar/minguar/dobrar/dobrar/diminuir
ensaiar	balizar/desempenhar/avaliar/executar/julgar/fazer
ensinar	informar
entender	comprender/comprender/comprender/comprender/compreender/compreender/compreender/compreender/conhecer/saber
enterrar	omitir/tampar/tapar/acobertar/ocultar/encobrir/esconder
entornar	deslocar/mover
entravar	impedir/atrapalhar/evitar
entregar	regalar/regalar/ceder/ceder/ceder/oferecer/oferecer/passar/passar/passar/dar/dar/dar/dar/dar/transferir/transferir/transmitir/trazer/pegar/dar/dar/dar
entreter	divertir/sentir/experimentar/socializar
entumescer	expandir
enumerar	determinar/achar
enviar	transmitir/expedir/deslocar/deslocar/mover/mover/transferir/despachar/embarcar/transportar/transmitir/trazer/trazer
envisionar	conjeturar/conjecturar/imaginar/pensar
enxaguar	lavar
enxamear	zumbir
enxergar	aperceber/aperceber-se/perceber/entender
enxugar	modificar/alterar/modelar/esfregar/formar/mudar
equilibrar	combinar
equipar	prover/abastecer/fornecer/suprir
equiparar	modificar/alterar/mudar/julgar/pensar/considerar
erguer	botar/pôr/colocar/carregar/deslocar/mover
erradicar	matar
errar	viajar/caminhar/ir/andar
esbanjar	despender/gastar
esboroar	mudar
escanear	compreender/entender
escapar	escapulir/fugir/evadir-se/fugir/sair/partir/ir
escapulir	evadir-se/fugir/sair/escapar/partir/ir
escavar	explorar/retirar/remover/tirar
esclarecer	explicar/informar
escoar	esvaziar
escolar	lustrar/polir/refinar
escolher	seleccionar/seleccionar/seleccionar/selecionar/selecionar/selecionar/resolver/decidir
esconder	disfarçar/mascarar/omitir/omitir/tampar/tampar/tapar/tapar/acobertar/acobertar/ocultar/ocultar/encobrir/encobrir/encobrir
escorregar	deslizar/viajar/viajar/caminhar/caminhar/ir/ir/andar/andar
escovar	assear/purgar/retirar/remover/limpar/tirar
escrever	comunicar/traçar/delinear/verbalizar/transmitir
escrutinar	inspecionar/examinar/ver
escurecer	alterar/mudar
escutar	aperceber/aperceber/aperceber-se/aperceber-se/obedecer/perceber/perceber/entender/entender
esfarelar	mudar
esfregar	irritar/correr/passar
esfriar	comportar-se/modificar/agir/alterar/atuar/parecer/mudar
esganiçar	urrar/berrar/gritar
esgueirar	caminhar/ir/andar
esnobar	tratar/rejeitar
espalhar	viajar/caminhar/partir/ir/andar/separar/desaguar/derramar/estender/continuar/lançar
esparramar	estender/continuar/lançar
especular	antecipar/raciocinar/cogitar/refletir/pensar/raciocinar
esperançar	ansiar/querer/desejar
esperar	ansiar/ansiar/ansiar/antecipar/querer/querer/querer/desejar/desejar/desejar/agir/atuar/fazer
espernear	deslocar/mover/mexer
espiar	mirar/observar/olhar/ver
espionar	checar/conferir
esposar	seleccionar/selecionar/escolher/unificar/reunir
espreguiçar-se	estar
espremer	agarrar/segurar
esquecer	perder
esquentar	modificar/modificar/alterar/alterar/mudar/mudar/alterar/mudar
esquiar	viajar/caminhar/ir/andar
estabelecer	pioneirar/empreender/iniciar/representar
estabilizar-se	alterar/mudar
estacionar	botar/pôr/colocar/carregar/manobrar/canalizar/guiar/dirigir
estar	tornar/ser/ser/virar/mudar
estender	estressar/tensionar/deformar/estar/estar
estender-se	estar
esterilizar	operar
esticar	estressar/tensionar/alongar/deformar
esticar-se	estar
estimar	balizar/computar/aproximar/calcular/adivinhar/chutar/avaliar/avaliar/julgar/julgar
estimular	concitar/elicitar/incitar/provocar/afectar/afetar/apoiar/suportar/ajudar
estirar	lesionar/lesar/ferir/machucar
estorricar	secar/enxugar
estorvar	impedir/atrapalhar/evitar
estourar	falhar/desmoronar/morrer/acabar/dividir/separar
estragar	avariar/danificar/tornar/virar/mudar
estrangular	matar
estreitar	modificar/alterar/mudar/alterar/mudar
estremecer	tremular/tiritar/sacudir/tremer/tremer/agitar
estressar	afectar/afetar
estripar	retirar/remover/tirar
esvanecer	sumir/desaparecer
esvaziar	modificar/alterar/mudar/tornar/virar/mudar
esventrar	retirar/remover/tirar
etiquetar	anexar/anexar/juntar/juntar/unir/unir
evadir-se	escapulir/fugir/escapar
evaporar	mudar
evaziar	modificar/alterar/mudar
evidenciar	informar/informar/contar
eviscerar	retirar/remover/tirar
evitar	impedir/atrapalhar
evoluir	progredir/desenvolver
exacerbar	modificar/alterar/mudar
exalar	transmitir/passar
exaltar	enaltecer/elogiar/comover/louvar/emocionar/estimular/excitar
exasperar	encolerizar/irar/zangar/enraivecer
exaurir	indispor
exaurir-se	indispor
excitar	concitar/elicitar/estimular/incitar/provocar/afectar/comover/emocionar/afetar/estimular
excluir	expulsar
excruciar	angustiar/doer/machucar
executar	penalizar/punir/encerrar/castigar/matar/matar/finalizar/acabar/terminar/ocasionar/efetuar/produzir/provocar
exercer	trabalhar/empregar/utilizar/usar
exercitar	desempenhar/executar/fazer
exibir	apresentar/apresentar/mostrar/mostrar
exigir	solicitar/requisitar/demandar/requerer/pedir
exortar	assessorar/aconselhar/opinar/avisar
expandir	explicar/crescer/crescer/aumentar/aumentar
expedir	deslocar/mover
experimentar	ingerir/alterar/caber/consumir/vestir/pôr/tomar/usar/colocar/mudar
expirar	tornar/virar/mudar
explicar	informar
explodir	desmoronar/dividir/separar
explorar	empregar/empregar/utilizar/utilizar/usar/usar
expor	explicar/apresentar/mostrar
expressar	transmitir/passar
exprimir	comunicar/transmitir/transmitir/passar
expulsar	deslocar/mover
extender	alongar/alongar
exultar	animar-se/alegrar-se/alegrar/animar
fabricar	inventar/causar/pensar/criar/provocar/fazer
facilitar	acorrer/socorrer/assistir/auxiliar/ajudar
falar	leccionar/lecionar/ensinar/instruir/encetar/abordar/proferir/proferir/proferir/comunicar/comunicar/comunicar/exprimir/exprimir/verbalizar/verbalizar/verbalizar/conversar/expressar/expressar/iniciar/transmitir/transmitir/transmitir/dizer
falecer	tornar/virar/mudar
falir	avariar/danificar
falsificar	recriar
fazer	comportar-se/modificar/agir/alterar/atuar/parecer/mudar/amanhar/agir/agir/recriar/recriar/cultivar/plantar/atuar/atuar/causar/causar/causar/causar/criar/criar/criar/parecer/dirigir/provocar/provocar/provocar/provocar/conduzir
fechar	tornar/virar/mudar
fecundar	modificar/alterar/mudar
feder	recender/cheirar/recender/cheirar
fender	mudar
ferir	indispor/aleijar/doer/machucar
ferrar	malograr/fracassar/falhar
ferroar	doer
fertilizar	modificar/alterar/mudar
ferver	reduzir/diminuir/tornar/virar/mudar
ficar	tornar/estar/estar/estar/ser/ser/ser/virar/mudar/passar
figurar	conjeturar/conjecturar/imaginar/pensar
filmar	registar/registrar
finalizar	modificar/alterar/mudar/encerrar/encerrar/encerrar/concluir/concluir/concluir/terminar/terminar/terminar
financiar	entregar/dar
fingir	atuar
firmar	acordar/concordar
fitar	mirar/observar/olhar/ver
fixar	anexar/juntar/unir
florescer	progredir/crescer/desenvolver/aumentar
florir	progredir/desenvolver
fluir	manar/deslocar/mover/mexer/correr
focar	centrar/concentrar/raciocinar/cogitar/refletir/pensar
foder	acasalar/copular
fofocar	dialogar/conversar
foragir	evadir-se/fugir/escapar
forjar	moldar/moldar/modelar/modelar/formar/formar/confeccionar/fabricar/transformar/construir
formar	modificar/alterar/mudar/confeccionar/fabricar/construir
formigar	zumbir
fornecer	prover/abastecer/suprir/prover/entregar/entregar/dar/dar/dar
fortalecer	modificar/alterar/mudar
fortificar	modificar/alterar/mudar
forçar	fixar/prender/compelir/deslocar/mover/obrigar/induzir
fotografar	registar/registrar
fracassar	mudar
fraccionar	mudar
fracionar	mudar
fragmentar	desmoronar/dividir/separar
fretar	comprar/obter/adquirir/receber
frigir	cozinhar
fritar	cozinhar
fugir	escapulir/escapar/evadir-se/sair/escapar/partir/ir
fulgir	estar/ser
fulgurar	estar/ser
fumar	ingerir/consumir/tomar
funcionar	exercer/operar/operar/servir
fundar	pioneirar/empreender/iniciar
fundir	moldar/forjar/modelar/modelar/formar/formar/dissolver/mudar
furar	traspassar/doer/perfurar/penetrar/perfurar/dividir/cortar
gaguejar	proferir/verbalizar/conversar/falar/dizer
galgar	ascender/subir
ganhar	comprar/comprar/comprar/comprar/obter/obter/obter/obter/adquirir/adquirir/adquirir/adquirir/receber/receber/receber/receber
gastar	despender/pagar/pagar
gatinhar	viajar/caminhar/ir/andar
gelar	modificar/alterar/mudar/solidificar
gemer	chorar/choramingar
gerar	causar/criar/provocar/fazer
gerenciar	lidar/cuidar/guiar
gerir	governar/reger/lidar/cuidar/guiar
gesticular	comunicar/transmitir
girar	virar-se/deslocar/mover/tornar-se/mexer/virar/virar
glorificar	enaltecer/elogiar/louvar
golpear	tocar/tocar/bater/bater
gostar	considerar/achar/ver
governar	reger
gozar	empregar/utilizar/usar
gritar	urrar/berrar/proferir/verbalizar/conversar/falar/dizer
grudar	juntar/juntar/unir
guardar	sentir/experimentar/reter/segurar/ter/manter/checar/conferir
guerrear	brigar/disputar/lutar
guiar	governar/governar/reger/reger/deslocar/mover
guinchar	ressoar/soar
habitar	existir/estar/ser
habituar	modificar/alterar/mudar
habituar-se	modificar/alterar/mudar
harmonizar	corresponder/combinar/concordar
hibridizar	reproduzir/criar
hierarquizar	balizar/avaliar/julgar
hipotetizar	antecipar
hospedar	abrigar/amparar
humilhar	magoar/ofender/provocar
identificar	determinar
ignorar	tratar/rejeitar
igualar	modificar/alterar/mudar
iludir	victimizar/vitimar
iluminar	iluminar-se/alterar/mudar
iluminar-se	alterar/mudar
imaginar	causar/criar/provocar/fazer
imitar	assemelhar-se/assemelhar/reproduzir/parecer
impactar	modificar/alterar/mudar
impedir	atrapalhar/evitar
impelir	assessorar/aconselhar/opinar/avisar
imperilar	existir/ser
impetrar	requisitar/requerer/pedir
implantar	fixar/prender
importar	estar/ser
importunar	agastar/aporrinhar/vexar/chatear/aborrecer/amolar/molestar/perturbar/irritar/incomodar
imprimir	produzir/construir/criar/fazer
improvisar	desempenhar/executar/fazer
impulsionar	deslocar/mover
imputar	balizar/avaliar/julgar
incapacitar	modificar/alterar/mudar
inchar	dilatar-se/expandir-se/expandir
incinerar	mudar
inclinar	debruçar/vergar/curvar/dobrar/torcer
inclinar-se	gesticular
incluir	abarcar/conter/acrescer/somar/acrescentar/adicionar/considerar/achar/ver
incomodar	agastar/aporrinhar/vexar/chatear/aborrecer/amolar/molestar/importunar/perturbar/irritar
incorrer	alterar/mudar
incumbir	ceder/entregar/passar/dar
indagar	comunicar/transmitir
indenizar	pagar
indicar	informar/informar/informar/significar/contar/transmitir/passar
indispor	modificar/alterar/mudar
inferir	solucionar/resolver
inflar	dilatar-se/expandir-se/expandir
influenciar	impactar/afetar
influir	impactar/afetar
informar	comunicar/transmitir
ingurgitar	ingerir/consumir/tomar
iniciar	discutir/começar/causar/provocar/fazer
injustiçar	tratar
inocentar	pronunciar/rotular/julgar
inrijecer	alterar/mudar
inscrever	protocolar/registar/registrar
inseminar	modificar/alterar/mudar
inserir	anexar/juntar/unir
inspeccionar	inspecionar/examinar/ver
inspecionar	examinar/ver
inspirar	comover/emocionar/estimular/excitar
instalar	botar/botar/pôr/pôr/colocar/colocar/carregar/carregar
institucionalizar	transferir/transmitir/trazer
instruir	leccionar/lecionar/ensinar/impetrar/intimar/mandar/informar/ordenar
insultar	magoar/ofender/provocar
intensificar	acrescer/acrescentar/crescer/aumentar
inter-relacionar	estar/ser
interagir	agir/atuar/fazer
interessar	concitar/elicitar/estimular/incitar/provocar
internar	transferir/transmitir/trazer
interpretar	comprender/compreender/entender
interromper	encerrar/encerrar/encerrar/agir/atuar/suspender/finalizar/finalizar/finalizar/concluir/concluir/concluir/terminar/terminar/terminar/parar/fazer
intimar	requisitar/requerer/pedir
intimidar	comover/emocionar/estimular/excitar
intoxicar	comover/emocionar/estimular/excitar
introduzir	contar/falar/dizer/anexar/informar/juntar/unir
inundar	cobrir
invadir	assaltar/atacar
inventar	imaginar/pensar
inverter	alterar/mudar
investigar	pesquisar/examinar
investir	despender/gastar
involver	admitir/aceitar
ir	ocorrer/suceder/viajar/viajar/viajar/viajar/viajar/viajar/acontecer/caminhar/caminhar/caminhar/caminhar/caminhar/caminhar/andar/andar/andar/andar/andar/andar/passar/viajar/estar/estar/andar
irar	concitar/elicitar/estimular/incitar/provocar/encolerizar/zangar/enraivecer
ironizar	tratar
irradiar	parecer
irritar	agastar/aporrinhar/vexar/chatear/aborrecer/amolar/molestar/importunar/perturbar/incomodar/agravar/exacerbar/piorar
jazer	estar/estar/ser
jogar	competir/concorrer/propulsar/propulsionar/alinhar/apostar/impulsionar/tocar
julgar	raciocinar/cogitar/refletir/pensar/balizar/computar/calcular/avaliar/declarar/considerar/achar/ver
juntar	unir/unir/unir/ligar/ligar/ligar/reunir/reunir/reunir/unificar/unir/reunir
jurar	declarar
laborar	trabalhar
lacrimejar	chorar/choramingar
ladrar	emitir/soltar/proferir/verbalizar/conversar/falar/dizer
lamentar	sentir/experimentar/afligir-se/magoar/sofrer
lançar	propulsar/propulsionar/deslocar/deslocar/mover/mover/impulsionar/tocar
largar	alterar/deslocar/mover/mudar
lascar	dividir/cortar
latir	emitir/soltar
lavar	assear/cuidar-se/purgar/limpar/limpar
lavar-se	lavar/limpar
leccionar	informar
lecionar	informar
legar	regalar/oferecer/entregar/dar
lembrar	legar/deixar/entregar/passar/dar/pensar
lembrar-se	legar/deixar/entregar/passar/dar
ler	assinalar/compreender/compreender/indicar/entender/entender
lesar	aleijar/ferir/doer/machucar
lesionar	aleijar/ferir/doer/machucar
levantar	botar/aludir/mencionar/citar/pôr/colocar/carregar/repousar/descansar/deslocar/mover
levantar-se	aprumar/tornar/virar/mudar
levar	deslocar/mover/estar/estar
liberar	ceder/entregar/passar/dar
lidar	governar/reger/encetar/abordar/agir/agir/cuidar/atuar/atuar/guiar/iniciar/entregar/dar/fazer/fazer
liderar	dirigir/conduzir
ligar	fixar/prender/engatar/engajar
limitar	reduzir/diminuir/coibir/entravar/refrear/refrear/serenar/deter/moderar/conter/controlar/controlar
limpar	modificar/modificar/modificar/alterar/alterar/alterar/esfregar/mudar/mudar/mudar/cuidar-se/retirar/retirar/lavar/remover/remover/tirar/tirar
liquidar	matar/custear/pagar
livrar	ceder/entregar/passar/dar
lixar	alisar
logar	acessar
lograr	victimizar/vitimar
lotear	lidar/conceder/entregar
louvar	medir/estimar/avaliar/enaltecer/elogiar
lucrar	comprar/obter/adquirir/receber
lustrar	aperfeiçoar/melhorar/embonecar/empetecar/embelezar
lutar	brigar/disputar
machucar	doer/indispor/aleijar/desconcertar/ferir/doer/perturbar/confundir
macular	modificar/alterar/mudar
magoar	concitar/elicitar/estimular/incitar/provocar/sofrer
maltratar	tratar
manar	deslocar/mover/mexer
mancar	caminhar/ir/andar
manchar	modificar/alterar/mudar
mandar	requisitar/transferir/requerer/pedir/transmitir/trazer
manejar	manusear/manusear/manipular/tocar
mangar	ironizar/menosprezar/zombar
manifestar	apresentar/mostrar/transmitir/passar
manipular	manusear/tocar
manobrar	governar/reger
manter	teimar/insistir/sentir/experimentar/reter/guardar/segurar/ter/ter/ter/desabilitar/desativar/incapacitar/estar/ser/considerar/entregar/achar/ver/dar
manufaturar	inventar/pensar
manusear	tocar/tocar/bater/bater/manejar/manipular/tocar
maquiar	cuidar-se
maquilar	cuidar-se
marcar	modificar/alterar/limitar/restringir/conter/mudar/caracterizar/caraterizar/qualificar
marchar	caminhar/ir/andar
martelar	forjar/transformar
mascar	ranger
mascarar	omitir/tampar/tapar/acobertar/ocultar/encobrir/esconder
massacrar	matar/matar
mastigar	ranger
materializar	ocorrer/suceder/acontecer/passar
meandrar	estar/ser
medir	resolver/decidir/balizar/avaliar/estar/ser/julgar
melhorar	aperfeiçoar/modificar/alterar/mudar/perfazer/aperfeiçoar/tornar/virar/mudar
mencionar	associar/conectar/relacionar
mendigar	solicitar/requisitar/requerer/pedir
menosprezar	tratar/rejeitar
mensurar	resolver/decidir/exprimir/transmitir
mentir	desinformar/enganar
mesclar	amalgamar/unificar/misturar
meter	acasalar/copular
mexer	deslocar/deslocar/mover/mover
mimar	tratar
mimosear	tratar
minar	explorar
minerar	explorar
minimizar	reduzir/diminuir
mirar	checar/conferir
misturar	modificar/alterar/mudar/amalgamar/amalgamar/acrescer/somar/unificar/unificar/acrescentar/adicionar/mudar
mobiliar	prover/abastecer/fornecer/suprir
modelar	modificar/moldar/alterar/forjar/formar/mudar/confeccionar/fabricar/construir
moer	fragmentar
moldar	forjar/modelar/modelar/formar/formar/confeccionar/fabricar/construir
molestar	agastar/aporrinhar/vexar/chatear/aborrecer/amolar/importunar/perturbar/irritar/incomodar
molhar	modificar/alterar/mudar
montar	ascender/viajar/caminhar/ir/andar/subir/acasalar/copular
morar	povoar/habitar/viver/estar
morder	agarrar/segurar
mordiscar	papar/comer/agarrar/segurar
morrer	tornar/virar/mudar
mortificar	magoar/ofender/provocar
mostrar	expor/exibir/apresentar/assinalar/informar/informar/informar/apresentar/apresentar/indicar/transmitir/passar
mostrar-se	surgir/aparecer
mudar	substituir/vestir-se/arrumar-se/alterar/alterar/alterar/vestir
murchar	decrescer/decrescer/desabar/desabar/minguar/minguar/diminuir/diminuir
murmurar	proferir/proferir/proferir/verbalizar/verbalizar/verbalizar/conversar/conversar/conversar/falar/falar/falar/dizer/dizer/dizer
nadar	viajar/viajar/caminhar/caminhar/ir/ir/andar/andar
namorar	associar
narrar	informar
nascer	tornar/virar/mudar
naufragar	descer/baixar/cair
necessitar	estar/ser
negar	reter/guardar/segurar/manter
neutralizar	matar
nivelar	alterar/mudar
nomear	rotular/classificar
obedecer	confromar-se/adaptar-se/adequar-se/ajustar
obrigar	compelir/induzir/forçar
observar	checar/conferir
obter	comprar/comprar/adquirir/adquirir/receber/receber/alterar/conseguir/suceder/atingir/mudar
ocasionar	causar/provocar/fazer
ocorrer	suceder/acontecer/passar
ocupar	assaltar/interessar/trabalhar/atacar
ofender	concitar/elicitar/magoar/estimular/incitar/provocar/provocar
oferecer	agir/atuar/entregar/dar/fazer
oficiar	exercer/servir
olhar	aperceber/aperceber-se/perceber/entender/checar/conferir/mirar/observar/ver
olvidar	perder
ondular	deslocar/mover/mexer
operar	tratar/manejar/manusear/manipular
opor	rebater/refutar
ordenar	dispor/arranjar/requisitar/requerer/organizar/pedir
organizar	solicitar/requisitar/requerer/pedir/lidar/cuidar/arrumar/guiar/ordenar
oscilar	deslocar/mover/mexer
ousar	agir/agir/atuar/atuar/fazer/fazer
outorgar	alocar/causar/provocar/entregar/entregar/dar/dar/dar
ouvir	aperceber/aperceber/aperceber-se/aperceber-se/perceber/perceber/entender/entender
padecer	doer/sofrer
pagar	entregar/dar
pagodear	ironizar/menosprezar/zombar
palestrar	leccionar/lecionar/ensinar/instruir
palpitar	pulsar
papar	ingerir/consumir/comer/tomar
paparicar	zelar/cuidar
papear	dialogar/conversar
parar	descontinuar/cessar/finalizar/desistir/acabar/terminar/deixar/encerrar/suspender/finalizar/interromper/concluir/terminar
parecer	corresponder/combinar/concordar/estar/estar/ser/ser
parir	produzir/fazer
participar	agir/atuar/fazer
partilhar	comprar/obter/adquirir/receber/empregar/utilizar/usar
partir	deslocar/deslocar/mover/mover/mexer/mexer/alterar/alterar/deslocar/mover/sair/sair/sair/mudar/mudar/ir/ir/ir
passar	regalar/viajar/viajar/viajar/caminhar/caminhar/caminhar/oferecer/entregar/ir/ir/ir/andar/andar/andar/dar/transferir/transmitir/dar
passear	caminhar/caminhar/ir/ir/andar/andar
patinar	escorregar/deslizar
pedalar	ir
pedir	concitar/elicitar/solicitar/requisitar/requerer/estimular/incitar/provocar/requisitar/requerer
pegar	agarrar/capturar/segurar/alterar/anexar/agarrar/agarrar/tomar/tomar/juntar/unir/mudar/passar
pendurar	fixar/fixar/prender/prender/ornar/empetecar/enfeitar/ornamentar/embelezar/adornar/decorar
penetrar	entrar
pensar	antecipar/balizar/imaginar/imaginar/avaliar/julgar
perambular	viajar/viajar/caminhar/caminhar/ir/ir/andar/andar
perceber	aperceber/aperceber-se/entender
perder	empregar/utilizar/usar/abandonar
perdoar	conceder
perecer	tornar/virar/mudar
perfazer	aperfeiçoar/melhorar
performar	agir/atuar/fazer
perfurar	traspassar/entrar/penetrar/furar/dividir/cortar
perguntar	ruminar/cogitar/ponderar/especular/contemplar/refletir/comunicar/dirigir-se/transmitir
perigar	existir/ser
permanecer	agir/atuar/estar/estar/ser/ser/fazer
permitir	consentir/deixar/consentir/prover/aprovar/concordar/aceitar/entregar/dar/dar
permutar	trocar
perpetrar	agir/atuar/fazer
perseguir	viajar/caminhar/ir/andar
perseverar	preservar/continuar/manter
persistir	preservar/continuar/manter
personificar	atuar/representar/fazer
persuadir	influir/influenciar/induzir
pertencer	estar/estar/estar/ser/ser
perturbar	concitar/elicitar/estimular/incitar/provocar/comover/agir/afetar/impressionar/atuar/parecer/fazer
perverter	modificar/alterar/mudar
pesar	estar/ser
pesquisar	analizar/examinar
pestanejar	reagir
picar	doer
pigarrear	retirar/remover/tirar
pilotar	operar/controlar
pinar	acasalar/copular
pincelar	criar/fazer
pintar	figurar/revestir/criar/representar/cobrir/fazer
pioneirar	causar/provocar/fazer
piorar	modificar/alterar/decair/decair/mudar/tornar/virar/mudar
pisar	viajar/caminhar/ir/andar
piscar	reagir
planear	pretender
planejar	raciocinar/cogitar/refletir/pensar/prognosticar/predizer/pretender/prever/avaliar/considerar/achar
plantar	botar/botar/pôr/pôr/colocar/colocar/carregar/carregar
plasmar	moldar/forjar/modelar/formar
poder	despender/gastar
polir	aperfeiçoar/melhorar/embonecar/perfazer/empetecar/aperfeiçoar/embelezar
ponderar	ruminar/raciocinar/cogitar/cogitar/especular/contemplar/refletir/refletir/pensar
pontuar	acrescer/somar/exprimir/acrescentar/expressar/adicionar/mostrar
portar	apresenta/dispõe
posar	botar/pôr/colocar/carregar
posicionar	botar/pôr/colocar/carregar
pospor	adiar
possibilitar	prover/dar
possuir	apresenta/dispõe
postergar	adiar
poupar	reter/guardar/segurar/manter
povoar	estar
prantear	afligir-se/magoar/sofrer
praticar	desempenhar/executar/fazer
preceder	contar/falar/dizer
precisar	estar/ser
prefaciar	contar/falar/dizer
pregar	anexar/juntar/unir
premiar	alocar
prender	agarrar/capturar/segurar/pegar/desabilitar/desativar/incapacitar/anexar/anexar/juntar/juntar/unir/unir
prensar	tocar/bater
preparar	leccionar/lecionar/ensinar/modificar/alterar/instruir/mudar/confeccionar/fabricar/causar/construir/criar/provocar/fazer
presentear	alocar
preservar	cozinhar/preparar/reter/guardar/segurar/manter
pressagiar	informar/contar
pressionar	tocar/bater
pressupor	antecipar
prestar	entregar/dar
presumir	antecipar
prever	informar/contar
prezar	considerar/achar/ver
privar	reter/conter
proceder	agir/atuar/fazer
proclamar	proferir/verbalizar/conversar/falar/dizer
procrastinar	adiar
procriar	causar/criar/provocar/fazer
procurar	buscar/agir/inspecionar/atuar/examinar/ver/fazer
produzir	amanhar/cultivar/plantar/causar/causar/criar/provocar/provocar/fazer/fazer
proferir	comunicar/transmitir
progredir	modificar/alterar/viajar/caminhar/mudar/ir/andar/crescer/desenvolver/aumentar
proliferar	crescer/aumentar
prolongar	alongar
prometer	estar/ser/declarar/declarar
promover	aconselhar/sugerir/propor/delegar/apoiar/suportar/ajudar
pronunciar	julgar/declarar
propor	declarar/representar
proporcionar	prover/dar
propulsar	deslocar/mover
propulsionar	empurrar/forçar/deslocar/mover
prorrogar	adiar/alongar
prosear	dialogar/conversar
prosseguir	ocorrer/suceder/viajar/acontecer/caminhar/ir/andar/passar/agir/atuar/fazer
proteger	defender
protelar	adiar
protestar	opor
protocolar	registar/registrar
provar	ingerir/informar/consumir/estar/ser/tomar
prover	abastecer/fornecer/suprir/entregar/entregar/dar/dar
providenciar	prover/acordar/concordar/dar
provisionar	entregar/dar
provocar	agastar/aporrinhar/vexar/concitar/elicitar/chatear/aborrecer/amolar/molestar/importunar/estimular/incitar/perturbar/irritar/incomodar/comover/emocionar/causar/causar/causar/estimular/excitar/criar/criar/fazer/fazer/fazer
publicar	produzir/construir/criar/fazer
pulsar	deslocar/mover/mexer
pulular	apinhar/zumbir
purgar	modificar/alterar/mudar
puxar	lesionar/lesar/ferir/machucar/deslocar/mover
pôr	botar/botar/botar/colocar/colocar/colocar/carregar/carregar/carregar/vestir-se/arrumar-se/deslocar/mover/vestir
qualificar	bastar/lembrar/pensar/servir
qualificar-se	bastar/servir
quantificar	exprimir/transmitir
quebrar	partir/dividir/dividir/separar/separar
quedar	estar/ser
queimar	tratar/avariar/danificar/tornar/falhar/morrer/acabar/virar/mudar/mudar
querer	ansiar/ansiar/ansiar/ansiar/ansiar/ansiar/desejar/desejar/desejar/desejar/desejar/desejar
questionar	ruminar/cogitar/ponderar/especular/contemplar/refletir/dirigir-se
raciocinar	cogitar/refletir/pensar
radiar	parecer
ralar	trabalhar
ranger	fragmentar
ranquiar	balizar/avaliar/julgar
raptar	capturar/tomar/pegar
rascar	cortar
rasgar	partir/dividir/separar
raspar	lesionar/lesar/ferir/machucar/tocar/bater/cortar
rastejar	viajar/caminhar/ir/andar
rastejar-se	viajar/caminhar/ir/andar
ratear	ressoar/soar/fazer
re-adquirir	comprar/obter/adquirir/receber
re-ocorrer	ocorrer/suceder/acontecer/passar
reagir	comportar-se/agir/atuar/parecer/agir/atuar/fazer
realizar	encerrar/finalizar/acabar/terminar/ocasionar/conseguir/cumprir/efetuar/efetuar/conhecer/suceder/causar/produzir/saber/executar/satisfazer/criar/provocar/provocar/entender/atingir/atingir/fazer
reapresentar	informar/contar
rebaixar	magoar/ofender/provocar/humilhar/mortificar/aviltar/deslocar/mover
rebater	repudiar/renunciar
receber	comprar/obter/adquirir/alterar/alterar/mudar/mudar
recender	cheirar/parecer
rechaçar	deslocar/mover
recitar	ecoar/repetir
reclamar	solicitar/requisitar/requerer/pedir/proferir/verbalizar/conversar/falar/dizer
recomendar	aconselhar/sugerir/propor
recompensar	pagar
reconciliar	acordar/concordar
reconhecer	recordar-se/lembrar-se/recordar/lembrar/valorizar/determinar/apreciar
reconquistar	comprar/obter/adquirir/receber
recontar	informar
recorrer	ocorrer/suceder/acontecer/passar
recriar	causar/causar/criar/criar/provocar/provocar/fazer/fazer
recrutar	enlistar/protocolar/empregar/engajar/registar/registrar
recuperar	comprar/obter/adquirir/receber/melhorar
recusar	reagir/responder
redigir	comunicar/transmitir
redizer	informar/contar
redundar	resultar/provar
reduzir	modificar/alterar/mudar/diminuir/diminuir/diminuir
referir	associar/conectar/relacionar
referir-se	pertencer
refinar	aperfeiçoar/melhorar
refletir	raciocinar/cogitar/pensar
refrear	coibir/entravar/serenar/deter/moderar/conter
refrescar	modificar/alterar/mudar
refrigerar	modificar/alterar/mudar
refulgir	estar/ser
refutar	repudiar/renunciar
reganhar	comprar/comprar/obter/obter/adquirir/adquirir/receber/receber
reger	governar
registar	redigir/escrever/protocolar/poupar/preservar/conservar/guardar/registrar/registrar/manter
registrar	redigir/escrever/protocolar/assinalar/poupar/preservar/conservar/registar/registar/guardar/indicar/manter
regozijar	sentir/experimentar
regozijar-se	sentir/experimentar
regulamentar	resolver/decidir
regularizar	dispor/arranjar/resolver/decidir
reinar	governar/reger
reincidir	ocorrer/suceder/acontecer/passar
reintegrar	pagar
reinvindicar	teimar/insistir/comportar-se/resistir/conduzir
reiterar	agir/informar/atuar/contar/fazer
reivindicar	solicitar/solicitar/requisitar/requisitar/requerer/requerer/pedir/pedir
rejeitar	balizar/reagir/responder/avaliar/julgar
rejubilar	animar-se/alegrar-se/alegrar/animar
relacionar	raciocinar/cogitar/refletir/pensar/interagir/estar/ser
relacionar-se	interagir
relatar	informar/anunciar/mostrar
relaxar	tornar/tornar/virar/virar/mudar/mudar
relinchar	emitir/soltar
remendar	reparar/emendar/consertar
remeter	transmitir/transmitir/trazer/pegar
remover	retirar/retirar/tirar/tirar
render-se	regalar/oferecer/entregar/dar
renunciar	ceder/entregar/passar/dar/rejeitar
repagar	pagar
reparar	aperfeiçoar/melhorar
repartir	mudar
repetir	emitir/ocorrer/suceder/soltar/acontecer/passar/agir/informar/atuar/contar/fazer
replicar	contar/falar/dizer
reportar	anunciar/anunciar/mostrar/mostrar
repousar	jazer/estar/ser
representar	contar/falar/dizer/proferir/figurar/recriar/exprimir/verbalizar/atuar/expressar/fazer
reproduzir	produzir/produzir/construir/construir/criar/criar/fazer/fazer/causar/criar/provocar/fazer
repudiar	rejeitar
reputar	pensar/achar
requerer	solicitar/requisitar/demandar/exigir/pedir/estar/ser
resfriar	modificar/alterar/mudar
resgatar	retirar/remover/tirar
resistir	brigar/agir/portar/atuar/defender/lutar/fazer
resmungar	proferir/verbalizar/conversar/falar/dizer
resolver	aperfeiçoar/comprender/compreender/melhorar/entender/encerrar/finalizar/concluir/terminar
respeitar	considerar/achar/ver
respigar	coligir/ajuntar/recolher/coletar/juntar/reunir
responder	contar/falar/dizer
ressecar	secar/enxugar
ressoar	soar/soar/soar/parecer/fazer/fazer/fazer
restabelecer	renovar
restituir	pagar
restringir	reduzir/diminuir/refrear/refrear/limitar/limitar/controlar/controlar
resultar	redundar/sobrevir/suceder/provar/estar/ser/seguir
resumir	reduzir/diminuir
resvalar	escorregar/deslizar
reter	negar/guardar/guardar/segurar/segurar/ter/manter/manter/desabilitar/desativar/incapacitar/agir/impedir/atrapalhar/atuar/evitar/fazer
retificar	inverter/reverter/tornar/virar
retirar	remover/remover/tirar/tirar
retorcer	modelar/formar
retornar	transportar/trazer/levar/tirar
retratar	atuar/representar/fazer
retribuir	pagar
retrucar	contar/falar/dizer
reunir	ingressar/juntar-se/acrescer/somar/associar-se/acrescentar/adicionar
reunir-se	encontrar/reunir
revelar	informar/apresentar/contar/mostrar
reverberar	ressoar/soar/fazer
reverter	alterar/mudar
revestir	tampar/tampar/cobrir/cobrir
revirar	buscar/procurar/deslocar/mover
revistar	inspecionar/examinar/ver
revolver	deslocar/mover
ridicularizar	ironizar/menosprezar/zombar
rir	ironizar/menosprezar/zombar
rodar	viajar/girar/caminhar/virar/ir/andar/deslocar/mover
rodear	encostar/tocar
rolar	deslocar/mover/mexer/achatar/aplainar/enxugar
romper	dividir/separar
ronronar	ressoar/soar/fazer
rosar	descolorir/colorir
rotular	denominar/anexar/designar/julgar/juntar/declarar/unir
roçar	esfregar/tocar/bater
ruborizar	descolorir/colorir
rugir	ressoar/soar
ruminar	raciocinar/cogitar/refletir/pensar
sacanear	ironizar/menosprezar/zombar
sacar	retirar/retirar/retirar/remover/remover/remover/tirar/tirar/tirar
sacudir	deslocar/mover/mexer/oscilar
sair	deslocar/mover/mexer/alterar/partir/partir/partir/mudar/ir/ir/ir
salpicar	desaguar/derramar
sarar	melhorar
satisfazer	corresponder/combinar/concordar/provisionar/prover/abastecer/fornecer/servir
saudar	acostar/comunicar/cumprimentar/transmitir
secar	modificar/alterar/mudar/alterar/mudar
sediar	abrigar/amparar
seguir	viajar/viajar/caminhar/caminhar/ir/ir/andar/andar/agir/perseguir/resultar/atuar/provar/fazer
segurar	agarrar/agarrar/capturar/capturar/reter/guardar/ter/pegar/pegar/manter/agarrar/tomar/pegar
seleccionar	resolver/decidir
selecionar	resolver/decidir
semear	botar/pôr/colocar/carregar
sentar	botar/pôr/colocar/carregar
sentar-se	botar/pôr/colocar/carregar/estar
sentir	aperceber/aperceber-se/perceber/entender
separar	deslocar/mover/expulsar/mexer/alterar/deslocar/mover/identificar/reconhecer/partir/mudar/mudar/mudar/mudar/dividir
sepultar	omitir/tampar/tapar/acobertar/ocultar/encobrir/esconder
sequestrar	capturar/tomar/pegar
seqüestrar	capturar/tomar/pegar
ser	estar
serpear	viajar/caminhar/ir/andar
serrar	dividir/cortar
servir	trabalhar/bastar/provisionar/provisionar/operar/cumprir/prover/prover/abastecer/abastecer/fornecer/fornecer/funcionar/trabalhar/estar/ser/realizar/satisfazer/entregar/passar/dar
significar	indicar/transmitir/passar
simular	reproduzir/atuar/fingir
sinalizar	botar/pôr/colocar/carregar/informar/contar
sitiar	assaltar/atacar
situar	botar/pôr/colocar/carregar/deslocar/mover
soar	ressoar/ressoar/parecer/fazer/fazer
sobrevir	resultar/provar
sobreviver	agir/atuar/fazer
socorrer	apoiar/suportar/ajudar
sofrer	sentir/experimentar/alterar/experimentar/estar/ser/ter/mudar
solicitar	requisitar/requerer/pedir
solidificar	mudar
soltar	proferir/deslocar/exprimir/mover/verbalizar/expressar
solucionar	comprender/compreender/entender
somar	acrescer/acrescentar/crescer/aumentar
sonecar	dormir/repousar/descansar/cochilar
sonhar	aperceber/aperceber-se/perceber/entender
sorver	beber/tomar
soterrar	omitir/tampar/tapar/acobertar/ocultar/encobrir/esconder
subir	ascender/ascender/viajar/caminhar/ir/andar/crescer/crescer/aumentar
subjazer	estar/ser
submergir	tampar/cobrir/deslocar/mover
submeter-se	entregar/dar
subornar	pagar
substanciar	causar/criar/provocar/fazer
substituir	modificar/alterar/mudar/renovar
subtrair	computar/calcular
subverter	modificar/alterar/mudar
suceder	ocorrer/acontecer/passar/resultar/provar
sucumbir	entregar/dar
sufocar	matar
sugar	beber/tomar
sugerir	informar/contar/declarar
sujar	modificar/alterar/mudar
sulcar	dividir/cortar
superar	concitar/elicitar/estimular/incitar/provocar
superproteger	zelar/cuidar
suplementar	anexar/juntar/unir
supor	solucionar/antecipar/antecipar/antecipar/resolver
suportar	consentir/permitir/deixar
suprir	prover/prover/abastecer/abastecer/fornecer/fornecer/provisionar/prover/abastecer/fornecer/servir/entregar/dar
surgir	parecer
surpreender	agir/atuar/fazer
suspender	pendurar/encerrar/encerrar/encerrar/finalizar/finalizar/finalizar/concluir/concluir/concluir/terminar/terminar/terminar
suspirar	ansiar/querer/desejar
sussurrar	proferir/ressoar/verbalizar/conversar/soar/falar/dizer/fazer
sustentar	teimar/insistir/sentir/experimentar/ter
tagarelar	proferir/verbalizar/conversar/falar/dizer
telecomunicar	comunicar/transmitir
telefonar	telecomunicar
tensionar	afectar/afetar
tentar	balizar/comover/agir/emocionar/atuar/estimular/avaliar/excitar/julgar/fazer
teorizar	antecipar
ter	abarcar/incluir/conter/apresenta/dispõe/vivenciar/experienciar/doer/produzir/experimentar/experimentar/sofrer/fazer
terminar	modificar/alterar/mudar/cessar/encerrar/encerrar/encerrar/encerrar/finalizar/finalizar/finalizar/finalizar/concluir/concluir/concluir/acabar/parar
testar	balizar/avaliar/julgar
testemunhar	informar
testificar	informar
tique-taque	ressoar/soar/fazer
tirar	cerrar/fechar/deslocar/mover/retirar/retirar/retirar/retirar/retirar/remover/remover/remover/remover/remover/remover
tiritar	estremecer/tremular/sacudir/tremer/tremer/agitar
tirotear	lesionar/lesar/ferir/machucar
tocar	desempenhar/apresentar/fazer/bater/deslocar/deslocar/mover/mover/ressoar/soar/fazer
tolerar	consentir/permitir/deixar
tolher	impedir/atrapalhar/evitar
tomar	ingerir/ingerir/consumir/consumir/agarrar/pegar
tombar	perecer/falecer/expirar/morrer
topar	comprar/obter/adquirir/receber
torcer	modelar/formar/deformar
torcer-se	deslocar/mover/mexer
tornar	alterar/alterar/virar/mudar/mudar/mudar
tornar-se	deslocar/mover/mexer
torrar	despender/gastar
torturar	angustiar/doer/machucar
tossir	retirar/remover/tirar
tostar	esquentar/aquecer
totalizar	estar/ser
trabalhar	transubstanciar/transmudar/manejar/manusear/manipular/transformar
traduzir	modificar/comprender/alterar/compreender/entender/mudar
tramitar	interagir
trancar	fixar/prender
transaccionar	interagir
transacionar	interagir
transar	acasalar/copular
transcrever	escrever
transferir	ceder/entregar/passar/dar/deslocar/mover
transformar	modificar/modificar/modificar/moldar/alterar/alterar/alterar/forjar/modelar/formar/mudar/mudar/mudar/alterar/mudar
transladar	deslocar/mover
transmitir	ceder/entregar/passar/dar/interagir/comunicar/deslocar/deslocar/mover/mover/informar/contar/enviar/dar
transmudar	modificar/modificar/alterar/alterar/mudar/mudar
transmutar	alterar/mudar
transportar	deslocar/deslocar/deslocar/mover/mover/mover
transubstanciar	modificar/alterar/mudar
trapacear	victimizar/vitimar
traspassar	entrar
tratar	encetar/interagir/abordar/lidar/cuidar/guiar/iniciar
trautear	cantar
trazer	modificar/alterar/mudar/deslocar/deslocar/mover/mover/apresentar/mostrar
traçar	marcar
treinar	leccionar/leccionar/lecionar/lecionar/ensinar/ensinar/lustrar/polir/refinar/instruir/instruir/refrear/limitar/controlar
tremelicar	estremecer/tremular/tiritar/tremer
tremer	arredar/estremecer/tremular/tiritar/deslocar/mover/puxar/mexer/sacudir/agitar/tirar
tremular	sacudir/tremer/agitar
trepar	ascender/subir/acasalar/copular
tresandar	recender/feder/cheirar
trinar	cantar
triturar	fragmentar
trocar	modificar/alterar/substituir/mudar/vestir-se/arrumar-se/transferir/vestir
tropeçar	caminhar/ir/andar
trucidar	matar
uivar	ressoar/soar
unificar	modificar/alterar/mudar/ingressar/juntar-se/associar-se
unir	juntar/juntar/juntar/ligar/ligar/ligar/reunir/reunir/reunir/acrescer/somar/acrescentar/adicionar
urgir	aconselhar/sugerir/propor/assessorar/aconselhar/opinar/avisar
usar	ingerir/vestir-se/arrumar-se/empregar/utilizar/consumir/vestir/tomar
vacilar	adiar
vadear	caminhar/ir/andar
vadiar	viajar/caminhar/ir/andar
vagabundear	viajar/caminhar/ir/andar
vagar	viajar/viajar/viajar/caminhar/caminhar/caminhar/ir/ir/ir/andar/andar/andar
vaguear	viajar/caminhar/ir/andar
valer	estar/ser
validar	revalidar/corroborar/substanciar/confirmar/sustentar/provar/suportar
valorizar	considerar/achar/ver
vaporizar	mudar
varrer	deslocar/deslocar/mover/mover/mexer/mexer/assear/purgar/limpar
vasculhar	revistar/buscar/procurar
vassourar	deslocar/mover/mexer
vender	estar/ser/trocar
venerar	considerar/achar/ver
ver	aperceber/aperceber/aperceber-se/aperceber-se/conjeturar/conjecturar/imaginar/perceber/perceber/pensar/pensar/entender/entender/achar/avistar/divisar/checar/conferir/mirar/mirar/observar/observar/olhar/olhar
verbalizar	comunicar/causar/criar/transmitir/provocar/fazer
vergar	deformar
verter	deslocar/mover
vestir	vestir-se/arrumar-se/alterar/mudar
vestir-se	alterar/mudar
viajar	caminhar/caminhar/ir/ir/andar/andar
viciar	modificar/alterar/mudar
victimizar	injustiçar/maltratar
vir	viajar/caminhar/ir/andar
virar	virar-se/virar-se/virar-se/deslocar/deslocar/mover/mover/tornar-se/tornar-se/tornar-se/mexer/mexer/alterar/alterar/deslocar/mover/mudar/mudar
virar-se	deslocar/mover/mexer/agir/atuar/fazer
vislumbrar	mirar/observar/olhar/ver
vistoriar	inspecionar/examinar/ver
visualizar	conjeturar/conjecturar/imaginar/pensar
vitimar	injustiçar/maltratar
viver	estar
voar	operar/viajar/caminhar/controlar/ir/andar/viajar/ir/andar
vociferar	proferir/verbalizar/conversar/falar/dizer
voltar	transportar/trazer/levar/tirar
voluntariar	agir/atuar/fazer
votar	seleccionar/selecionar/escolher
zangar	concitar/elicitar/estimular/incitar/provocar
zoar	ironizar/menosprezar/zombar
zombar	tratar/ironizar/menosprezar
zumbir	estar/ser

