abiência	psicologia
absorbância	física
absortividade	física
absorção	quimica/física/química
acatexia	psicanálise
aceleração	física
acento	linguagem/discurso/idioma/língua
acta	jurisprudência/lei
actuário	estatística/estatísticas/estatística
acusado	jurisprudência/lei
adiência	psicologia
administração	industria/empresa/negócio/comércio
adoção	jurisprudência/jurisprudência/lei/lei
advocacia	jurisprudência/lei
advogado	jurisprudência/jurisprudência/jurisprudência/jurisprudência/lei/lei/lei/lei
adágio	música
afinação	música
agente	esporte
alegação	jurisprudência/jurisprudência/lei/lei
alternador	auto/automóvel/viatura/carro/veículo
aluguel	auto/auto/automóvel/automóvel/viatura/viatura/carro/carro/veículo/veículo
amarra	batel/bote/escaler/barco
amnistia	jurisprudência/lei
amostragem	estatística/estatísticas/estatística
anafilaxia	entorpecente/droga/medicamento/remédio
analepse	literatura
andada	basebol/beisebol
andamento	música
anfiteatro	dramaturgia/teatro
anistia	jurisprudência/lei
anulação	jurisprudência/lei
análise	matematica/matemática
apanhador	basebol/beisebol
apelação	jurisprudência/lei
apelo	jurisprudência/lei
arapuca	criatura/animal/besta/bicho/ser
arbitragem	jurisprudência/lei
arco	arquitetura/arquitetura/arquitectura/arquitectura
argüido	jurisprudência/lei
arioso	música
aristotelismo	filosofia/filosofia
aritmética	matematica/matematica/matemática/matemática
armadilha	criatura/animal/besta/bicho/ser
armazenamento	informática
arquitectura	informática/arquitetura
arquitetura	informática/arquitectura
arquivo	informática
arredondamento	matematica/matemática
arremesso	basebol/beisebol
arrendamento	auto/automóvel/viatura/carro/veículo
art.	contrato/acordo
artigo	gramática/contrato/acordo
ascii	informática/informática
assento	dramaturgia/aeroplano/avião/teatro
assimetria	matematica/matemática
assistência	basquete/basquetebol/bola-ao-cesto/basebol/basquetebol/beisebol
associacionismo	psicologia
assombração	folclore/folclore
astucidade	industria/empresa/negócio/comércio
astúcia	industria/empresa/negócio/comércio
ato	jurisprudência/jurisprudência/lei/lei
atractor	física
atuário	estatística/estatísticas/estatística
autogolo	futebol
avaliador	arte
backup	informática
bancarrota	jurisprudência/lei
banshee	folclore/folclore/folclore/folclore
batedor	basebol/beisebol
batida	basebol/beisebol
baud	informática/informática
bbs	informática
becape	informática
beisebolistas	basebol/beisebol
belas-artes	arte
beque	futebol
bigamia	jurisprudência/lei
binómio	matematica/matemática
binômio	matematica/matemática
bloco	informática
brecha	contrato/acordo
buffer	informática
cache	informática
cachê	informática
cadeia	industria/quimica/empresa/negócio/comércio/química
cadeira	dramaturgia/aeroplano/avião/teatro
calculadora	informática
calculo	matematica/matemática
calma	poema/verso/poesia
canal	rio
capitalista	industria/empresa/negócio/comércio
cardinalidade	matematica/matemática
carta-patente	jurisprudência/lei
casa	dramaturgia/jurisprudência/lei/teatro
casal	jurisprudência/lei
casamento	jurisprudência/lei
castidade	religião/fé
catalisador	quimica/química
catarse	psicanálise
catexia	psicanálise
causa	jurisprudência/jurisprudência/lei/lei
celibato	religião/fé
charanga	música
chateação	jurisprudência/lei
chinês	industria/empresa/negócio/arte/comércio
cidadania	jurisprudência/lei
cine	industria/empresa/negócio/arte/comércio
cinema	industria/empresa/negócio/arte/comércio
circulação	flora/planta/vegetal
circum-navegação	aeroplano/avião
circumnavegação	aeroplano/avião
citação	jurisprudência/jurisprudência/lei/lei
claustro	religião/fé
cliente	informática/jurisprudência/lei
cláusula	gramática/contrato/acordo
co-variância	estatística/estatísticas/estatística
cobrador	colectas/impostos/imposto/taxação/taxa/tributo
coca	flora/planta/vegetal
codicilo	jurisprudência/lei
coesão	física
coima	jurisprudência/lei
coletor	colectas/impostos/basebol/beisebol/imposto/taxação/taxa/tributo
colisão	física
coluna	arquitetura/arquitetura/arquitectura/arquitectura
comensalismo	flora/planta/vegetal
common-law	jurisprudência/lei
compilador	informática
comportamento	psicologia
computador	informática
condenação	jurisprudência/lei
condicional	jurisprudência/lei
confluência	rio
conformista	religião/fé
conjunto	matematica/matemática
consagração	religião/fé
console	calculadora/computador
conspiração	jurisprudência/lei
constituinte	gramática/jurisprudência/lei
constituição	jurisprudência/lei
consumo	economia
contagem	eleição
contra-ataque	basquete/basquetebol/bola-ao-cesto/basquetebol
contrariedade	jurisprudência/lei
contraste	quimica/química/fotografia
contratador	jurisprudência/lei
contrato	bíblia/jurisprudência/lei/acordo
controlador	informática
conúbio	jurisprudência/lei
corcel	literatura
corda	música
corpo	matematica/matemática/criatura/animal/besta/bicho/humano/ser
correlação	estatística/estatísticas/estatística
corte	jurisprudência/lei
costa	rio/oceano/lago
costume	psicologia
covariância	estatística/estatísticas/estatística
cpu	informática
crache	informática
cronista	história/história
crónica	história/história
crônica	história/história
cultivo	agricultura/pecuária
curador	jurisprudência/lei
cursor	informática
curva	rio
cáculo	matematica/matemática
cálculo	matematica/matematica/matemática/matemática
código	informática
código-fonte	engenharia/tecnologia
cópia	jurisprudência/lei
debênture	jurisprudência/lei
declaração	jurisprudência/lei
decreto	jurisprudência/lei
defensor	jurisprudência/lei
delusão	psicologia
demodulação	electrónica/eletronica/eletrónica/eletrônica/eletrônica
demonstração	matematica/matemática
depoimento	jurisprudência/lei
derivativo	jurisprudência/lei
derivativos	jurisprudência/lei
desacato	jurisprudência/lei
desaceleração	física
desapropriação	jurisprudência/lei
desconstrução	filosofia/filosofia/literatura/literatura
desvio	aeroplano/avião
desvio-padrão	estatística/estatísticas/estatística
determinismo	filosofia
diabo	religião/fé
diagonal	matematica/matemática
diamante	basebol/beisebol
difusão	física
direito	jurisprudência/jurisprudência/lei/lei
diretório	informática
disco	informática
discurso	linguagem/música/arte/idioma/língua
dissociação	quimica/química
distúrbio	jurisprudência/lei
ditame	jurisprudência/lei
divorcio	jurisprudência/lei
divórcio	jurisprudência/lei
dolo	jurisprudência/lei
domicílio	jurisprudência/lei
dominante	música
dominio	informática
domínio	informática/matematica/matemática
dongle	informática
dono	jurisprudência/lei
dor	poema/verso/poesia
drible	basquete/basquetebol/bola-ao-cesto/basquetebol/futebol
dualidade	física
duende	folclore/folclore/folclore/folclore
e-mail	informática
editor	informática
educação	didáctica/didáctica/ensinamento/ensinamento/ensino/ensino/pedagogia/pedagogia/instrução/instrução/formação/formação
electrólise	quimica/química
eletronegatividade	quimica/química
eletrólise	quimica/química
elfo	folclore/folclore
email	informática
empirismo	filosofia
empresa	industria/negócio/comércio
emulsão	quimica/química
encarceramento	jurisprudência/lei
encargo	colectas/impostos/imposto/taxação/taxa/tributo
enchente	engenharia/tecnologia
energia	física
ensaio	concertos/concerto/show
ensino	didáctica/ensinamento/pedagogia/educação/instrução/formação
enxerto	cirurgia
eprom	informática
equaçao	matematica/matemática
equação	matematica/matemática
equações	matematica/matemática
erin	poema/verso/poesia
erro	basebol/beisebol
espalação	física
estabelecimento	industria/empresa/negócio/comércio
estatuo	jurisprudência/lei
estatuto	jurisprudência/lei
estatística	estatísticas
estatístico	estatística/estatísticas/estatística
estequiometria	quimica/química
estilo	linguagem/música/arte/discurso/idioma/língua
estoicismo	filosofia
estética	filosofia/arte/arte
evidência	matematica/matemática/jurisprudência/lei
execução	informática/jurisprudência/jurisprudência/lei/lei
exegese	bíblia/bíblia
existencialismo	filosofia/filosofia
exposição	arte
exposições	arte
expressão	matematica/matemática
extrapolação	matematica/matemática
extroversão	psicologia
extrovertido	psicologia
exórdio	retorica/retórica/retórica
fadiga	psicologia
falta	esporte
falência	jurisprudência/lei
fanfarra	música
fatoração	matematica/matemática
fbi	jurisprudência/lei
fenestração	arquitetura/arquitectura
fermata	música
fiança	jurisprudência/lei
ficheiro	informática
filósofo	filosofia
firewall	informática/informática
firmware	informática
fitoterapia	flora/flora/planta/planta/vegetal/vegetal
flora	planta/vegetal
fluoresceina	soluto/soluto/solução
fluoresceína	soluto/soluto/solução
fluorocarbono	quimica/química
fluxo	física
fonte	engenharia/tecnologia
forehand	ténis/tênis
formalismo	filosofia
formatação	calculadora/computador
formato	calculadora/computador
força	física
fotossintese	flora/planta/vegetal
fotossíntese	flora/flora/planta/planta/vegetal/vegetal
fractal	matematica/matemática
frade	religião/fé
fragmentação	informática
ftp	informática
fulereno	quimica/química
fullback	futebol
fumble	basebol/beisebol
função	matematica/matemática
físico	física
fórmula	matematica/matematica/matemática/matemática
gabriel	bíblia
gama	música
game	ténis/tênis
generalização	psicologia
geodésica	matematica/matemática
geometria	matematica/matemática
gerenciamento	industria/empresa/negócio/comércio
gestalt	psicologia
gestão	industria/empresa/negócio/comércio
gol-contra	futebol
gravidade	física
gravitação	física
gás	fábrica/usina/planta
handshake	contrato/acordo
hard-drive	informática
hardware	informática
herança	jurisprudência/jurisprudência/lei/lei
historiador	história/história
historiografo	história/história
hobgoblin	folclore/folclore
holometabolismo	insectos/insetos/hemípteros/insecto/inseto
honorário	jurisprudência/lei
humanidade	criatura/animal/besta/bicho/ser
hábito	psicologia/religião/fé
idealismo	filosofia/filosofia
idioma	linguagem/discurso/língua
imagem	matematica/matemática
impedimento	esporte
imposto	colectas/impostos/taxação/taxa/tributo
impressora	informática
incensário	religião/fé
incômodo	jurisprudência/lei
indicador	quimica/química
indulto	jurisprudência/lei
indústria	manufatura
inferno	religião/fé
infinitesimal	matematica/matemática
informática	calculadora/computador
inibição	psicologia
inicialização	informática
injunção	jurisprudência/lei
instrução	informática/informática
intensificação	fotografia
interbases	basebol/beisebol
interdição	jurisprudência/lei
interoperabilidade	informática
interpolação	matematica/matemática
interpretador	informática
intimação	jurisprudência/jurisprudência/lei/lei
introvertido	psicologia
intérprete	informática
invariante	matematica/matemática
invariância	matematica/matemática
inércia	física
irmão	religião/fé
isolda	apólogo/lenda
isometria	ontogenia/ontogénese/crescimento
isotropia	física
iteração	informática
janela	informática/informática
jogada	basebol/beisebol/jogo
jogo	esporte
judiciário	jurisprudência/lei
juiz	esporte
julgamento	jurisprudência/jurisprudência/jurisprudência/lei/lei/lei
jurisconsulto	jurisprudência/lei
jurisdição	jurisprudência/lei
jurista	jurisprudência/jurisprudência/lei/lei
justiça	jurisprudência/jurisprudência/lei/lei
juízo	jurisprudência/lei
júri	jurisprudência/lei
lado	criatura/animal/besta/bicho/humano/ser
lance	esporte
legado	jurisprudência/jurisprudência/lei/lei
legalização	jurisprudência/lei
legislador	jurisprudência/jurisprudência/lei/lei
legislação	jurisprudência/jurisprudência/lei/lei
legitimação	jurisprudência/lei
lei	jurisprudência/jurisprudência
leis	jurisprudência/jurisprudência/lei/lei
libelo	jurisprudência/lei
libido	psicanálise
licantropia	folclore/folclore
licenciamentos	jurisprudência/lei
licença	jurisprudência/lei
ligadura	música
limitação	jurisprudência/lei
linguagem	música/arte/discurso/idioma/língua
litigante	jurisprudência/lei
litoral	rio/oceano/lago
litígio	jurisprudência/lei
logicismo	filosofia
lugar	dramaturgia/aeroplano/avião/teatro
lutter	calculadora/computador
luz	física
lápis	física
língua	linguagem/música/arte/discurso/idioma
lógica	informática
lúcifer	religião/fé
magnete	física
maioria	eleição
mandado	jurisprudência/jurisprudência/lei/lei
mandato	jurisprudência/jurisprudência/lei/lei
marina	armada/marinha
matematica	ciência
matemática	ciência
matemático	matematica/matemática
materialismo	filosofia
matrimónio	jurisprudência/lei
matrimônio	jurisprudência/lei
matriz	matematica/matemática
matrizes	matematica/matemática
medalhista	golfe
mediana	estatística/estatísticas/estatística
meditação	religião/fé
meio-campo	futebol
meleca	golfe
mentalismo	filosofia
menu	informática
microorganismo	criatura/flora/animal/besta/bicho/planta/vegetal/ser
microrganismo	criatura/flora/animal/besta/bicho/planta/vegetal/ser
midas	apólogo/lenda
mistura	quimica/química
moda	estatística/estatísticas/estatística
modulação	electrónica/eletronica/eletrónica/eletrônica/eletrônica
molécula	quimica/física/química
moléstia	jurisprudência/lei
monopsônio	economia
monopólio	economia
multa	jurisprudência/lei
multicolinearidade	estatística/estatísticas/estatística
musico	música
média	estatística/estatística/estatística/estatísticas/estatísticas/estatísticas/estatística/estatística/estatística
métrica	matematica/matemática/física
mísula	arquitetura/arquitectura
módulo	calculadora/computador
músico	música/música
nariz	criatura/animal/besta/bicho/ser
nativismo	filosofia
naturalismo	filosofia
negócio	industria/empresa/comércio
nervosismo	psicologia
nitrificação	flora/planta/vegetal
nominalismo	filosofia
norma	estatística/estatísticas/estatística
notário	jurisprudência/lei
noviciado	religião/fé
numina	religião/fé
objeto	gramática
ogre	folclore/folclore
ogro	folclore/folclore
olfato	criatura/animal/besta/bicho/ser
olheiro	esporte
oligopolio	economia
oligopólio	economia
onda	física
ontologia	informática
operador	matematica/matemática
operação	informática/matematica/matemática/cirurgia
opinião	jurisprudência/lei
oração	gramática
orla	rio/oceano/lago
ortodoxia	religião/fé
oscilação	física
osmose	quimica/química
ostomia	cirurgia
pacto	bíblia
par	golfe
paralela	matematica/matemática
parasita	flora/planta/vegetal
paridade	informática/física
parte	industria/jurisprudência/empresa/música/negócio/comércio/lei
participante	industria/empresa/negócio/comércio
partitura	música
partição	informática
parâmetro	informática/informática
pas	balé
passageiro	auto/autocarro/batel/caminhos-de-ferro/ônibus/aeroplano/automóvel/bote/escaler/locomotivas/avião/trem/viatura/barco/carro/comboio/veículo
passaporte	jurisprudência/lei
passaportes	jurisprudência/lei
passarinho	golfe
patrimônio	jurisprudência/lei
pauta	música
pedagogia	didáctica/ensinamento/ensino/educação/instrução/formação
perdão	jurisprudência/jurisprudência/lei/lei
periférico	informática
peroxidase	flora/planta/vegetal
perseguição	religião/fé
pertubação	física/jurisprudência/lei
ph	quimica/quimica/química/química
piano	música
pilar	arquitetura/arquitetura/arquitectura/arquitectura
piloto	aeronave/aeroplano/avião
pináculo	arquitetura/arquitectura
pixel	informática
placekicker	futebol
plano	matematica/matemática
platonismo	filosofia
pleito	jurisprudência/lei
plotter	calculadora/computador
pluralidade	eleição
polidactilia	humano
polimorfismo	quimica/química
polinómio	matematica/matemática
polinómios	matematica/matemática
polinômio	matematica/matematica/matemática/matemática
ponta	râguebi/rúgbi/futebol/futebol
ponteiro	râguebi/rúgbi/futebol/futebol
porta	informática
posição	esporte
posse	esporte
potência	física
pragmatismo	filosofia
predestinação	teologia
preempção	jurisprudência/lei
premeditação	jurisprudência/lei
prescrição	jurisprudência/lei
presunção	jurisprudência/lei
primeira-base	basebol/beisebol
privilégio	jurisprudência/lei
processador	informática
processo	jurisprudência/jurisprudência/jurisprudência/lei/lei/lei
procurador	jurisprudência/lei
procurador-geral	jurisprudência/lei
procuração	jurisprudência/lei
produção	economia
programa	informática/informática
programador	informática
proibição	jurisprudência/lei
promessa	bíblia
promotor	jurisprudência/jurisprudência/jurisprudência/lei/lei/lei
proprietário	jurisprudência/lei
protocolo	informática
prova	matematica/matemática/jurisprudência/lei
pudicícia	religião/fé
pulsação	electrónica/eletronica/eletrónica/eletrônica/eletrônica
punter	futebol
purgatório	teologia
putout	basebol/beisebol
píxel	informática
quantificador	gramática
quantum	física
quark	física
quartil	estatística/estatísticas/estatística
querelante	jurisprudência/lei
quitação	jurisprudência/lei
químico	quimica/química
racionalismo	filosofia
radical	quimica/química
radioactividade	quimica/química
raio	matematica/matemática
rapto	jurisprudência/lei
rastreamento	criatura/animal/besta/bicho/ser
rastreio	criatura/animal/besta/bicho/ser
reactor	física
reactores	física
realejo	música
realismo	filosofia
rebatida	basebol/beisebol
recapitulação	música
recato	religião/fé
receptor	basebol/beisebol
recolhedor	colectas/impostos/imposto/taxação/taxa/tributo
recolheràgaragem	jurisprudência/lei
recompensa	psicologia
recurso	jurisprudência/lei
recíproco	matematica/matemática
redacção	literatura
redação	literatura
rede	electrónica/eletronica/eletrónica/eletrônica/eletrônica/informática/criatura/animal/besta/bicho/ser
redenção	teologia
reflexiva	matematica/matemática
registrador	informática
registro	jurisprudência/fotografia/lei
regra	matematica/matemática
regressão	estatística/estatística/estatísticas/estatísticas/estatística/estatística
relativismo	filosofia
renda	colectas/impostos/imposto/taxação/taxa/tributo
rendimento	colectas/impostos/imposto/taxação/taxa/tributo
repetição	informática/jogo
rescisão	jurisprudência/lei
revestimento	psicologia
revogação	jurisprudência/lei
ripple	electrónica/eletronica/eletrónica/eletrônica/eletrônica
risc	informática/informática
rodada	jogo
rosto	psicologia
roteador	informática/informática
router	informática
réu	jurisprudência/lei
sacrificio	criatura/animal/besta/bicho/ser
sacrifício	criatura/animal/besta/bicho/ser
sagacidade	industria/empresa/negócio/comércio
salinidade	soluto/soluto/solução
salvação	teologia
sanfona	música
sarraceno	história/história/história/história
satanás	religião/fé
satã	religião/fé
segunda-base	basebol/beisebol
semiótica	filosofia/filosofia
sensacionalismo	filosofia
sensualismo	filosofia
sentença	jurisprudência/jurisprudência/lei/lei
sequestro	jurisprudência/lei
sequestros	jurisprudência/lei
seqüestro	jurisprudência/jurisprudência/lei/lei
servidor	informática
servidão	jurisprudência/lei
serviço	ténis/tênis
seção	música
sgml	informática
silfo	folclore/folclore
simetria	matematica/matemática
simulação	informática
sindactilia	humano
sintetizador	música
sintetizadores	música
software	informática
solipsismo	filosofia
solubilidade	soluto/soluto/solução
solução	quimica/química
som	música
sotaque	linguagem/discurso/idioma/língua
stress	psicologia
strikeout	basebol/beisebol
sub-directório	informática
subdesenvolvimento	fotografia
subdirectório	informática
subdiretório	informática
subgrupo	matematica/matemática
submundo	religião/fé
subpopulação	estatística/estatísticas/estatística
sufrágio	jurisprudência/lei
sujeito	gramática
superego	psicanálise
supersimetria	física
suspeito	jurisprudência/lei
suíte	música
série	matematica/matemática
sísifo	apólogo/lenda
sócio	industria/empresa/negócio/comércio
tabela	basquete/basquetebol/bola-ao-cesto/basquetebol
tabelião	jurisprudência/lei
tacada	esporte
tacto	música
tangência	electrónica/eletronica/eletrónica/eletrônica/eletrônica
taxa	colectas/impostos/imposto/taxação/tributo
teatro	dramaturgia
teleologia	filosofia
tema	música
tempo	jogo
tensão	psicologia/psicologia/física/física
terceira-base	basebol/beisebol
terra	electricidade/eletricidade
testamento	jurisprudência/lei
testemunha	jurisprudência/jurisprudência/lei/lei
testemunho	jurisprudência/jurisprudência/lei/lei
teórico	ciência/arte
throughput	calculadora/computador
timbre	música
titania	folclore/folclore
titanio	aeroplano/avião
titânia	folclore/folclore
titânio	aeroplano/avião
tolerância	religião/fé
tonica	música
topologia	matematica/matematica/matemática/matemática
tracção	auto/automóvel/viatura/carro/veículo
transferência	psicanálise
transformação	matematica/matemática
transiente	física
transistor	electrónica/eletronica/eletrónica/eletrônica/eletrônica
transitiva	matematica/matemática
transposição	música
transístor	electrónica/eletronica/eletrónica/eletrônica/eletrônica
travamento	informática
tração	auto/automóvel/viatura/carro/veículo
treinador	esporte
tribunal	jurisprudência/lei
trigonometria	matematica/matematica/matemática/matemática
trilha	informática
tristão	apólogo/lenda
troll	folclore/folclore/folclore/folclore
turno	basebol/beisebol/jogo
turíbulo	religião/fé
tânato	psicanálise
técnico	esporte
título	jurisprudência/lei
tónica	música
tônica	música
túnel	auto/automóvel/viatura/carro/veículo
ucp	informática
universo	estatística/estatísticas/estatística
uníssono	música
uptime	casademoinho/fábrica/manufatura/usina
usufruto	jurisprudência/lei
utilitário	informática
uxor	jurisprudência/lei
valência	quimica/química
vampiro	folclore/folclore
variância	estatística/estatísticas/estatística
vegetação	flora/planta/vegetal
veredicto	jurisprudência/lei
veredito	jurisprudência/lei
verruga	criatura/animal/besta/bicho/ser
vez	jogo
vibrato	música
vibração	física/física
vibrações	física
vigor	jurisprudência/lei
vigência	jurisprudência/lei
vigília	religião/fé
vitalismo	filosofia
voto	jurisprudência/lei
vídeo	informática
zagueiro	futebol
água	rio/oceano/lago
álgebra	matematica/matematica/matemática/matemática
álibi	jurisprudência/lei
árbitro	esporte
átomo	quimica/física/química
ícone	informática
íman	física
ímã	física
órgão	música

