abalo	zanga/consternação/espírito/ira/cólera/temor/raiva/terror/humor/medo/alegria/ânsia/ódio/ansiedade/aversão/preocupação/afeição/amor
abarcar	abranger/incluir/compreender/conter/ter
abastecer	apetrechar/aparelhar/equipar/suprir/abrigar/amparar/mobiliar/armar/despejar/prover/derramar/fornecer/suprir/alimentar/dar
aborrecer	assediar/molestar/importunar/irritar/provocar/incomodar
abrigo	morada/seguros/apartamento/aposento/moradia/domicílio/residência/habitação/lar/seguro/casa/hostelalbergue/quartos/albergue/apartamento/moradia/habitação/acampamento
abuso	perseguição
acabar	cumprir/efetuar/executar/desistir/realizar/parar/abandonar/atingir
aceitar	involver
aceno	numeral/símbolo/selo/número/marcadores/estigma/marca/mancha/selo
achar	reputar/considerar/ver
acobertar	disfarçar/mascarar/encobrir/esconder/sepultar/soterrar/enterrar
aconselhar	advocar/recomendar/urgir/promover
acontecer	materializar/re-ocorrer/reincidir/calhar/recorrer/ocorrer/prosseguir/suceder/repetir/ir
acontecimento	cerimónia/cerimônia/festa/rotulagem/celebração/balada/festa
acorrer	facilitar/aliviar
acrescentamento	aumento
acrescentar	conglomerar/acrescer/aglomerar/amontoar/aprofundar/somar/intensificar/acumular/adicionar/crescer/aumentar
acrescer	conglomerar/aglomerar/amontoar/aprofundar/somar/intensificar/acumular/acrescentar/adicionar/crescer/aumentar
acção	critica/juízo/rejeição/recuperação/julgamento/partida/comunicado/descobrimento/efetuação/insucesso/paralização/causalidade/descoberta/distribuição/escapatória/escape/implementação/interferência/ociosidade/paralisação/propulsão/uso/atrapalhação/permanência/comunicação/eliminação/fuga/impulsão/contato/disposição/habitação/impedimento/atividade/ocupação/toque/ato/falha/causa/execução/aquisição/ação/parada/realização
acúmulo	biota/exposições/galáxia/transito/tránsito/trânsito/embalagem/embrulho/flora/nebulosa/tráfego/trânsito/vegetação/biologia/circulação/cúmulo/jurisprudência/mão/monte/lei/montão/pacote/combinação/exposição/pilha/jogo/grupo/dados/encepamento/miscelanea/mitologia/potpourri/mitologia/universo/aglomeração/categoria/frota/biblioteca/bloco/conjunto/informação/pacote/mistura/família/grupo/classe
adaptar-se	obedecer
adequar-se	obedecer
adiar	delongar/pospor/postergar/protelar/prorrogar/procrastinar/atrasar/vacilar
adição	anexo/asa
administrador	gestor/director/dirigente/diretor/gerente/executivo
administração	tratamento/gerenciamento/gestão/autorização
admitir	involver/confessar/conceder
adorno	ornamento/decoração
adquirir	beneficiar-se/re-adquirir/beneficiar/reconquistar/reganhar/auferir/lucrar/comprar/recuperar/ganhar/obter/encontrar/atingir/compartir/fretar/reganhar/topar/partilhar/alugar/ganhar/receber/encontrar/aceitar/atingir/achar/dividir
adulto	anfitrião/hospedeiro/profissional/mulher/homem/idoso/personagem/velho/figura/tipo
advertir	alarmar/alertar
afagar	acariciar
afetar	influir/influenciar/atacar/atingir
agarrar	apreender/prender/segurar/capturar/segurar/pegar
agastar	assediar/aborrecer/molestar/importunar/irritar/provocar/incomodar
agente	booker
agir	esfriar/reagir/conquistar/endurecer/adquirir/fazer
agitar	estremecer/tremular/tiritar/tremer
aglomeração	biota/exposições/galáxia/transito/tránsito/trânsito/embalagem/embrulho/flora/nebulosa/tráfego/trânsito/vegetação/biologia/circulação/cúmulo/jurisprudência/mão/monte/acúmulo/lei/montão/pacote/combinação/exposição/pilha/jogo/grupo/dados/encepamento/miscelanea/mitologia/potpourri/mitologia/universo/categoria/frota/biblioteca/bloco/conjunto/informação/pacote/mistura/família/grupo/classe
agouro	evidência/indicação
agressão	violência/força
agricultura	horticultura
ajuda	apoio/mão/suporte/socorro/assistência
ajudante	manequim/secretário/secretária/modelo
ajudar	facilitar/aliviar
ajustar	obedecer
alertar	alarmar
alfaia	aparelhador/cómoda/gaveteiro/candeeiro/cômoda/luminária/assento/mesa/cadeira/guardarroupas/guarda-roupas/estante/mesa/armário
alguém	conhecida/engenheiro/habitante/proponente/líder/morador/cientista/especialista/parente/conhecido/defensor/advogado/amizade/autoridade/vizinho/aluno/chefe/trabalhador/amigo/estudante/representante/adjudicator/amado/amo/comunicador/creador/desafortunado/desventurado/governante/hebraica/hebreia/infortunado/intelecto/possuidor/amiga/anomalia/autóctone/competidor/contendor/criatura/fêmea/governador/súdito/turista/capitalista/cidadão/criador/dono/hebreu/judia/artista/camarada/conhecido/criativo/hebraico/judeu/juvenil/menor/viajante/amizade/criança/juiz/proprietário/seguidor/amante/esperança/face/jovem/árbitro/amigo/intelectual/pessoa/varão/estudante/macho/rosto/cara/homem/ser/parte/vida
alimento	bebida/alimentos/comestivel/provisões/suprimentos/ração/alimentação/nutriente/nutrição/comida
alma	conhecida/engenheiro/habitante/proponente/líder/morador/cientista/especialista/parente/conhecido/defensor/advogado/amizade/autoridade/vizinho/aluno/chefe/trabalhador/amigo/estudante/representante/adjudicator/amado/amo/comunicador/creador/desafortunado/desventurado/governante/hebraica/hebreia/infortunado/intelecto/possuidor/amiga/anomalia/autóctone/competidor/contendor/criatura/fêmea/governador/súdito/turista/capitalista/cidadão/criador/dono/hebreu/judia/artista/camarada/conhecido/criativo/hebraico/judeu/juvenil/menor/viajante/amizade/criança/juiz/proprietário/seguidor/amante/esperança/face/jovem/árbitro/amigo/intelectual/pessoa/varão/estudante/macho/rosto/cara/homem/ser/parte/vida
alojamento	morada/apartamento/aposento/moradia/domicílio/residência/habitação/lar/casa/hostelalbergue/quartos/albergue/apartamento/moradia/habitação/acampamento
alterar	impactar/aperfeiçoar/acertar/completar/afetar/modelar/formar/substituir/ajustar/corrigir/melhorar/encher/trocar/reduzir/diminuir/acostumar-se/adequar/amalgamar/aprontar/assear/cevar/depravar/desabilitar/desordenar/evaziar/fortalecer/habituar/habituar-se/indispor/inseminar/perverter/transubstanciar/acostumar/adaptar/afectar/afrouxar/agravar/ampliar/avariar/corromper/desativar/desobstruir/emprestar/engordar/equiparar/exacerbar/fecundar/fertilizar/incapacitar/transmudar/viciar/alumiar/desvirtuar/encerrar/esfriar/estreitar/macular/purgar/refrigerar/resfriar/secar/subverter/bagunçar/contaminar/contribuir/enrijecer/fortificar/gelar/molhar/progredir/sujar/amortecer/aviltar/converter/danificar/esquentar/esvaziar/refrescar/traduzir/unificar/afetar/aquecer/enxugar/igualar/apertar/clarear/endurecer/piorar/enfraquecer/manchar/marcar/baixar/finalizar/preparar/adicionar/ajustar/transformar/concluir/encher/trazer/misturar/terminar/deixar/limpar/carregar/conduzir/cair/aumentar/fazer
alteração	decréscimo/falecimento/dano/estrago/flutuação/avaria/variação/prejuízo/surpresa/queda/diminuição/abatimento/morte/mudança/transmutação/nascimento/transformação/crescimento/transição/aumento/mudança
alternativa	cabimento/possibilidade
aludir	desenterrar/apresentar/levantar
alvo	objetivo/fim/intenção
amante	homem
amigo	conexão
amizade	companherismo/conexão
amolar	assediar/aborrecer/molestar/importunar/irritar/provocar/incomodar
amplidão	altitude/altura
ancestral	antepassado/progenitor
andar	cave/engatinhar/gatinhar/mansarda/porão/rastejar/rastejar-se/serpear/trapeira/vadiar/vagabundear/vaguear/boiar/pisar/sótão/ático/ascender/escorregar/nadar/errar/passear/perambular/vagar/deslizar/voar/apressar/acompanhar/atravessar/caminhar/dirigir/correr/seguir/ir/subir/passar/apressar-se/coxear/despachar-se/esgueirar/esquiar/mancar/vadear/cavalgar/desfilar/progredir/avançar/marchar/perambular/perseguir/tropeçar/vagar/acelerar/rodar/apressar/descer/montar/prosseguir/baixar/circular/viajar/atravessar/espalhar/vir/caminhar/continuar/seguir/ir/passar/cair
animal	cria/predadores/prole/filhote/presa/invertebrados/cordados/fêmea/herbívoro/invertebrado/caça/larva/macho
anseio	ambição/pretensão/aspiração/afã/concupiscência/cio/eros/saudade/anelo/desejo
ansiar	suspirar/desejar/esperançar/aguardar/querer/esperar/desejar
antecessor	antepassado/progenitor
antecipar	conjecturar/hipotetizar/teorizar/pressupor/presumir/especular/supor/assumir/supor/pensar/esperar/achar
antenome	denominação/cognome/sobrenome/prenome/apelido/nome/título
antepassado	progenitor
aparecer	mostrar-se
aparelho	chibata/açoite/chicote/armamento/arma/metro
aparência	aspecto/rosto/feiura/feiúra/beleza/semblante/face/rosto
aperceber	enxergar/ouvir/doer/escutar/cheirar/sentir/olhar/ver/avistar/divisar/sonhar/perceber/ver
aperceber-se	enxergar/ouvir/doer/escutar/cheirar/sentir/olhar/ver/avistar/divisar/sonhar/perceber/ver
aperfeiçoar	reparar/emendar/lustrar/consertar/polir/refinar/embonecar/perfazer/atenuar/empetecar/amenizar/embelezar/acordar/resolver/aliviar/melhorar
apetite	ambição/pretensão/aspiração/afã/concupiscência/cio/eros/saudade/anelo/anseio/desejo
apoio	degrau/pedestal/suporte/pé/base/aderência/adesão/endosso/perna/pé
aporrinhar	assediar/aborrecer/molestar/importunar/irritar/provocar/incomodar
aposento	vivenda/hall/bar/habitação/cozinha/banheiro/sala/casa/biblioteca/banheiro/sala
apresentar	tocar/mostrar
apressar	acelerar/correr
aprovaçã0	mecenato/proteção
aprovação	mecenato/proteção
aquisição	dádiva/brinde/dom/doação/presente
ar	céu
arbusto	rosa/rosas/rosa/pimentão/pimenta/algodão
argumentação	política
arma	revóvel/revólver
armamento	revóvel/revólver/arma
arranjar	regularizar/arrumar/ordenar
arredar	arrastar/tremer
arte	pintura
artigo	carregamento/frete/mercadoria/carga
artista	musico/músico
arvoreta	rosa/rosas/rosa/pimentão/pimenta/algodão
ascender	galgar/trepar/montar/subir
aspecto	rosto/aparência/feiura/feiúra/beleza/semblante/face/rosto/aparência
assembléia	encontro/reunião/concentração
assemelhar	copiar/imitar
assemelhar-se	assemelhar/copiar/imitar
assento	cadeira
assintência	tratamento
assistente	manequim/secretário/secretária/modelo
assistir	facilitar/aliviar
assistência	apoio/mão/ajuda/suporte/socorro/ajuda
associar	mencionar/referir
associação	guilda/clube/sociedade/ordem/consórcio/gangue/sindicato/instituição/quadrilha/instituto
ataque	bombardeio/tiro
atenção	concentração
atingir	chocar/colidir/bater
atitude	mentalidade/tendência/deferência/intolerância/orientação/respeito
atmosfera	céu
ato	critica/juízo/rejeição/recuperação/julgamento/partida/comunicado/descobrimento/efetuação/insucesso/paralização/causalidade/descoberta/distribuição/escapatória/escape/implementação/interferência/ociosidade/paralisação/propulsão/uso/acção/atrapalhação/permanência/comunicação/eliminação/fuga/impulsão/contato/disposição/habitação/impedimento/atividade/ocupação/toque/falha/causa/execução/aquisição/ação/parada/realização
atravessar	correr
atributo	característica/qualidade
atuar	esfriar/reagir/conquistar/endurecer/adquirir/fazer
aula	seminário
aumentar	conglomerar/acrescer/aglomerar/amontoar/aprofundar/somar/intensificar/acumular/acrescentar/adicionar/crescer
ausência	escassez
auto	ambulancia/taxi/ambulância/táxi/calhambeque/jipe/sedan/sedã/carro
automóvel	ambulancia/taxi/ambulância/táxi/calhambeque/jipe/sedan/sedã/carro
autor	periodista/poetas/poeta/poetisa/jornalista
autoridade	julgador/avaliador/mestre/professor
autoridades	estado/palácio
auxiliar	facilitar/aliviar
auxílio	apoio/mão/ajuda/suporte/socorro/ajuda/assistência
avaliar	enaltecer/elogiar/louvar
avisar	alarmar/alertar
ação	critica/juízo/rejeição/recuperação/julgamento/partida/comunicado/descobrimento/efetuação/insucesso/paralização/causalidade/descoberta/distribuição/escapatória/escape/implementação/interferência/ociosidade/paralisação/propulsão/uso/acção/atrapalhação/permanência/comunicação/eliminação/fuga/impulsão/contato/disposição/habitação/impedimento/atividade/ocupação/toque/ato/falha/causa/execução/aquisição/parada/realização
barco	batel/iate/balsa/bote/escaler/barca/barcaça/bateira/embarcação/navios/navio
bastão	clava/porrete
batalha	combate/luta/guerra/defesa/conflito/proteção/disputa
batel	balsa/barca/barcaça/bateira/barco
bater	prensar/golpear/afagar/colidir/pressionar/apertar/chutar/atingir/golpear/roçar/manusear/acertar/chocar/colidir/raspar/tocar
beber	bebericar/sorver/sugar/chupar
bebida	leite/chá/café
bem	predominância/vantagem/benefício
berrar	esganiçar/gritar
besta	cria/predadores/prole/filhote/presa/invertebrados/cordados/fêmea/herbívoro/invertebrado/caça/larva/macho
bicho	cria/predadores/prole/filhote/presa/invertebrados/cordados/fêmea/herbívoro/invertebrado/caça/larva/macho
botar	deitar/semear/instalar/dispor/plantar/arranjar/pôr/colocar/estacionar/posicionar/instalar/posar/sentar-se/assentar/sentar/situar/acumular/sinalizar/erguer/pôr/levantar
bote	balsa/barca/barcaça/bateira/barco
boutique	botica/drogaria/drograria/farmacia/farmácia
brigar	aguerrir/combater/guerrear/digladiar/assaltar/batalhar/lutar/atacar
brinde	galardão/prémio/prêmio/ajuda
brinquedo	pião/boneca/boneco/ursídeos/bola
buscar	revirar/procurar
caber	ajustar
cabeça	administrador/gerente
cadeira	assento
cadáver	enchido/defunto/corpo
camada	pigmento/tinta/pintura/cor/superfície
caminhar	engatinhar/gatinhar/rastejar/rastejar-se/serpear/vadiar/vagabundear/vaguear/boiar/pisar/ascender/escorregar/nadar/errar/passear/perambular/vagar/deslizar/voar/apressar/acompanhar/atravessar/dirigir/correr/seguir/ir/andar/subir/passar/apressar-se/coxear/despachar-se/esgueirar/esquiar/mancar/vadear/cavalgar/desfilar/progredir/avançar/marchar/perambular/perseguir/tropeçar/vagar/acelerar/rodar/apressar/descer/montar/prosseguir/baixar/circular/viajar/atravessar/espalhar/vir/continuar/seguir/ir/andar/passar/cair
caminho	entrada/rumo/direcção/avenida/direção/trilha/curso
campo	engenharia/tecnologia/ciência
campos	horto/jardim
canal	orifício
cantar	trautear/cantarolar/trinar
capa	pigmento/tinta/pintura/cor/camuflagem
capturar	apreender/agarrar/prender/segurar/agarrar/segurar/pegar
característica	faceta/qualidade/incompatibilidade/qualidade
carapaça	concha
carburante	benzina/gasolina/coque/cozedura/lenha/querosene/fuelóleo/petróleo
carne	corte
carregar	deitar/semear/instalar/dispor/plantar/arranjar/pôr/colocar/aerotransportar/estacionar/posicionar/instalar/posar/sentar-se/assentar/sentar/situar/acumular/sinalizar/erguer/pôr/levantar
carro	ambulancia/taxi/ambulância/táxi/calhambeque/jipe/sedan/sedã
carta	invitação/convite
carência	ausência/escassez/deficiência/falta/escassez/necessidade
casa	morada/vivenda/apartamento/aposento/moradia/domicílio/residência/habitação/lar/hostelalbergue/quartos/albergue/apartamento/moradia/habitação/acampamento/lar
caso	vez
castigar	executar
categoria	elemento/excedente/restante/resíduo/sobra/resto/substância/componente/item/espécies/raça/membro/unidade/componente/género/tipo/classe
caule	galho/ramo
causa	alguém/indivíduo/alma/pessoa/poder/força/aventurança/manipulador/fado/operador/ameaça/destino/perigo/risco
causador	alguém/indivíduo/alma/pessoa/poder/força/aventurança/manipulador/fado/operador/ameaça/destino/perigo/risco
ceder	comissionar/desobrigar/incumbir/confidenciar/confiar/livrar/alienar/transferir/renunciar/desistir/transmitir/liberar/abandonar/deixar/entregar/dar
celebração	festival
centrar	focar
cerimónia	boda/funeral/boda/enterro/funeral/casamento
cerimônia	boda/funeral/boda/enterro/funeral/casamento
cerrar	bater/tirar
certame	competição/torneio/corrida/combate/partida/jogo/luta/corrida
cessar	desistir/parar/abandonar
chamar	baptizar/batizar
chance	audiência/ouvinte/dia
chatear	assediar/aborrecer/molestar/importunar/irritar/provocar/incomodar
chefe	empregador/líder/administrador/gerente/cabeça/liderança/exemplo/responsável/modelo/político/presidente/superior
chegada	demolição/placar/destruição/desolação/vitória/resultado/términio/vencimento/derrota/parada/perda
cheirar	recender/feder
cheiro	aroma/fragância
choramingar	lacrimejar/gemer
chorar	lacrimejar/gemer/choramingar
chão	florestas/arvoredo/selva/bosque/ilha/mata/floresta/planície/campanha/terra
circunscrição	jurisdição/bairro/vizinhança
circunstância	justificativa/justificação
citar	desenterrar/apresentar/levantar
ciência	matematica/matemática/psicologia/lingüística/linguística/lingüística
classe	gradação/nacionalidade/hierarquia/posto/grau/posição/burguesia/mulherio/irmandade/dignidade/fraternidade/categoria/espécies/nobreza/raça/liderança/posto/primeiro/género/mercado/mulher/tipo/lugar/ordem
clima	vento/precipitação
clã	genealogia/família
cobertor	camuflagem
cobertura	camuflagem
cobrar	arrecadar/coletar
cobre	cache/numerário/divisa/moeda/dinheiro/moeda
cobrir	embrulhar/embalar/encadernar/revestir/submergir/aplicar/colocar
cogitar	centrar/ruminar/concentrar/associar/conectar/relacionar/ponderar/especular/focar/questionar/contemplar/perguntar/planejar/refletir/balizar/raciocinar/avaliar/julgar
cognição	psique/atitude/mente/cabeça/incapacidade/informação/capacidade/conhecimento/poder/habilidade/talento
colecção	biota/exposições/galáxia/transito/tránsito/trânsito/embalagem/embrulho/flora/nebulosa/tráfego/trânsito/vegetação/biologia/circulação/cúmulo/jurisprudência/mão/monte/acúmulo/lei/montão/pacote/combinação/exposição/pilha/jogo/grupo/dados/encepamento/miscelanea/mitologia/potpourri/mitologia/universo/aglomeração/categoria/frota/biblioteca/bloco/conjunto/informação/pacote/mistura/família/grupo/classe
coleção	biota/exposições/galáxia/transito/tránsito/trânsito/embalagem/embrulho/flora/nebulosa/tráfego/trânsito/vegetação/biologia/circulação/cúmulo/jurisprudência/mão/monte/acúmulo/lei/montão/pacote/combinação/exposição/pilha/jogo/grupo/dados/encepamento/miscelanea/mitologia/potpourri/mitologia/universo/aglomeração/categoria/frota/biblioteca/bloco/conjunto/informação/pacote/mistura/família/grupo/classe
colidir	chocar/bater
colocar	deitar/semear/instalar/dispor/plantar/arranjar/pôr/estacionar/posicionar/instalar/posar/sentar-se/assentar/sentar/situar/acumular/sinalizar/erguer/pôr/levantar
comando	mandamento/ordem
comarca	jurisdição/bairro/vizinhança
combate	batalha/luta/guerra/defesa/conflito/proteção/disputa
combinar	assemelhar-se/assemelhar/parecer/convir/adaptar-se/adequar-se/harmonizar/compatibilizar/corresponder/concordar/satisfazer
combustível	benzina/gasolina/coque/cozedura/lenha/querosene/fuelóleo/petróleo
comer	mordiscar
comercialismo	industria/pagamento/empresa/negócio/comércio/venda
comerciante	dono/proprietário
começar	iniciar
comida	bebida/alimentos/comestivel/provisões/suprimentos/ração/alimentação/nutriente/nutrição/alimento
comoção	zanga/consternação/espírito/ira/cólera/temor/raiva/terror/humor/medo/alegria/ânsia/ódio/ansiedade/aversão/preocupação/afeição/amor
companheiro	esposa/mulher
competir	jogar
competição	torneio/corrida/combate/partida/jogo/luta/corrida
completar	carregar
componente	elemento/hardware/excedente/restante/adição/resíduo/sobra/melhoria/resto/substância/item/pixel/píxel/membro/unidade
comportamento	desfeita/ofensa/injúria
comportar-se	esfriar/reagir/conquistar/endurecer/adquirir/fazer
composição	arquitectura/estrutura
comprar	beneficiar-se/re-adquirir/beneficiar/reconquistar/reganhar/auferir/lucrar/recuperar/ganhar/obter/adquirir/encontrar/atingir/compartir/fretar/reganhar/topar/partilhar/alugar/ganhar/adquirir/receber/encontrar/aceitar/atingir/achar/dividir
compreender	solucionar/resolver/interpretar/traduzir/entender
compreensão	psique/atitude/mente/cabeça/incapacidade/informação/capacidade/conhecimento/poder/habilidade/talento
comprender	solucionar/resolver/interpretar/traduzir/compreender/entender
comunicação	agouro/indício/mensagem/presságio/indicação/linguagem/discurso/idioma/língua/sinal/documento/mensagem/linguagem/tópico/assunto/conteúdo/discurso/voz/anúncio/língua/estilo
comércio	industria/transportação/indústria/manufatura/pagamento/transporte/empresa/negócio/expedição/finança/venda
conceito	projecto/atributo/categoria/concepção/possibilidade/programação/soma/característica/idéia/suposição/tema/teoria/motivo/projeto/quantidade/hipótese/propriedade/qualidade/família/ideia/intenção/programa/plano/número/classe/abstracção/abstracto/abstrato/totalidade/sentido/lei/componente/significado/intenção
concentrar	focar
concentração	foco
concepção	atributo/categoria/possibilidade/soma/característica/suposição/teoria/quantidade/hipótese/propriedade/qualidade/família/número/classe/abstracção/abstracto/abstrato/totalidade/lei/componente
concitar	magoar/ofender/provocar/encolerizar/irar/zangar/comover/interessar/desconcertar/enraivecer/emocionar/estimular/atrair/perturbar/confundir/excitar/superar/pedir
conclusão	demolição/placar/destruição/desolação/vitória/resultado/términio/vencimento/derrota/parada/perda
concordar	assemelhar-se/assemelhar/parecer/convir/adaptar-se/adequar-se/harmonizar/compatibilizar/corresponder/satisfazer
concorrer	jogar
concurso	competição/torneio/corrida/combate/partida/jogo/luta/corrida
condição	ascendencia/nacionalidade/delinquência/dominancia/melhora/superioridade/hierarquia/conforto/melhoria/necessidade/culpa/perigo/posto/segurança/carência/controle/domínio/ordem/classe/posição/iniqüidade/nudez/secura/secas/aridez/circunstância/dignidade/cena/cenário/imunidade/nobreza/ambiente/liderança/situação/posto/prisão/maldade/lugar/posição
conduta	desfeita/ofensa/injúria/caminho
condutas	vaso
condutor	cobre
conectar	mencionar/referir
conexão	coerência/coesão/ligação
confessar	conceder/admitir
confirmar	validar/demonstrar
conflito	atrito/fricção
confromar-se	obedecer
confronto	atrito/fricção
conhecida	conexão
conhecido	conexão
conhecimento	psique/atitude/mente/cabeça/incapacidade/informação/capacidade/poder/habilidade/talento
conjecturar	afigurar/envisionar/figurar/visualizar/ver
conjeturar	afigurar/envisionar/figurar/visualizar/ver
conquista	proeza/feito/obtenção/andada/façanha/realização
consentir	aturar/tolerar/aguentar/suportar/admitir/aceitar/confiar/autorizar/permitir
consequência	efeitos/influência/efeito
conseqüência	efeitos/influência/efeito
consertar	remendar
conservar	enlatar
consideração	justificativa/justificação
consorte	esposa/mulher
consternação	pânico/terror/medo/calafrio/tremedeira/tremura/arrepio/tremor
constituição	arquitectura/estrutura
construir	reproduzir/criar/publicar/editar/imprimir
contar	retrucar/replicar/responder/prefaciar/preceder/introduzir/anunciar/apresentar/declarar/representar
contemplar	ponderar/questionar/perguntar
conter	abranger/incluir/compreender/ter/delimitar/marcar
continuidade	trecho/período
controlar	avionar/pilotar/voar
convicção	doutrina/religião/filosofia/certeza/fé/espirito/perspicácia/confiança/pensamento/fé/opinião
corpo	enchido/defunto/cadáver
corrente	rio/caminho/regato/ribeira
correr	arremeter/fluir/acelerar
corresponder	assemelhar-se/assemelhar/parecer/convir/adaptar-se/adequar-se/harmonizar/compatibilizar/concordar/satisfazer
corrida	estafeta
corroborar	validar/demonstrar
costume	maltrato/escravidão/ritual/emprego/hábito
cozinhar	preservar/conservar
crença	doutrina/convicção/religião/filosofia/certeza/fé/espirito/perspicácia/confiança/pensamento/fé/opinião
crescer	conglomerar/acrescer/aglomerar/amontoar/aprofundar/somar/intensificar/acumular/acrescentar/adicionar/aumentar
crescimento	cultura
criado	manequim/secretário/secretária/modelo
criança	bebé/criancinha/nenê/recém-nascido/bebê/filha/rapaz/menino
criar	reproduzir/hibridizar/publicar/editar/cruzar/imprimir
criatura	cria/predadores/prole/filhote/presa/invertebrados/cordados/fêmea/herbívoro/invertebrado/caça/larva/macho
criação	arte
crime	infracção/infração
critica	avaliação/estimativa/cálculo
crónica	biografia
crônica	biografia
cuidado	tratamento
cultivo	horticultura
curso	seminário/caminho/trilha
curva	arco
código	software/programa
cólera	fúria/ira/raiva
cónjuge	esposa/mulher
córrego	rio/regato/ribeira
cônjuge	esposa/mulher
dano	fractura/fratura
dar	legar/deixar/entregar/passar/comissionar/desobrigar/incumbir/confidenciar/lembrar-se/render-se/confiar/livrar/alienar/ceder/transferir/renunciar/lembrar/desistir/transmitir/liberar/abandonar/deixar/entregar
debruçar	declivar/inclinar
decair	degenerar/degradar/deteriorar/piorar/adoecer/adoentar/piorar
decidir	seleccionar/selecionar/escolher/mensurar/regulamentar/regularizar/decretar/medir
decoração	ornamento
decrescer	amainar/contrair-se/murchar/abater/amenizar/encolher/enrugar/declinar/contrair/enfraquecer/diminuir
deficiência	escassez
defunto	enchido/cadáver/corpo
deidade	santo
deidades	santo
deixar	aturar/tolerar/aguentar/suportar/admitir/aceitar/lembrar-se/confiar/autorizar/permitir/lembrar/desistir/parar/abandonar
delapidar	dissipar/desperdiçar
demanda	consumo
demandar	exigir/requerer
demo	manifestação/reflexão
demolição	desolação/ruína
demonstração	manifestação/reflexão
denominar	baptizar/batizar
departamento	broto/ramo
depressão	baixada/vale/leito/fundo
desabar	amainar/contrair-se/murchar/abater/amenizar/encolher/enrugar/declinar/contrair/enfraquecer/diminuir
desaparecer	esvanecer
descendente	criança/filho/menino
descendência	criança/filho/menino
descontinuar	desistir/parar/abandonar
desejar	ansiar/suspirar/esperançar/aguardar/querer/esperar
desejo	ambição/pretensão/aspiração/afã/concupiscência/cio/eros/saudade/anelo/anseio
desempenhar	tocar
desempenho	mecanica/mecanismo
desfeita	afronta/desconsideração/insulto/ofensa/injúria
desinformar	mentir
desistir	parar/abandonar
deslizar	resvalar/derrapar/escorregar/patinar
deslocar	contorcer/enroscar/espernear/torcer-se/manar/virar-se/dançar/fluir/pulsar/tornar-se/girar/sacudir/tremer/sair/correr/partir/agitar/deixar/virar/separar/vassourar/bailar/oscilar/dançar/ondular/varrer/encostar/rolar/atravessar/desaparecer/agitar/bater
desolação	ruína
despender	delapidar/dilapidar/esbanjar/desperdiçar/torrar/gastar/dispor/consumir/investir/poder
desperdiçar	dissipar
despesa	gastos/custos/preço/custo
destruição	desolação/ruína
deus	santo
deusa	santo
dever	incumbência/serviço/designação/função/tarefa/papel
dia	data
didáctica	aula/curso
dificuldade	fineza/subtileza/sutileza/rigor/problema
dilapidar	dissipar/desperdiçar
dimensão	altitude/altura
diminuir	encurtar/resumir/condensar/abreviar/reduzir/amainar/circunscrever/contrair-se/murchar/abater/amenizar/encurtar/encolher/enrugar/confinar/declinar/minimizar/contrair/ferver/enfraquecer/limitar/restringir/reduzir
dinheiro	cache/numerário/divisa/moeda/moeda
disciplina	engenharia/tecnologia/ciência
discurso	preleção/palestra/linguagem/idioma/língua
discutir	encetar/abordar/iniciar
disfarçar	esconder
dispor	regularizar/arrumar/ordenar
disposição	ambição/aspiração
disputa	conflito
disputar	aguerrir/combater/guerrear/digladiar/assaltar/batalhar/lutar/atacar
districto	jurisdição/bairro/vizinhança
distrito	jurisdição/bairro/vizinhança
ditado	provérbio
diversão	distracção/exibição/distração/divertimento/apresentação
divertimento	distracção/exibição/distração/apresentação
divertir	entreter
divindade	santo
divinidade	santo
divisa	cache/numerário/moeda/dinheiro/dólar/moeda
divisão	departamento/broto/ramo/departamento
dizer	retrucar/replicar/responder/prefaciar/preceder/introduzir/anunciar/apresentar/declarar/representar
doação	galardão/prémio/prêmio/ajuda
dobrar	corrugar/enrugar/cruzar/amassar
documentação	reporte/relato/relatório/estudo
documento	reporte/relato/relatório/estudo
doença	doenças/tumores/fitopatologia/colapso
doenças	fitopatologia
doer	ferroar/picar/furar/machucar
dom	galardão/prémio/prêmio/ajuda
domicílio	vivenda/habitação/casa/lar/casa
domínio	engenharia/tecnologia/ciência/jurisdição/bairro/vizinhança
droga	medicamento/remédio/intoxicante/narcótico
duração	trecho/período
dádiva	galardão/prémio/prêmio/ajuda
débito	empréstimo/crédito
dívida	empréstimo/crédito
dívidas	empréstimo/crédito
dúvida	descrença
edifício	escolas/estádio/plantel/sacada/torres/varanda/vivenda/alojamento/estufa/hall/hotel/pavimento/piso/ponte/prédio/restaurante/roque/torre/varanda/arena/balcão/cruz/monumento/monumentos/viveiro/abrigo/colégio/departamento/habitação/salão/centro/escola/casa/andar/alpendre/arco/casadeoração/corcova/divisória/clube/paredes/asilo/ministério/obstrução/parede/contrapeso/defesa/estabelecimento/igreja/impedimento/monte/refúgio/templo/equilíbrio/teatro/arco/casa/obstáculo
edição	livro/coletânea/coleção/periódico/revista/compêndio/jornal
educação	aula/experiência/curso
efeito	efeitos/influência
eleição	cabimento/possibilidade
elicitar	magoar/ofender/provocar/encolerizar/irar/zangar/comover/interessar/desconcertar/enraivecer/emocionar/estimular/atrair/perturbar/confundir/excitar/superar/pedir
embarcação	batel/iate/bote/escaler/barco/navios/navio/barco
embarcações	batel/iate/bote/escaler/barco/embarcação/navios/navio/barco
emblema	numeral/símbolo/selo/número/marcadores/estigma/marca/mancha/selo
emendar	remendar/consertar
emitir	latir/ladrar/relinchar/ecoar/repetir
emoção	zanga/consternação/espírito/ira/cólera/temor/raiva/terror/humor/medo/alegria/ânsia/ódio/ansiedade/aversão/preocupação/afeição/amor
emprego	chácara/granja/quinta/oficina/ofício/sítio/arte/profissão/fazenda/cargo/central/posto/posição
empresa	transportação/indústria/manufatura/transporte/expedição/finança
empresário	dono/proprietário
empurrar	propulsionar
encerrar	cumprir/efetuar/executar/realizar/atingir
encher	carregar
encobrir	disfarçar/mascarar/esconder/sepultar/soterrar/enterrar/esconder
encontrar	apinhar/reunir-se/acessar
encontro	sessão
encosto	degrau/pedestal/suporte/pé/base/perna/pé
endereço	domicílio/residência/casa
enfermidade	doenças/tumores/doença/colapso
enganar	mentir
engano	mácula/fiasco/bobagem/gafe/descuido/mancha/negligência/erro
ensinamento	aula/curso
ensinar	educar/instruir/preparar/treinar/palestrar/falar
ensino	aula/curso
entender	enxergar/ouvir/solucionar/doer/escutar/cheirar/resolver/sentir/olhar/ver/avistar/divisar/interpretar/sonhar/traduzir/perceber/compreender/ver
entorpecente	medicamento/remédio/intoxicante/narcótico
entrar	traspassar/perfurar/penetrar
entregar	legar/deixar/passar/dar/comissionar/desobrigar/incumbir/confidenciar/lembrar-se/render-se/confiar/livrar/alienar/ceder/transferir/renunciar/lembrar/desistir/transmitir/liberar/abandonar/deixar/dar
entretenimento	distracção/exibição/distração/divertimento/apresentação
entreter	divertir
entreterimento	distracção/exibição/distração/divertimento/apresentação
envólucro	camuflagem
equipamento	aparato/aparelho/parafernália/material
equívoco	mácula/fiasco/bobagem/gafe/descuido/mancha/negligência/erro
era	período
erro	mácula/fiasco/bobagem/gafe/descuido/mancha/negligência
esbanjar	dissipar/desperdiçar
escada	escadas
escadaria	escadas
escaler	balsa/barca/barcaça/bateira/barco
escapar	evadir-se/fugir
escapulir	evadir-se/fugir/escapar
escolha	cabimento/possibilidade
escolher	eleger/votar/decidir/esposar/adoptar/adotar
esconder	disfarçar/mascarar/encobrir/sepultar/soterrar/enterrar
escorregar	resvalar/derrapar/deslizar/patinar
escrever	registar/registrar
escritor	periodista/poetas/poeta/poetisa/jornalista
esforço	chute/tacada/tentativa/batalha/luta/teste
esfregar	roçar/enxugar/limpar
espalhar	borrifar
espaçamento	composição
espaço	ângulo/ângulos/vão/extensão/fenda
especialista	experiente/perito/autoridade
espectáculo	película/cinema/filme/emissão/produção/programa/atuação
especular	ponderar/questionar/perguntar
esporte	remo
esposa	dona-de-casa/mulher
esposo	esposa/mulher
espírito	felicidade/alegria
esquema	configuração
estabelecimento	igrejas/religião/empresa/igreja/companhia
estado	ascendencia/nacionalidade/delinquência/dominancia/melhora/superioridade/hierarquia/conforto/melhoria/necessidade/culpa/perigo/posto/segurança/carência/controle/domínio/ordem/classe/posição/iniqüidade/nudez/secura/secas/aridez/circunstância/dignidade/imunidade/nobreza/liderança/situação/posto/maldade/lugar/posição
estado-maior	mediação
estação	estio/inverno/outono/primavera/verão
estimar	enaltecer/elogiar/louvar
estimular	magoar/ofender/provocar/encolerizar/irar/zangar/comover/interessar/desconcertar/enraivecer/emocionar/atrair/perturbar/confundir/excitar/superar/pedir
estrada	entrada/caminho/rumo/direcção/avenida/direção/curso
estrato	burguesia/mulherio/irmandade/fraternidade/superfície/mercado/mulher/ordem
estremecer	tremelicar/tiritar/tremer
estressar	alongar/esticar/estender
estrutura	estádio/sacada/torres/varanda/alojamento/pavimento/piso/ponte/prédio/roque/torre/varanda/arena/balcão/cruz/monumento/monumentos/edifício/abrigo/casa/andar/alpendre/arco/corcova/divisória/paredes/asilo/obstrução/parede/contrapeso/defesa/estabelecimento/arquitectura/impedimento/monte/refúgio/equilíbrio/arco/obstáculo
etapa	centúria/decênio/década/sazão/século/séculos/manhã/mês/noitada/século/estágio/semana/continuidade/trimestre/fase/tarde/duração/era/estação/idade/época/ano/noite/tempo/período/pré-história/jornada/noitada/temporada/semana/sono/prazo/sesta/era/estação/idade/juventude/época/licença/ano/hora/passado/momento/noite/dia/vida/tempo/período
evidência	sintoma/confirmação/trilha/pista/prova/refutação
executar	enforcar
execução	mecanica/mecanismo
exemplo	mostra/excepção/exceção/amostra/vez
exercício	revisão
exibir	mostrar
exigir	requerer
experimentar	arrepender/arrepender-se/lamentar/regozijar/regozijar-se/alegrar-se/enraivecer/entreter/alegrar/arder/sustentar/sofrer/guardar/considerar/manter
expirar	afogar-se/afogar/tombar/cair
explicar	elocubrar/elaborar/expandir/expor/elucidar/esclarecer
explorar	minerar/minar/escavar
expor	mostrar
expressão	provérbio/ditado
expulsar	ejetar/excluir/dividir/separar
extensão	altitude/altura
exército	corpo
face	fundo/dianteira/frente
falar	retrucar/replicar/responder/prefaciar/preceder/introduzir/anunciar/apresentar/declarar/representar
falecer	afogar-se/afogar/tombar/cair
falha	mácula/fiasco/bobagem/gafe/descuido/mancha/negligência/erro
falhar	borrar/ferrar/arruinar
falta	escassez
familia	genealogia/família
família	genealogia/categoria/espécies/raça/género/povo/tipo/classe
fatia	seção/parte
fazenda	seda/algodão/crepe/mohair/plantação/plantio/viveirodeplantas/pano/trama/malha/rede
fazer	reproduzir/criar/tocar/publicar/editar/imprimir
façanha	proeza/feito/obtenção/andada/realização
fechar	bater/tirar
feito	critica/juízo/rejeição/recuperação/julgamento/partida/comunicado/descobrimento/efetuação/insucesso/paralização/causalidade/descoberta/distribuição/escapatória/escape/implementação/interferência/ociosidade/paralisação/proeza/propulsão/uso/acção/atrapalhação/obtenção/permanência/andada/comunicação/eliminação/façanha/fuga/impulsão/contato/disposição/habitação/impedimento/atividade/ocupação/toque/ato/falha/causa/execução/aquisição/ação/parada/realização
feição	disposição/atividade/egocentrismo/índole/bobeira/caráter/sagacidade/sapiência/conduta/egoísmo/firmeza/modalidade/natureza/disciplina/sabedoria/sensatez/comportamento/procedimento/personalidade/maneira
fenómeno	ensejo/consequência/fortuna/conseqüência/azar/efeito/sorte/resultado/fim
fenômeno	ensejo/consequência/fortuna/conseqüência/azar/efeito/sorte/resultado/fim
ferir	atropelar/estirar/tirotear/arranhar/raspar/puxar/atirar
ferramenta	chibata/aparato/açoite/chicote/aparelho/armamento/equipamento/arma/parafernália/material/metro
festa	boda/cerimónia/funeral/boda/enterro/festival/funeral/cerimônia/casamento/rotulagem/celebração/balada
festividade	festival
fibra	bisso
fibras	bisso
ficar	caber/ajustar
filho	bebé/criancinha/nenê/recém-nascido/criança/bebê/menino/filha/rapaz/menino
fim	demolição/efeitos/placar/destruição/influência/desolação/vitória/efeito/resultado/términio/vencimento/derrota/parada/perda
final	demolição/placar/destruição/desolação/vitória/resultado/términio/vencimento/derrota/parada/perda
finalizar	cumprir/efetuar/executar/desistir/realizar/parar/abandonar/atingir
fixar	trancar/pendurar/implantar/conectar/pendurar/amarrar/atar/forçar/ligar/colocar
flora	chaparral/epifitismo/epífito/traqueófitos/bosque/mata/floresta
fluido	líquido/gás
fluir	correr
flutuação	diferença
folha	folhas
folhas	folha
forjar	plasmar/amoldar/moldar/fundir/modelar/transformar
formar	plasmar/achatar/amoldar/retorcer/aplainar/moldar/enxugar/forjar/fundir/modelar/torcer/transformar
formação	aula/curso
fornecer	apetrechar/aparelhar/equipar/suprir/abrigar/amparar/mobiliar/armar/despejar/prover/derramar/suprir/alimentar/dar
força	efeitos/potência/vigor
forçar	propulsionar/empurrar
fracassar	borrar/ferrar/arruinar
fraqueza	lassidão/letargia
fronteira	aba/borda/limite
fruta	espiga
fruto	espiga/fruta
fugir	evadir-se/escapar
funcionário	magistrado/jurista/juiz/servidor
função	ofício/arte/profissão/cargo/posto/posição
fábrica	casademoinho/manufatura/usina
fé	doutrina/convicção/religião/filosofia/certeza/espirito/perspicácia/confiança/pensamento/opinião
galera	ralé
gastar	delapidar/dilapidar/esbanjar/desperdiçar/torrar/dispor/consumir/investir/poder
gasto	gastos/custos/preço/custo
genitor	progenitora/papai/papá/painho/pai/mãe
gente	galera/vulgo/nação/estrato/geração/inimigo/mundo/população/pessoal/povo/classe/freguesia/ralé/clientela/coorte/nação/povo
gerente	gestor/director/dirigente/administrador/diretor/executivo
gestão	tratamento/gerenciamento/autorização/administração
girar	rodar
golpe	pontapé/chute
golpear	chutar
governar	gerir/reinar/reger/manobrar/canalizar/lidar/cuidar/guiar/dirigir
governo	estado/palácio
grafema	caracter/caractér/carácter/letra
grandeza	amplidão/tamanho/dimensão/medida/proporção/magnitude/extensão/alcance/quantidade/extensão/número
grau	intensidade
gritar	esganiçar
grupo	classe/parelha/par/união
guardar	negar/deter/deduzir/poupar/preservar/conservar/reter/segurar/manter
habilidade	arte
habitante	europeu
habitação	vivenda/casa
hemípteros	himenópteros/sota/rainha/operário
hierarquia	gradação/grau/primeiro
hipótese	pressuposição/suposição
homem	cavalheiro/senhor
homemdenegócios	dono/proprietário
honra	celebridade/fama/glória/renome
hora	meio-dia
hortaliça	folhas/vegetal
hortifruti	verdura/hortaliça/legume/vegetal/fruta
hortifruto	verdura/hortaliça/legume/vegetal/fruta
hostilidade	violência/força
hotel	albergaria/albergue/hospedaria/pousada
humano	humanidade/mundo/homem/povo
humor	felicidade/alegria
hábito	maltrato/escravidão/ritual/costume/emprego
idade	era/período
ideia	atributo/categoria/possibilidade/soma/característica/suposição/teoria/quantidade/hipótese/propriedade/qualidade/família/número/classe/abstracção/raciocinio/razoamento/abstracto/argumentação/planejamento/abstrato/raciocínio/totalidade/lei/preparação/componente
idioma	linguagem/língua/provérbio/ditado
idéia	projecto/conceito/atributo/categoria/concepção/possibilidade/programação/soma/característica/suposição/tema/teoria/motivo/projeto/quantidade/hipótese/propriedade/qualidade/família/ideia/intenção/programa/plano/número/classe/abstracção/abstracto/abstrato/totalidade/sentido/lei/componente/significado/intenção
igual	associado
imaginar	afigurar/envisionar/figurar/visualizar/ver
impactar	influir/influenciar/afetar/atacar/atingir
importunar	assediar/aborrecer/molestar/irritar/provocar/incomodar
importância	merecimento/mérito/preços/significação/virtude/preço/significado/qualidade
incerteza	descrença/dúvida
incitar	magoar/ofender/provocar/encolerizar/irar/zangar/comover/interessar/desconcertar/enraivecer/emocionar/estimular/atrair/perturbar/confundir/excitar/superar/pedir
inclinar	declivar
incluir	abranger/compreender/conter/ter
incomodar	assediar/aborrecer/molestar/importunar/irritar/provocar
indagar	consultar
indicação	evidência
indivíduo	conhecida/engenheiro/habitante/proponente/líder/morador/cientista/especialista/parente/conhecido/defensor/advogado/amizade/autoridade/vizinho/aluno/chefe/trabalhador/amigo/estudante/representante/adjudicator/amado/amo/comunicador/creador/desafortunado/desventurado/governante/hebraica/hebreia/infortunado/intelecto/possuidor/amiga/anomalia/autóctone/competidor/contendor/criatura/fêmea/governador/súdito/turista/capitalista/cidadão/criador/dono/hebreu/judia/artista/camarada/conhecido/criativo/hebraico/judeu/juvenil/menor/viajante/amizade/criança/juiz/proprietário/seguidor/amante/esperança/face/jovem/árbitro/amigo/intelectual/pessoa/varão/estudante/macho/rosto/cara/homem/ser/parte/vida
industria	transportação/indústria/manufatura/transporte/expedição/finança
indício	evidência/indicação
indústria	produção
informação	notícia/notícias/fato/artigo/arcano/materiais/material/segredo
infra-estrutura	aeroporto/aeródromo/instalação/água/estação/origem/pista/posto/fonte/campo
iniciar	começar
injúria	afronta/desconsideração/insulto/ofensa/perseguição
insecto	himenópteros/sota/rainha/operário
insectos	himenópteros/sota/rainha/operário
inseto	himenópteros/sota/rainha/operário
insetos	himenópteros/sota/rainha/operário
insistir	reinvindicar/asseverar/sustentar/manter
instalação	aeroporto/aeródromo/água/estação/origem/pista/posto/fonte/campo
instituição	igrejas/religião/empresa/igreja/companhia
instituto	igrejas/religião/empresa/igreja/companhia
instruir	educar/preparar/treinar/palestrar/falar
instrumento	chibata/açoite/chicote/armamento/arma/metro
instrução	aula/experiência/curso
instância	mostra/excepção/exceção/amostra/vez
inteligência	agudez/astucidade/agudeza/sagacidade/astúcia/cérebro
intenção	objetivo/fim/morais/moralidade/ética/moral/programa/vida
interação	contato/ligação
intercorrência	cabimento/possibilidade
interesse	caso
intérprete	actor/ator/artista/instrumentalista/instrumentista/tocador/músico
ir	engatinhar/gatinhar/rastejar/rastejar-se/serpear/vadiar/vagabundear/vaguear/boiar/pisar/ascender/escorregar/nadar/errar/passear/perambular/vagar/deslizar/voar/apressar/acompanhar/atravessar/caminhar/dirigir/correr/seguir/andar/subir/passar/apressar-se/bicicletar/coxear/despachar-se/esgueirar/esquiar/mancar/vadear/cavalgar/desfilar/pedalar/progredir/avançar/marchar/perambular/perseguir/tropeçar/vagar/acelerar/rodar/apressar/descer/montar/prosseguir/baixar/circular/viajar/atravessar/espalhar/vir/caminhar/continuar/seguir/andar/passar/cair
ira	fúria/cólera/raiva
irritar	assediar/aborrecer/molestar/importunar/provocar/incomodar
itinerário	rumo/direcção/direção/curso
itinerários	rumo/direcção/direção/curso
jogar	apanhar/apostar/capturar/anunciar
jogo	competição/torneio/corrida/combate/partida/luta/classe/parelha/esporte/corrida/par/união
julgamento	revogação/avaliação/estimativa/cálculo
juntar	acoplar/anexar/unir
juízo	avaliação/estimativa/cálculo
laboratório	chácara/granja/quinta/oficina/sítio/fazenda/central
lado	fundo/dianteira/frente
lar	vivenda/habitação/casa
lavar	enxaguar
laço	forca/nó
leccionar	educar/instruir/preparar/treinar/palestrar/falar
lecionar	educar/instruir/preparar/treinar/palestrar/falar
legar	lembrar-se/lembrar
legislatura	parlamento/assembléia
legume	folhas/vegetal
lembrar	reconhecer
lembrar-se	reconhecer
lesar	atropelar/estirar/tirotear/arranhar/raspar/puxar/atirar
lesionar	atropelar/estirar/tirotear/arranhar/raspar/puxar/atirar
lesão	fractura/fratura
letra	caracter/caractér/carácter
levar	devolver/voltar/retornar/carregar/aerotransportar
liberdade	independência
liderança	administrador/gerente
ligar	acoplar/anexar/juntar/unir
ligação	coerência/coesão
limitar	delimitar/marcar
limite	aba/borda/fronteira
linguagem	idioma/língua
linha	encabeçamento/rumo/direcção/direção/curso
listagem	lista
livro	diário/autoridade
livros	diário
localização	regiões/selva/floresta/região/lar/região/fronteira/lugar/casa
locação	regiões/selva/floresta/região/lar/região/fronteira/lugar/casa
locução	provérbio/ditado
loja	botica/drogaria/drograria/farmacia/farmácia
lugar	regiões/selva/ofício/arte/floresta/profissão/região/cargo/lar/posto/região/fronteira/casa/posição
lustrar	aculturar/civilizar/escolar/educar/cultivar/treinar
luta	conflito/disputa
lutar	aguerrir/combater/guerrear/digladiar/assaltar/batalhar/atacar
líder	empregador/administrador/gerente/cabeça/chefe/liderança/exemplo/responsável/modelo/político/presidente/superior
língua	linguagem/idioma
líquido	água
líqüido	líquido/gás
machucado	fractura/fratura
machucar	atropelar/estirar/tirotear/arranhar/raspar/puxar/atirar
magnitude	amplidão/tamanho/dimensão/medida/proporção/extensão/significação/alcance/altitude/altura/quantidade/significado/extensão/número
magoar	humilhar/descompor/mortificar/aviltar/ofender/insultar/rebaixar
mal	fractura/fratura
malograr	borrar/ferrar/arruinar
manar	fluir/correr
manobra	ofensiva/campanha/ataque
manter	negar/deter/deduzir/poupar/preservar/conservar/reter/guardar/segurar
manufatura	produção
maquinaria	moinhos/calculadora/maquinário/moinho/computador/máquina/motores/motor
maquinário	moinhos/moinho
marido	esposa/mulher
mascarar	esconder
matar	decapitar/degolar/executar/chacinar/trucidar/aniquilar/balear/devastar/dizimar/massacrar/assassinar/erradicar/afogar/asfixiar/liquidar/despachar/estrangular/neutralizar/sufocar/executar
materiais	minérios/química/thread/mineral/fibras/lixo/resíduo/condutor/fibra/substância/papel/colorante/matéria-prima/corante/átomo/rocha/cimento/partícula/tinta/pedra/solo/cor
mato	rosa/rosas/rosa/pimentão/pimenta/algodão
matéria	líqüido/sedimento/fluido/substância/depósito/residuo/sólida/sólido
medicamento	terapia/remédio/analgésicos/intoxicante/analgésico/narcótico/sedativo/calmante
medir	enaltecer/elogiar/louvar
medo	pânico/terror/calafrio/tremedeira/tremura/arrepio/tremor
melhorar	reparar/emendar/lustrar/consertar/polir/refinar/embonecar/perfazer/atenuar/empetecar/amenizar/aperfeiçoar/embelezar/acordar/resolver/aliviar
melhoria	anexo/asa
melodia	encabeçamento
membro	soror/irmã/perna
mencionar	desenterrar/apresentar/levantar
menino	bebé/criancinha/nenê/recém-nascido/bebê/filha/rapaz
mensagem	agouro/indício/presságio/correio/indicação/linguagem/discurso/idioma/língua/sinal/telegrama/documento/linguagem/tópico/assunto/conteúdo/discurso/voz/anúncio/língua/estilo
mensurar	cronometrar
mercadoria	carregamento/frete/carga
mercantilismo	industria/pagamento/empresa/negócio/comércio/venda
meta	arte/objetivo/fim/habilidade/intenção
metais	cobre/estanho/chumbo/cobre/ferro
metal	cobre/estanho/chumbo/cobre/ferro
metodo	sistema
mexer	contorcer/enroscar/espernear/torcer-se/manar/virar-se/dançar/fluir/pulsar/tornar-se/girar/sacudir/tremer/sair/correr/partir/agitar/deixar/virar/separar/vassourar/bailar/oscilar/dançar/ondular/varrer/encostar/rolar/atravessar/desaparecer/agitar/bater
migração	emigração/expatriação
minguar	amainar/contrair-se/murchar/abater/amenizar/encolher/enrugar/declinar/contrair/enfraquecer/diminuir
missiva	invitação/convite
mobiliário	aparelhador/cómoda/gaveteiro/candeeiro/cômoda/luminária/assento/mesa/cadeira/guardarroupas/guarda-roupas/estante/mesa/armário
mobília	aparelhador/cómoda/gaveteiro/candeeiro/cômoda/luminária/assento/mesa/cadeira/guardarroupas/guarda-roupas/estante/mesa/armário
modelar	plasmar/achatar/amoldar/retorcer/aplainar/moldar/enxugar/forjar/fundir/torcer/transformar
modificar	impactar/aperfeiçoar/acertar/completar/afetar/modelar/formar/substituir/ajustar/corrigir/melhorar/encher/trocar/reduzir/diminuir/acostumar-se/adequar/amalgamar/aprontar/assear/cevar/depravar/desabilitar/desordenar/evaziar/fortalecer/habituar/habituar-se/indispor/inseminar/perverter/transubstanciar/acostumar/adaptar/afectar/afrouxar/agravar/ampliar/avariar/corromper/desativar/desobstruir/emprestar/engordar/equiparar/exacerbar/fecundar/fertilizar/incapacitar/transmudar/viciar/alumiar/desvirtuar/encerrar/esfriar/estreitar/macular/purgar/refrigerar/resfriar/secar/subverter/bagunçar/contaminar/contribuir/enrijecer/fortificar/gelar/molhar/progredir/sujar/amortecer/aviltar/converter/danificar/esquentar/esvaziar/refrescar/traduzir/unificar/afetar/aquecer/enxugar/igualar/apertar/clarear/endurecer/piorar/enfraquecer/manchar/marcar/baixar/finalizar/preparar/adicionar/ajustar/transformar/concluir/encher/trazer/misturar/terminar/deixar/limpar/carregar/conduzir/cair/aumentar/fazer
modificação	decréscimo/falecimento/dano/estrago/flutuação/avaria/variação/prejuízo/surpresa/queda/diminuição/abatimento/morte/mudança/transmutação/nascimento/transformação/crescimento/transição/aumento/mudança
moeda	cache/numerário/divisa/dinheiro/dólar
moita	rosa/rosas/rosa/pimentão/pimenta/algodão
moldar	plasmar/amoldar/forjar/fundir/modelar/transformar
molestar	assediar/aborrecer/importunar/irritar/provocar/incomodar
montão	leva/horda/turba/tropa/legião/exército/multidão/massa
morada	vivenda/habitação/casa
moradia	vivenda/habitação/casa
morador	europeu
morrer	afogar-se/afogar/tombar/cair
morto	enchido/defunto/cadáver/corpo
mota	moto/motocicleta
motivação	morais/moralidade/ética/moral/vida
motivo	morais/moralidade/ética/moral/vida
moto	mota/motocicleta
motocicleta	moto/mota
mover	contorcer/enroscar/espernear/torcer-se/manar/virar-se/dançar/fluir/pulsar/tornar-se/girar/sacudir/tremer/sair/correr/partir/agitar/deixar/virar/separar/vassourar/bailar/oscilar/dançar/ondular/varrer/encostar/rolar/atravessar/desaparecer/agitar/bater
movéis	aparelhador/cómoda/gaveteiro/candeeiro/cômoda/luminária/assento/mesa/cadeira/guardarroupas/guarda-roupas/estante/mesa/armário
mudança	decréscimo/falecimento/dano/estrago/flutuação/rotação/avaria/variação/gesto/prejuízo/surpresa/queda/diminuição/sinal/abatimento/morte/transmutação/agitação/nascimento/transformação/crescimento/golpe/transição/diferença/inclinação/aumento
mudar	impactar/aperfeiçoar/acertar/completar/afetar/modelar/formar/substituir/ajustar/corrigir/melhorar/encher/trocar/reduzir/diminuir/acostumar-se/adequar/amalgamar/aprontar/assear/cevar/depravar/desabilitar/desordenar/evaziar/fortalecer/habituar/habituar-se/indispor/inseminar/perverter/transubstanciar/acostumar/adaptar/afectar/afrouxar/agravar/ampliar/avariar/corromper/desativar/desobstruir/emprestar/engordar/equiparar/exacerbar/fecundar/fertilizar/incapacitar/transmudar/viciar/alumiar/desvirtuar/encerrar/esfriar/estreitar/macular/purgar/refrigerar/resfriar/secar/subverter/bagunçar/contaminar/contribuir/enrijecer/fortificar/gelar/molhar/progredir/sujar/amortecer/aviltar/converter/danificar/esquentar/esvaziar/refrescar/traduzir/unificar/afetar/aquecer/enxugar/igualar/apertar/clarear/endurecer/piorar/enfraquecer/manchar/marcar/baixar/finalizar/preparar/adicionar/ajustar/transformar/concluir/encher/trazer/misturar/terminar/deixar/limpar/carregar/conduzir/cair/aumentar/fazer
mulher	dona-de-casa/dona/esposa/senhora/dama/madame/senhorita/senhora/dama/garota/moça/rapariga
multidão	leva/horda/turba/tropa/legião/exército/massa
musico	compositor
máquina	moinhos/calculadora/maquinaria/maquinário/moinho/computador/motores/motor
mãe	progenitora/papai/papá/painho/pai
mão-de-obra	empenho/esforço
método	sistema
métodos	sistema
móvel	aparelhador/cómoda/gaveteiro/candeeiro/cômoda/luminária/assento/mesa/cadeira/guardarroupas/guarda-roupas/estante/mesa/armário
música	seção/parte
músico	compositor
navio	batel/iate/bote/escaler/barco/embarcação/navios/barco
navios	batel/iate/bote/escaler/barco/embarcação/navio/barco
nação	ralé
necessidade	ausência/escassez/deficiência/falta/carência/morais/moralidade/ética/moral/vida
negar	reter/conter
negociante	dono/proprietário
negócio	transportação/indústria/manufatura/transporte/expedição/finança
nome	denominação/cognome/sobrenome/antenome/prenome/apelido/título
nomear	baptizar/batizar
noção	psique/atitude/mente/cabeça/incapacidade/informação/capacidade/conhecimento/poder/habilidade/talento
nutriente	bebida/alimentos/comestivel/provisões/suprimentos/ração/alimentação/nutrição/comida/alimento
número	amplidão/tamanho/dimensão/medida/proporção/magnitude/extensão/maioridade/montante/ascendência/maioria/totalizar/alcance/soma/quantidade/extensão
obedecer	escutar
objectivo	objetivo/fim/intenção
objeto	chão/locação/relevo/localização/solo/terra/ponto/lugar/solos/coisas/todo/lua/resto/porção/unidade/solo/formação/terra/parte
objeção	queixa
obrigação	incumbência/serviço/designação/função/tarefa/papel
obstáculo	problema
obter	beneficiar-se/re-adquirir/beneficiar/reconquistar/reganhar/auferir/lucrar/comprar/recuperar/ganhar/adquirir/encontrar/atingir/compartir/fretar/reganhar/topar/partilhar/alugar/ganhar/adquirir/receber/encontrar/aceitar/atingir/achar/dividir
ocasião	vez
ocorrer	materializar/re-ocorrer/reincidir/calhar/recorrer/prosseguir/suceder/repetir/acontecer/ir
ocorrência	vez
ocultar	disfarçar/mascarar/encobrir/esconder/sepultar/soterrar/enterrar
ocupação	ofício/arte/profissão/cargo/posto/posição
odor	aroma/fragância
ofender	humilhar/descompor/mortificar/aviltar/insultar/rebaixar
ofensa	infracção/infração/afronta/desconsideração/insulto/crime/injúria
oferecer	legar/deixar/entregar/passar/dar/render-se/ceder/entregar/dar
oficina	chácara/granja/quinta/sítio/fazenda/central
ofício	arte/profissão/cargo/pintura/posto/posição
omitir	disfarçar/mascarar/encobrir/esconder/sepultar/soterrar/enterrar
ontogenia	cultura
ontogénese	cultura
operar	avionar/pilotar/voar
operação	ofensiva/campanha/ataque/manobra
opinião	doutrina/projecto/conceito/convicção/religião/filosofia/concepção/programação/certeza/idéia/tema/motivo/projeto/fé/ideia/intenção/programa/plano/espirito/perspicácia/confiança/pensamento/sentido/fé/significado/intenção
oportunidade	audiência/ouvinte/chance/dia
oposição	resistência/reação
opção	cabimento/possibilidade
ordem	guilda/clube/sociedade/consórcio/mandamento/gangue/sindicato/instituição/quadrilha/instituto
organização	guilda/clube/elenco/associação/chapa/comissão/comité/comitê/legenda/partido/delegação/economia/embaixada/missão/sociedade/pessoal/união/companhia/ordem/consórcio/coalizão/coligação/gangue/sindicato/empresa/instituição/quadrilha/instituto/aliança/companhia
orientador	capataz/supervisor/chefe
ornamento	naipe/emblema/decoração
ornato	ornamento/decoração
osso	dentes/dente
pagar	reintegrar/retribuir/despender/restituir/repagar/gastar/desembolsar/corromper/indenizar/subornar/doar/recompensar/contribuir/gastar/compensar
pai	progenitora/papai/papá/painho/mãe
pano	seda/algodão/crepe/mohair/trama/malha/rede
papar	mordiscar
papel	folhas/cartão/carta/folha/folhas/folha
par	associado
parar	desistir/abandonar
parecer	assemelhar/esfriar/reagir/conquistar/copiar/surgir/endurecer/imitar/adquirir/fazer
parente	antecessor/cónjuge/prima/consorte/cônjuge/esposa/esposo/marido/ancestral/antepassado/descendência/primo/companheiro/descendente/filho/família
parentesco	paternidade
parte	elemento/hardware/excedente/restante/adição/resíduo/sobra/melhoria/resto/substância/componente/item/pixel/píxel/membro/unidade/componente
partida	despedida/competição/torneio/corrida/combate/jogo/luta/despacho/envio/saída/corrida/expedição
partir	dispersar/espalhar
passar	comissionar/desobrigar/incumbir/materializar/re-ocorrer/reincidir/calhar/confidenciar/lembrar-se/confiar/recorrer/livrar/alienar/transferir/ocorrer/prosseguir/renunciar/suceder/repetir/atravessar/lembrar/acontecer/desistir/transmitir/liberar/correr/abandonar/deixar/entregar/ir/dar
passo	rapidez/velocidade
pau	clava/porrete
pavimento	cave/mansarda/porão/trapeira/sótão/ático
pecado	decadência/queda
peculiaridade	disposição/atividade/egocentrismo/índole/bobeira/caráter/sagacidade/sapiência/conduta/egoísmo/firmeza/modalidade/natureza/disciplina/sabedoria/sensatez/comportamento/procedimento/personalidade/maneira
pecuária	horticultura
pedagogia	aula/curso
pedaço	pano
pedido	consumo
pedir	mendigar/demandar/exigir/convidar/reivindicar/solicitar/convidar/requerer/reclamar/organizar
pedra	litíase/matacão/rochedo/pedregulho/rocha
pegar	apreender/agarrar/prender/segurar/agarrar/capturar/segurar
peleja	conflito/disputa
penalizar	executar
pendurar	suspender
penetrar	perfurar/furar
pensamento	projecto/conceito/concepção/programação/idéia/tema/motivo/projeto/ideia/intenção/programa/plano/sentido/significado/intenção
pensar	centrar/ruminar/concentrar/associar/cogitar/conectar/relacionar/ponderar/especular/focar/contemplar/planejar/refletir/afigurar/balizar/envisionar/reputar/figurar/raciocinar/visualizar/avaliar/julgar/considerar/achar/ver
perceber	enxergar/ouvir/doer/escutar/cheirar/sentir/olhar/ver/avistar/divisar/sonhar/ver
percepção	sensação
percurso	rumo/direcção/direção/curso
perecer	afogar-se/afogar/tombar/cair
performance	mecanica/mecanismo
perfurar	furar
perguntar	consultar
permitir	aturar/tolerar/aguentar/suportar/admitir/aceitar/confiar/autorizar
personalidade	identidade
persuadir	convencer
perturbar	assediar/aborrecer/molestar/importunar/irritar/provocar/incomodar
período	centúria/decênio/década/estio/inverno/outono/primavera/sazão/século/séculos/verão/manhã/mês/noitada/século/estágio/semana/continuidade/trimestre/fase/tarde/duração/era/estação/idade/época/ano/noite/tempo/pré-história/jornada/noitada/temporada/semana/sono/prazo/sesta/era/estação/idade/juventude/época/licença/ano/hora/passado/momento/noite/dia/vida/tempo
pessoa	conhecida/engenheiro/habitante/proponente/líder/morador/cientista/especialista/parente/conhecido/defensor/identidade/advogado/amizade/autoridade/vizinho/aluno/chefe/personalidade/trabalhador/amigo/estudante/representante/adjudicator/amado/amo/comunicador/creador/desafortunado/desventurado/governante/hebraica/hebreia/infortunado/intelecto/possuidor/amiga/anomalia/autóctone/competidor/contendor/criatura/fêmea/governador/súdito/turista/capitalista/cidadão/criador/dono/hebreu/judia/artista/camarada/conhecido/criativo/hebraico/judeu/juvenil/menor/viajante/amizade/criança/juiz/proprietário/seguidor/amante/esperança/face/jovem/árbitro/amigo/intelectual/varão/estudante/macho/rosto/cara/homem/ser/parte/vida
pessoal	galera/vulgo/nação/estrato/geração/inimigo/mundo/população/gente/povo/classe/freguesia/ralé/clientela/coorte/mediação/nação/gente/povo
peça	pano/dólar
piorar	degenerar/degradar/deteriorar/adoecer/adoentar/decair
piso	cave/mansarda/porão/trapeira/sótão/ático
placar	conseqüência/resultado
planejar	destinar
plano	configuração/programa
planta	casademoinho/fábrica/manufatura/usina/epifitismo/epífito/traqueófitos
poder	efeitos
polir	aculturar/civilizar/escolar/educar/cultivar/treinar
ponderar	questionar/perguntar
ponto	regiões/selva/floresta/região/lar/região/fronteira/lugar/casa
população	galera/vulgo/nação/estrato/geração/inimigo/mundo/gente/pessoal/povo/classe/freguesia/clientela/coorte/nação/gente/povo
porrada	pontapé/chute
porção	elemento/excedente/restante/resíduo/sobra/resto/substância/componente/drinque/item/fatia/bebida/membro/unidade/componente/pedaço
posição	gradação/nacionalidade/hierarquia/posto/grau/classe/dignidade/espaçamento/nobreza/composição/liderança/posto/primeiro/lugar
possessão	imobiliária/imóvel/riqueza/fundo/bem
possibilidade	pressuposição/suposição/hipótese
posto	gradação/grau/primeiro
povo	galera/vulgo/nação/estrato/geração/inimigo/mundo/população/gente/pessoal/classe/freguesia/ralé/clientela/coorte/nação/gente
prata	dólar
prato	salada/sopa
prazer	deleite/conforto/alegria
praça	piazza/adro/largo
prender	trancar/pendurar/implantar/conectar/pendurar/amarrar/atar/forçar/ligar/colocar
prenome	denominação/cognome/sobrenome/antenome/apelido/nome/título
preocupação	interesse/caso
preparar	preservar/conservar
preparação	prática/exercício
presente	galardão/prémio/prêmio/ajuda
preservar	enlatar/conservar
presságio	evidência/indicação
pretensão	ambição/aspiração/afã/concupiscência/cio/eros/saudade/anelo/anseio/desejo
privar	deserdar
problema	estrondo/aflição/infortúnio/azar/ruído
procedimento	cálculo
processo	cálculo
procurar	arriscar/revirar/arriscar
produto	carregamento/frete/mercadoria/carga
produtor	cineasta
produtores	cineasta
produzir	reproduzir/criar/publicar/editar/imprimir
profissional	jurista/advogado/educacionista/pedagogo/educador/médico
profissão	ofício/arte/cargo/pedagogia/pintura/posto/política/posição
progenitor	progenitora/papai/papá/painho/pai/mãe
programa	sub-rotina/subrotina/procedimento/função
programação	programa
projecto	programa
projeto	aventura/bebê/programa
propor	advocar/recomendar/urgir/promover
propriedade	característica/qualidade/imobiliária/predominância/vantagem/imóvel/possessão/benefício/riqueza/qualidade/fundo/bem
protecção	tutela/cuidado
proteção	seguros/seguro/tutela/cuidado
provar	validar/demonstrar
prover	apetrechar/aparelhar/equipar/suprir/abrigar/amparar/mobiliar/armar/despejar/derramar/fornecer/suprir/alimentar/dar
provocar	magoar/ofender/humilhar/descompor/encolerizar/irar/zangar/comover/interessar/mortificar/desconcertar/enraivecer/aviltar/emocionar/ofender/insultar/rebaixar/estimular/atrair/perturbar/confundir/excitar/superar/pedir
provérbio	ditado
prática	revisão
prédio	escolas/plantel/vivenda/estufa/hall/hotel/restaurante/viveiro/colégio/departamento/habitação/salão/centro/escola/casa/casadeoração/clube/ministério/igreja/templo/teatro/casa
publicação	livro/coletânea/coleção/periódico/revista/compêndio/jornal
pugna	conflito/disputa
pular	arrebentar
pulsar	palpitar
punir	executar
puxar	arrastar/tremer
pário	associado
pão	pãozinho
pôr	deitar/semear/instalar/dispor/plantar/arranjar/colocar/estacionar/posicionar/instalar/posar/sentar-se/assentar/sentar/situar/acumular/sinalizar/erguer/levantar
qualidade	faceta/característica/incompatibilidade
quantidade	montante/totalizar/soma/número
quantificar	cronometrar
quarto	hall/bar/cozinha/banheiro/sala/biblioteca/banheiro/sala
querer	ansiar/suspirar/desejar/esperançar/aguardar/esperar/desejar
química	explosivo
raciocinar	centrar/ruminar/concentrar/associar/cogitar/conectar/relacionar/ponderar/especular/focar/contemplar/planejar/refletir/balizar/avaliar/julgar
raciocínio	política
raiva	fúria/ira/cólera
re-adquirir	acessar
realização	mecanica/proeza/feito/obtenção/andada/façanha/mecanismo
receber	beneficiar-se/re-adquirir/beneficiar/reconquistar/reganhar/auferir/lucrar/comprar/recuperar/ganhar/obter/adquirir/encontrar/atingir/compartir/fretar/reganhar/topar/partilhar/alugar/ganhar/adquirir/encontrar/aceitar/atingir/achar/dividir
recender	feder/cheirar
reconhecer	confessar/conceder/admitir
reconquistar	acessar
recontro	atrito/fricção
recordar	reconhecer
recordar-se	reconhecer
recuperar	acessar
recuperação	salvamento/salvação
recurso	predominância/vantagem/benefício
redigir	registar/registrar
reduzir	encurtar/resumir/condensar/abreviar/diminuir/circunscrever/encurtar/encolher/confinar/minimizar/ferver/limitar/restringir/diminuir
refinar	aculturar/civilizar/escolar/educar/cultivar/treinar
refletir	centrar/ruminar/concentrar/associar/cogitar/conectar/relacionar/ponderar/especular/focar/questionar/contemplar/perguntar/planejar/balizar/raciocinar/avaliar/julgar
regalar	legar/deixar/entregar/passar/dar/render-se/ceder/entregar/dar
reganhar	acessar
reger	gerir/governar/reinar/manobrar/canalizar/lidar/cuidar/guiar/dirigir
regime	estado/palácio
registro	registo/índices/registrador
região	circunscrição/comarca/districto/tumba/túmulo/distrito/sepultura/território/zona/domínio/paragem/território/esconderijo/ambiente/área/parada/ponto/domínio
regiões	circunscrição/comarca/districto/distrito/território/domínio/território/ambiente/área/região/domínio
relacionamento	romance
relacionar	mencionar/referir
relação	paternidade/romance
relevo	florestas/arvoredo/selva/bosque/ilha/mata/floresta/planície/chão/campanha/terra
remédio	terapia/medicamento/analgésicos/intoxicante/analgésico/narcótico/sedativo/calmante
reparar	remendar/consertar
repetição	recorrência
representante	mostra/excepção/exceção/amostra/agente
reproduzir	simular/copiar/imitar/hibridizar/cruzar
requerer	mendigar/demandar/exigir/convidar/pedir/reivindicar/solicitar/convidar/reclamar/organizar
requisitar	mendigar/demandar/exigir/convidar/pedir/reivindicar/solicitar/convidar/requerer/reclamar/organizar
residência	vivenda/habitação/casa/lar/casa
resolver	seleccionar/selecionar/escolher/mensurar/regulamentar/regularizar/decretar/inferir/medir/adivinhar/supor
responsável	administrador/gerente
restringir	delimitar/marcar
resultado	demolição/efeitos/placar/destruição/influência/desolação/vitória/efeito/términio/vencimento/conseqüência/derrota/parada/perda
reter	negar/deter/deduzir/poupar/preservar/conservar/guardar/segurar/manter
reunir	apinhar/reunir-se/acoplar/anexar/juntar/unir
reunião	sessão/encontro/concentração
revalidar	validar/demonstrar
ritmo	rapidez/velocidade
rito	nupcias/casamento
ritual	nupcias/casamento
rocha	litíase/matacão/rochedo/pedregulho/pedra
rodovia	entrada/caminho/avenida
roque	minarete/farol
rota	rumo/direcção/direção/curso
rotação	giro/torção
ruminar	ponderar/questionar/perguntar
ruído	baterpalmas/explosão
sacudir	estremecer/tremular/tiritar/tremer
sala	hall/bar/cozinha/banheiro/biblioteca/banheiro
salpicar	borrifar
saltar	arrebentar
sazão	estio/inverno/outono/primavera/verão
secreção	hormona/hormônio/hormônios
segmento	curva
segurar	apreender/negar/agarrar/prender/deter/deduzir/poupar/preservar/conservar/agarrar/capturar/reter/guardar/pegar/manter
seleccionar	eleger/votar/decidir/escolher/esposar/adoptar/adotar
selecionar	eleger/votar/decidir/escolher/esposar/adoptar/adotar
semblante	aspecto/rosto/aparência/feiura/feiúra/beleza/face/rosto/aparência
sentença	revogação
sentimento	zanga/consternação/espírito/ira/cólera/temor/raiva/terror/humor/medo/alegria/ânsia/ódio/ansiedade/aversão/preocupação/afeição/amor
sentir	arrepender/arrepender-se/lamentar/regozijar/regozijar-se/alegrar-se/enraivecer/entreter/alegrar/arder/sustentar/sofrer/guardar/considerar/manter
separar	dispersar/espalhar
ser	cria/predadores/prole/filhote/presa/invertebrados/cordados/fêmea/herbívoro/invertebrado/caça/larva/macho
serventuário	magistrado/jurista/juiz/servidor
servidor	manequim/secretário/secretária/modelo/doméstico/empregado
servir	caber/ajustar
serviço	ofício/arte/profissão/cargo/posto/posição
seção	curva
shopping	boutique/loja/venda
show	película/cinema/filme/emissão/produção/programa/atuação
significar	denotar
simbolo	numeral/símbolo/selo/número/marcadores/estigma/marca/mancha/selo
sinal	numeral/simbolo/símbolos/aceno/emblema/telefone/símbolo/selo/número/marcadores/estigma/evidência/indicação/marca/mancha/selo
sintoma	cefaleia/inflamação/dor
sistema	economia
situação	ascendencia/delinquência/dominancia/melhora/superioridade/conforto/melhoria/necessidade/culpa/perigo/segurança/carência/controle/domínio/ordem/iniqüidade/nudez/secura/secas/aridez/circunstância/cena/cenário/imunidade/ambiente/prisão/maldade/posição
sociedade	guilda/clube/ordem/consórcio/gangue/sindicato/instituição/quadrilha/instituto
socorrer	facilitar/aliviar
socorro	apoio/mão/ajuda/suporte/ajuda/assistência
software	programa/sub-rotina/subrotina/procedimento/função
solicitar	mendigar/demandar/exigir/convidar/pedir/reivindicar/convidar/requerer/reclamar/organizar
solo	areia/florestas/arvoredo/selva/bosque/ilha/mata/floresta/planície/chão/campanha/terra
soltar	latir/ladrar/relinchar/ecoar/repetir
solucionar	inferir/adivinhar/supor
soma	montante/totalizar/número
status	nacionalidade/hierarquia/posto/classe/posição/dignidade/nobreza/liderança/posto/lugar
subir	galgar/trepar/ascender/montar
substanciar	validar/demonstrar
substituir	converter/trocar/mudar
substância	líqüido/materiais/sedimento/átomo/fluido/depósito/fluído/proto-plasma/protoplasma/residuo/sólida/explosivo/solução/sólido/mistura
suceder	materializar/re-ocorrer/reincidir/calhar/recorrer/ocorrer/prosseguir/repetir/acontecer/ir
sugerir	advocar/recomendar/urgir/promover
sumir	esvanecer/desaparecer
superfície	face/lado/firmamento/céu/lado
supervisor	capataz/chefe
suportar	validar/demonstrar
suporte	degrau/pedestal/pé/base/aderência/adesão/endosso/perna/pé
suposição	pressuposição/hipótese
suprir	apetrechar/aparelhar/equipar/abrigar/amparar/mobiliar/armar/despejar/prover/derramar/fornecer/alimentar/dar
surgir	mostrar-se/aparecer
sustentar	validar/demonstrar
século	era/período
símbolo	numeral/selo/número/marcadores/estigma/marca/mancha/selo
símbolos	numeral/símbolo/selo/número/marcadores/estigma/marca/mancha/selo
talento	arte/habilidade
tampar	disfarçar/mascarar/embrulhar/embalar/encobrir/esconder/cobrir/encadernar/sepultar/soterrar/revestir/submergir/enterrar/aplicar/colocar/cobrir
tapar	disfarçar/mascarar/encobrir/esconder/sepultar/soterrar/enterrar
tarefa	aventura/bebê
tecido	estádio/sacada/torres/varanda/alojamento/pavimento/piso/ponte/prédio/roque/seda/torre/varanda/arena/balcão/cruz/monumento/monumentos/algodão/edifício/abrigo/casa/andar/alpendre/arco/corcova/crepe/divisória/mohair/pano/paredes/trama/asilo/malha/obstrução/parede/contrapeso/defesa/estabelecimento/impedimento/monte/refúgio/equilíbrio/arco/rede/obstáculo
teimar	reinvindicar/asseverar/sustentar/manter
telhado	abóbada
temor	pânico/terror/medo/calafrio/tremedeira/tremura/arrepio/tremor
temperamento	identidade/personalidade
tempo	centúria/decênio/década/estio/inverno/outono/primavera/sazão/século/séculos/verão/manhã/mês/noitada/século/vento/estágio/semana/continuidade/trimestre/fase/tarde/duração/era/estação/idade/época/ano/noite/período/pré-história/jornada/noitada/temporada/precipitação/semana/sono/prazo/sesta/era/estação/idade/juventude/época/licença/ano/hora/passado/momento/noite/dia/vida/período
tensionar	alongar/esticar/estender
tentar	arriscar
tentativa	chute/tacada/esforço/batalha/luta/teste
teoria	pressuposição/suposição/hipótese
ter	reter/guardar/segurar/manter/sustentar/manter
terminar	cumprir/efetuar/executar/desistir/realizar/parar/abandonar/atingir
terra	areia/florestas/arvoredo/selva/bosque/ilha/mata/floresta/planície/chão/campanha
terras	plantação/plantio/viveirodeplantas
território	jurisdição/bairro/vizinhança
terror	pânico/medo/calafrio/tremedeira/tremura/arrepio/tremor
teto	abóbada
texto	missiva/melodia/carta/linha
thread	bisso
tirar	devolver/voltar/arrastar/retornar/tremer
tiritar	tremelicar/estremecer/tremer
tocar	prensar/golpear/afagar/colidir/pressionar/apertar/atingir/bater/golpear/roçar/manusear/acertar/raspar/bater
tomar	bebericar/sorver/sugar/chupar
tornar-se	defletir/encarar/curvar/dobrar/derrubar/girar/virar
torneio	competição/corrida/combate/partida/jogo/luta/corrida
torre	minarete/farol
torres	minarete/farol
trabalhador	criado/assalariado/ajudante/assistente/empregado/servidor/operário
trabalhar	laborar/exercer/ralar/servir
trabalho	chácara/granja/quinta/oficina/ofício/sítio/arte/profissão/fazenda/empenho/cargo/central/esforço/posto/posição
transação	comercialismo/mercantilismo/comércio
transferência	entrega
transmitir	remeter/despachar/enviar
transportar	devolver/voltar/retornar/carregar/aerotransportar
transporte	entrega
traspassar	perfurar/furar
tratar	amimar/mimar/mimosear/afagar/injustiçar/ironizar/administrar/cauterizar/desconsiderar/esnobar/maltratar/operar/ignorar/menosprezar/zombar/dispensar/queimar
traumatismo	fractura/fratura
trazer	devolver/voltar/retornar
traço	bochecha/chinchilla/mento/testa/têmpora/queixo
treinamento	prática/exercício
treino	prática/exercício
tremer	estremecer/tremular/tiritar/tremelicar/estremecer/tiritar
tremular	tremelicar/estremecer/tiritar/tremer
tribo	genealogia/família
tronco	galho/ramo
trâmite	caminho
tubo	vaso
tumores	neoplasia/tumor
turba	leva/horda/tropa/legião/exército/multidão/massa
técnica	arte/habilidade/sistema
têxteis	seda/algodão/crepe/mohair/pano/trama/malha/rede
unir	acoplar/anexar/juntar
união	guilda/clube/sociedade/ordem/consórcio/gangue/sindicato/instituição/quadrilha/instituto
urrar	esganiçar/gritar
usina	casademoinho/fábrica/manufatura
usuário	consumidor
utente	consumidor
utilizador	consumidor
valor	merecimento/mérito/preços/virtude/preço/qualidade
vantagem	predominância/benefício
vara	clava/porrete
variar	adequar/adaptar/ajustar
variação	decréscimo/falecimento/dano/estrago/flutuação/avaria/prejuízo/surpresa/queda/diminuição/abatimento/morte/mudança/transmutação/nascimento/transformação/crescimento/transição/diferença/aumento/mudança
vasilha	garrafa/biberão/botelha/frasco/banheira/garrafa
vasilhame	garrafa/biberão/botelha/frasco/banheira/garrafa
vaso	garrafa/biberão/botelha/frasco/banheira/garrafa
vegetal	epifitismo/epífito/traqueófitos/folhas
vegetação	chaparral/bosque/mata/floresta
venda	botica/drogaria/drograria/farmacia/farmácia
verdura	folhas/vegetal
vexar	assediar/aborrecer/molestar/importunar/irritar/provocar/incomodar
veículo	ambulancia/taxi/ambulância/táxi/calhambeque/jipe/sedan/sedã/carro
via	entrada/caminho/avenida
viajar	engatinhar/gatinhar/rastejar/rastejar-se/serpear/vadiar/vagabundear/vaguear/boiar/pisar/ascender/escorregar/nadar/errar/perambular/vagar/deslizar/voar/apressar/acompanhar/atravessar/caminhar/dirigir/correr/seguir/ir/andar/subir/passar/apressar-se/despachar-se/esquiar/cavalgar/progredir/avançar/perambular/perseguir/vagar/acelerar/rodar/apressar/descer/montar/prosseguir/baixar/circular/espalhar/vir/continuar/seguir/ir/andar/passar/cair
vianda	corte
viatura	ambulancia/taxi/ambulância/táxi/calhambeque/jipe/sedan/sedã/carro
virar	defletir/encarar/rodar/curvar/dobrar/derrubar/girar
virar-se	defletir/encarar/curvar/dobrar/derrubar/girar/virar
virtude	predominância/vantagem/benefício
visita	visitação/visitante/companhia
visitante	visita/companhia
vitória	independência
vulgo	ralé
zanga	fúria/ira/cólera/raiva
zona	ilha
álcoois	vinho/fermentação/álcool
álcool	vinho/fermentação
área	tumba/túmulo/sepultura/zona/paragem/esconderijo/parada/ponto
égua	cavalo
época	era/período
órgão	ala/asa/língua/cristalino/genitália/genitália/víscera/lente
