afoito	denodo/coragem/ânimo
alta	gritaria/volume
alto	gritaria/volume/grau
ambicioso	ambição/aspiração
ambição	ambicioso
anchura	estreita/estreito
arrojado	denodo/coragem/ânimo
aspiração	ambicioso
atividade	ativo
ativo	atividade
ausente	presença
berrante	gritaria/volume
brava	denodo/coragem/ânimo
bravo	denodo/coragem/ânimo
calibre	superior
caloroso	temperatura
classe	dominante
comercial	comercialismo/mercantilismo/comércio
comercialismo	comercial
comércio	comercial
condição	dominante
confiante	confiança
confiança	confiante/tímido/inseguro
conforto	confortável
confortável	conforto
conservador	ideologia
consternação	receoso
convencional	convenção
convenção	corriqueiro/convencional
coragem	afoito/brava/valoroso/arrojado/valente/corajoso/bravo
corajoso	denodo/coragem/ânimo
corriqueiro	convenção
credibilidade	inacreditável/incrível
crise	crítico
crítico	crise
curto	duração
delicado	força
denodo	afoito/brava/valoroso/arrojado/valente/corajoso/bravo
dificuldade	intrincado/árduo/difícil
difícil	dificuldade
dimensão	grande/pequeno
disposto	prontidão/rapidez/preparação
distante	distância
distância	longe/vizinho/longínquo/perto/distante/próximo
diversidade	vário
dominante	status/condição/estado/classe/posição
duração	curto
débil	força
emocionante	excitamento/excitação
errado	verdade
estado	dominante
estreita	anchura/largura
estreito	anchura/largura
estrepitante	gritaria/volume
excitamento	emocionante/excitante
excitante	excitamento/excitação
excitação	emocionante/excitante
existente	realismo/realidade/verdade
falso	verdade
fiel	lealdade
fino	textura
forgoso	temperatura
força	débil/delicado
fresco	temperatura
frio	temperatura
funcional	propósito/função
função	funcional
grande	tamanho/dimensão/medida
grau	suave/intenso/alto
gritaria	berrante/estrepitante/alta/suave/alto
gênero	sexual
horizontal	orientação
idade	maturo/maduro/velho/novo
ideologia	conservador/liberal
inacreditável	credibilidade
incrível	credibilidade
inseguro	confiança
integral	integridade
integridade	partido/quebrado/integral/inteiro
inteiro	integridade
intelectual	inteligência
inteligência	intelectual
intenso	grau
intrincado	dificuldade
largura	estreita/estreito
leal	lealdade
lealdade	leal/fiel
leve	peso
liberal	ideologia
liberdade	livre
livre	liberdade
longe	distância
longínquo	distância
maduro	idade
maturo	idade
medida	grande/pequeno
medo	receoso
mercantilismo	comercial
novo	idade
orientação	horizontal/vertical/perpendicular
partido	integridade
pequeno	tamanho/dimensão/medida
perpendicular	orientação
perto	distância
pesado	peso
peso	leve/pesado
posição	dominante
possível	potenciabilidade/potencial
potenciabilidade	possível/potencial
potencial	potenciabilidade/possível
preparado	prontidão/rapidez/preparação
preparação	prestes/disposto/pronto/preparado
presente	presença
presença	ausente/presente
prestes	prontidão/rapidez/preparação
prontidão	prestes/disposto/pronto/preparado
pronto	prontidão/rapidez/preparação
propósito	funcional
próximo	distância
qualidade	superior
quebrado	integridade
quente	temperatura
rapidez	prestes/disposto/pronto/preparado
realidade	existente
realismo	existente
receoso	consternação/temor/terror/medo
sensibilidade	sensível
sensível	sensibilidade
sexo	sexual
sexual	sexualidade/gênero/sexo
sexualidade	sexual
status	dominante
suave	gritaria/volume/grau
superior	calibre/qualidade
tamanho	grande/pequeno
temor	receoso
temperatura	caloroso/forgoso/fresco/quente/frio
terror	receoso
textura	fino
tímido	confiança
valente	denodo/coragem/ânimo
valoroso	denodo/coragem/ânimo
velho	idade
verdade	existente/falso/verdadeiro/errado
verdadeiro	verdade
vertical	orientação
vizinho	distância
volume	berrante/estrepitante/alta/suave/alto
vário	diversidade
árduo	dificuldade
ânimo	afoito/brava/valoroso/arrojado/valente/corajoso/bravo
