abastecer	comercialismo/mercantilismo/comércio
abduzir	crime/ofensa
abrasar	culinária/cozinha/preparação
abrir	xadrez
absorver	quimica/química
acastanhar	culinária/cozinha/preparação
acetilar	quimica/quimica/química/química
acidificar	quimica/química
acompanhar	música
acreditar	religião/fé
acrescentar	flora/planta/vegetal
actuar	dramaturgia/teatro
adorar	religião/fé
adornar	arte
adquirir	comercialismo/comercialismo/mercantilismo/mercantilismo/comércio/comércio
adsorver	quimica/química
advogar	jurisprudência/lei
agudizar	música
ajardinar	horticultura
alcalinizar	quimica/quimica/química/química
alcoolizar	culinária/culinária/cozinha/cozinha/preparação/preparação
alfabetizar	linguagem/discurso/idioma/língua
aliar	quimica/química
amanhar	agricultura/pecuária/cultivo
amansar	criatura/criatura/animal/animal/besta/besta/bicho/bicho/ser/ser
amoldar	arte
amonificar	quimica/química
andar	esporte
anistiar	jurisprudência/lei
aparecer	dramaturgia/teatro
apelar	jurisprudência/lei
apimentar	culinária/cozinha/preparação
aprisionar	jurisprudência/lei
apurar	quimica/química
aquartelar	exército
arar	agricultura/agricultura/pecuária/pecuária/cultivo/cultivo
arbitrar	esporte
armazenar	comercialismo/mercantilismo/comércio
assar	culinária/culinária/cozinha/cozinha/preparação/preparação
atenuar	jurisprudência/lei
atestar	jurisprudência/lei
atingir	comercialismo/mercantilismo/comércio
atuar	dramaturgia/dramaturgia/teatro/teatro
avionar	aeronave/aeroplano/avião
baixar	música
balançar	música
basificar	quimica/química
bater	música/culinária/cozinha/preparação
bosquejar	arte
boxar	esporte
boxear	esporte
brilhar	astro/estrela
caiacar	esporte
cair	música
calcular	matematica/matemática
calibrar	culinária/cozinha/preparação
caminhar	esporte/esporte
canonizar	igrejas/religião/igreja
cantar	música/música
capacitar	jurisprudência/lei
caramelar	culinária/cozinha/preparação
caramelizar	culinária/culinária/cozinha/cozinha/preparação/preparação
carboxilar	quimica/química
catabolizar	quimica/química
catalisar	quimica/química
chantagear	crime/ofensa
chapinhar	esporte
churrasquear	culinária/cozinha/preparação
chutar	esporte/futebol
cintilar	astro/estrela
clarear	culinária/cozinha/preparação
clarificar	culinária/culinária/cozinha/cozinha/preparação/preparação
co-estrelar	dramaturgia/teatro
co-protagonizar	dramaturgia/teatro
coadjuvar	dramaturgia/teatro
cobrir	mamífero
coestrelar	dramaturgia/teatro
comercializar	comercialismo/mercantilismo/comércio
comerciar	comercialismo/mercantilismo/comércio
completar	futebol
compor	música
comprar	comercialismo/comercialismo/mercantilismo/mercantilismo/comércio/comércio
computar	matematica/matemática
condenar	jurisprudência/jurisprudência/lei/lei
condimentar	culinária/culinária/cozinha/cozinha/preparação/preparação
conduzir	música/música
congelar	física
conservar	culinária/cozinha/preparação
construir	edificação/construção
contestar	jurisprudência/lei
contrabandear	comercialismo/mercantilismo/crime/ofensa/comércio
controlar	ciência
convencionar	arte
convergir	matematica/matemática
converter	quimica/química
copiar	biologia
correr	esporte/esporte
corromper	crime/ofensa
cozer	culinária/cozinha/preparação
cozinhar	culinária/cozinha/preparação
crer	religião/fé
crismar	igrejas/religião/igreja
cristalizar	física
cultivar	flora/agricultura/agricultura/pecuária/pecuária/planta/cultivo/cultivo/vegetal
dançar	dança/baile
debilitar	quimica/química
decair	física
delinear	arte
desanexar	exército
desclassificar	esporte
desenhar	arte
desenvolver	matematica/matemática
desintegrar	física
desintoxicar	quimica/química
deslizar	esporte
desmagnetizar	física
desmineralizar	quimica/química
desnitrificar	quimica/química
desossar	criatura/animal/besta/bicho/ser
desoxidar	quimica/química
despolarizar	física
destilar	quimica/quimica/quimica/química/química/química
diferenciar	matematica/matemática
diminuir	culinária/cozinha/preparação
dissociar	quimica/química
distilar	quimica/química
distribuir	esporte
dividir	quimica/quimica/física/química/química
domar	criatura/flora/animal/besta/bicho/planta/vegetal/ser
domesticar	criatura/criatura/flora/animal/animal/besta/besta/bicho/bicho/planta/vegetal/ser/ser
dourar	culinária/cozinha/preparação
driblar	esporte
dublar	película/cinema/filme/produção
ebonizar	alfaia/movéis/mobília/mobiliário/móvel
electrificar	física
electrizar	física
eletrificar	física
eletrizar	física
emblazonar	arte
empanar	culinária/cozinha/preparação
empenhar	comercialismo/mercantilismo/comércio
emprisonar	jurisprudência/lei
encarcerar	jurisprudência/lei
encharcar	criatura/animal/besta/bicho/ser
enfarinhar	culinária/cozinha/preparação
engaiolar	jurisprudência/lei
enlatar	culinária/cozinha/preparação
enriquecer	culinária/cozinha/preparação
entalhar	arte
entrar	dramaturgia/teatro
entregar	jurisprudência/lei
envenenar	culinária/cozinha/preparação
erigir	edificação/construção
escalar	esporte
escrever	música
esculpir	arte
escusar	jurisprudência/lei
espalhar	agricultura/pecuária/cultivo
esquiar	esporte
estercar	agricultura/pecuária/cultivo
esterificar	quimica/química
estevar	agricultura/pecuária/cultivo
estilizar	arte
estocar	comercialismo/mercantilismo/comércio
estorrar	agricultura/pecuária/cultivo
estrelar	dramaturgia/teatro
estufar	culinária/culinária/cozinha/cozinha/preparação/preparação
estultificar	jurisprudência/lei
eterizar	quimica/química
etimologizar	lingüística/linguística/lingüística
evidenciar	jurisprudência/lei
exorcizar	igrejas/religião/igreja
exportar	comercialismo/mercantilismo/comércio
externalizar	psicologia
extorquir	crime/ofensa
extrair	quimica/química
extrapolar	matematica/matemática
faiscar	astro/estrela
fazer	comercialismo/dramaturgia/mercantilismo/agricultura/pecuária/comércio/cultivo/teatro
ferver	culinária/culinária/cozinha/cozinha/preparação/preparação
figurar	arte
filetar	culinária/cozinha/preparação
filiar	jurisprudência/lei
filmar	película/cinema/filme/produção
flautear	música
formular	quimica/química
fornear	culinária/culinária/cozinha/cozinha/preparação/preparação
fortificar	culinária/cozinha/preparação
franquiar	comercialismo/mercantilismo/comércio
frigir	culinária/cozinha/preparação
fritar	culinária/culinária/cozinha/cozinha/preparação/preparação
gelar	física
gerar	biologia
glicerolizar	quimica/química
gradar	agricultura/pecuária/cultivo
gratinar	culinária/cozinha/preparação
gravar	película/cinema/filme/arte/produção
grelhar	culinária/culinária/culinária/cozinha/cozinha/cozinha/preparação/preparação/preparação
harmonizar	música/música
idolatrar	religião/fé
iluminar	arte
ilustrar	arte
importar	comercialismo/mercantilismo/comércio
improvisar	culinária/cozinha/preparação
incarcerar	jurisprudência/lei
incluir	quimica/química
induzir	física
inibir	quimica/química/biologia
instruir	jurisprudência/lei
integrar	matematica/matemática
interiorizar	psicologia
intermediar	comercialismo/mercantilismo/comércio
internalizar	psicologia
interpolar	matematica/matemática
iodizar	quimica/química
ir	serviço
isolar	psicologia/quimica/química
isomerizar	quimica/quimica/química/química
iterar	matematica/matemática
jardinar	horticultura
lavrar	agricultura/agricultura/pecuária/pecuária/cultivo/cultivo
leiloar	comercialismo/mercantilismo/comércio
liberar	quimica/química
libertar	quimica/química
licitar	comercialismo/mercantilismo/comércio
ligar	quimica/química
limpar	quimica/química
liquefazer	física
liquidar	comercialismo/mercantilismo/comércio
liquidificar	física/física
livrar	quimica/química
magnetizar	física
marcar	futebol
marinar	culinária/cozinha/preparação
melodizar	música
misturar	quimica/química
mitigar	jurisprudência/lei
mochilar	esporte
modelar	arte
modular	música
montar	mamífero
mostrar	jurisprudência/lei
naturalizar	flora/planta/vegetal
negociar	comercialismo/mercantilismo/comércio
obter	comercialismo/mercantilismo/comércio
oxidar	quimica/química
pagar	crime/ofensa
paliar	jurisprudência/lei
passear	esporte
pastar	criatura/animal/besta/bicho/ser
patejar	esporte
patinar	esporte/esporte/esporte/esporte/esporte
pedalar	música
perdoar	jurisprudência/lei
piar	música
pilotar	aeronave/aeroplano/avião
pincelar	arte
pintar	arte/arte
piratear	crime/ofensa
plagiar	crime/ofensa
plantar	agricultura/agricultura/pecuária/pecuária/cultivo/cultivo
plasmar	arte
pleitear	jurisprudência/lei
polarizar	física
polimerizar	quimica/quimica/química/química
posar	arte
potencializar	entorpecente/droga/medicamento/remédio
pre-fabricar	edificação/construção
preferir	jurisprudência/lei
prender	jurisprudência/lei
preparar	culinária/cozinha/preparação
preservar	culinária/cozinha/preparação
privatizar	industria/indústria/manufatura/empresa/negócio/comércio
privilegiar	comercialismo/mercantilismo/comércio
procriar	biologia
produzir	agricultura/pecuária/cultivo
projectar	psicologia
projetar	psicologia
propagar	flora/planta/vegetal/biologia
protagonizar	dramaturgia/teatro
protocolar	jurisprudência/lei
provar	matematica/matemática/jurisprudência/ciência/lei
pré-digerir	ruminantes/ruminante
purificar	quimica/quimica/química/química
putrefazer	física
pôr	música
quantizar	física
quebrar	quimica/quimica/química/química
queimar	culinária/cozinha/preparação
racionalizar	matematica/matemática
rappel	esporte
raptar	crime/crime/ofensa/ofensa
rarefazer	quimica/química
rascunhar	arte
re-examinar	jurisprudência/lei
reagir	quimica/química
realizar	comercialismo/mercantilismo/música/comércio
recapitular	música
recondenar	jurisprudência/lei
reconsiderar	legislação
reconstruir	edificação/construção
recusar	jurisprudência/lei
recusar-se	jurisprudência/lei
redimir	igrejas/religião/igreja
reduplicar	lingüística/linguística/lingüística
reduzir	matematica/matemática/lingüística/linguística/lingüística/culinária/cozinha/preparação
reencarnar	religião/fé
reerguer	edificação/construção
refogar	culinária/culinária/cozinha/cozinha/preparação/preparação
reger	música/música
registar	jurisprudência/lei
registrar	jurisprudência/lei
remediar	jurisprudência/lei
remir	crime/ofensa
render	investimento
repetir	música
repintar	arte
replicar	biologia
representar	dramaturgia/arte/arte/arte/teatro
reproduzir	biologia
republicar	jurisprudência/lei
resgatar	crime/ofensa
retratar	arte
revender	comercialismo/mercantilismo/comércio
rocar	xadrez
roubar	crime/crime/ofensa/ofensa
rubricar	arte
ruminar	ruminantes/ruminante
saldar	comercialismo/mercantilismo/comércio
salgar	culinária/culinária/cozinha/cozinha/preparação/preparação
salmodiar	música
saltear	crime/ofensa
saponificar	quimica/quimica/química/química
saturar	quimica/química
sauter	culinária/cozinha/preparação
semear	agricultura/agricultura/pecuária/pecuária/cultivo/cultivo
sentenciar	jurisprudência/lei
separar	exército
sequestrar	quimica/crime/crime/ofensa/ofensa/química
seqüestrar	crime/crime/ofensa/ofensa
sincronizar	película/cinema/filme/produção
sinfonizar	música
solfar	música
solfejar	música/música
solidificar	física/física
solmizar	música
soltar	quimica/química
sombrear	arte
subir	esporte
sublimar	quimica/química
submeter	jurisprudência/lei
subornar	crime/crime/ofensa/ofensa
suingue	dança/baile
surfar	esporte
suspender	quimica/química
temperar	culinária/culinária/culinária/cozinha/cozinha/cozinha/preparação/preparação/preparação
testemunhar	jurisprudência/jurisprudência/lei/lei
testificar	jurisprudência/lei
tocar	música/música/música
topicalizar	lingüística/linguística/lingüística
tornar-se	quimica/química
torrar	culinária/cozinha/preparação
tostar	culinária/culinária/cozinha/cozinha/preparação/preparação
trabalhar	agricultura/pecuária/cultivo
traficar	comercialismo/mercantilismo/crime/ofensa/comércio
tramitar	comercialismo/mercantilismo/comércio
transaccionar	comercialismo/mercantilismo/comércio
transacionar	comercialismo/mercantilismo/comércio
transformar	quimica/física/química
transladar	física
tremeluzir	astro/estrela
trinar	música
trompetear	música
truncar	matematica/matemática
vegetar	biologia
vender	comercialismo/comercialismo/mercantilismo/mercantilismo/crime/ofensa/comércio/comércio
ver	psicologia
verbalizar	linguagem/discurso/idioma/língua
verificar	jurisprudência/ciência/lei
voar	aeronave/aeroplano/avião
volatizar	quimica/química

