administração	autoridades/federativo/regime/federal/governo
aeronave	piloto
aeroplano	desvio/assento/passageiro/piloto/cadeira/lugar
agricultura	semear/plantar/produzir/fazer
almoeda	oferecer
anatomia	articulações/oral/condutas/tubo/articulação
animal	arapuca/sacrificio/armadilha/pastar/sacrifício/gregário/corpo/rede
antropologia	parentesco/relação
aritmética	multiplicar
arqueologia	escavação/civilização/cultura
arquitectura	coluna/pilar/coluna
arquitetura	coluna/pilar/coluna
arrematação	oferecer
arte	chinês/exposições/cine/pincelar/cinema/teórico/pintar/desenhar/exposição
artesanato	tricotar/urdir/tecer
astrologia	signo
astronomia	cometa/cometas/galáxia/nebulosa/planeta/ascender/descer/pôr/subir
auto	tracção/túnel/tração/passageiro
autocarro	passageiro
automóvel	tracção/túnel/tração/passageiro
avião	desvio/assento/passageiro/piloto/cadeira/lugar
baile	dançar
barco	desvio/passageiro
batel	passageiro
besta	arapuca/sacrificio/armadilha/pastar/sacrifício/gregário/corpo/rede
bicho	arapuca/sacrificio/armadilha/pastar/sacrifício/gregário/corpo/rede
biologia	cepa/espécie/evolução/filogenia/filogênese/ontogenia/ontogénese/estirpe/célula/evolução/variante/espécies/crescimento/espécie/cultura/duradouro
botanica	flora/raíz/planta/raiz/vegetal
bote	passageiro
botânica	flora/raíz/planta/raiz/vegetal
boxe	murro/soco
broadcast	rede
calculadora	formatação/informática/formato
caminhos-de-ferro	passageiro
canto	instructor/preceptor/tutor
canção	instructor/preceptor/tutor
carro	tracção/túnel/tração/passageiro
cirurgia	operação
ciência	matematica/matemática/teórico
comboio	passageiro
comercialismo	comercializar/empenhar/exportar/importar/comprar/vender/obter/adquirir/atingir
computador	formatação/informática/formato
comércio	chinês/cine/comercializar/empenhar/exportar/cinema/importar/comprar/vender/cadeia/obter/adquirir/atingir
concerto	ensaio
concertos	ensaio
condução	estacionar/dirigir
construção	erigir/construir
cozinha	bater
criatura	arapuca/sacrificio/armadilha/pastar/sacrifício/gregário/corpo/rede
crime	plagiar/remir/abduzir/raptar/seqüestrar/sequestrar/resgatar
culinária	bater
cultivo	semear/plantar/produzir/fazer
dança	dançar
drama	atractivo/teatro
dramaturgia	actuar/assento/cadeira/atuar/lugar/representar/fazer
economia	consumo
edificação	erigir/construir
eleição	contagem/maioria
embarcação	desvio
empresa	chinês/cine/cinema/cadeia
escaler	passageiro
esporte	juiz/passear/árbitro/patinar/caminhar
estatística	média/norma
estatísticas	média/norma
exército	armada/assédio/bombardeiro/cerco/conscrição/marinha/prontidão/tanques/alistamento/general/baixa/rapidez/campanha/espião/sítio/capitão/inimigo/tanque/manobra/marcha/preparação/combate/operação/batalha/ataque/luta
filosofia	filósofo
flora	vegetação/domar/domesticar/naturalizar/cultivar
fotografia	aumentar
fé	submundo/inferno
física	gravitação/isotropia/molécula/reactor/reactores/átomo/gravidade
genetica	cruza/gene/genes/guen/mutação/mestiço/híbrido/mutação
genética	cruza/gene/genes/guen/mutação/mestiço/híbrido/mutação
geometria	quadrado
governação	autoridades/federativo/regime/federal/governo
governo	autoridades/federativo/regime/federal
gravação	deletar/apagar
hasta	oferecer
história	crónica/crônica/historiador/historiografo/cronista
humano	corpo
industria	chinês/cine/cinema/cadeia
informática	hardware/software/calculadora/impressora/iteração/computador/menu/código/trilha/repetição/programa
islamismo	mesquita/mesquitas
jogo	jogada
jurisprudência	acta/adoção/argüido/conúbio/decreto/divorcio/divórcio/emprisonar/encarcerar/engaiolar/incarcerar/licenciamentos/litígio/matrimónio/matrimônio/passaportes/pleitear/pleito/querelante/sufrágio/testamento/testificar/veredicto/veredito/acusado/anistia/bancarrota/coima/curador/falência/fiança/legislação/mandado/réu/adoção/advogar/atestar/casal/constituição/dono/evidenciar/jurisdição/jurista/juízo/multa/passaporte/sentença/aprisionar/contrato/suspeito/testemunhar/voto/advogado/judiciário/perdão/processo/proprietário/registro/condenar/julgamento/testemunha/ato/licença/casamento/causa/direito/título/maior/provar/mostrar/prender
lei	acta/adoção/argüido/conúbio/decreto/divorcio/divórcio/emprisonar/encarcerar/engaiolar/incarcerar/licenciamentos/litígio/matrimónio/matrimônio/passaportes/pleitear/pleito/querelante/sufrágio/testamento/testificar/veredicto/veredito/acusado/anistia/bancarrota/coima/curador/falência/fiança/legislação/mandado/réu/adoção/advogar/atestar/casal/constituição/dono/evidenciar/jurisdição/jurista/juízo/multa/passaporte/sentença/aprisionar/contrato/suspeito/testemunhar/voto/advogado/judiciário/perdão/processo/proprietário/registro/condenar/julgamento/testemunha/ato/licença/casamento/causa/direito/título/maior/provar/mostrar/prender
leilão	oferecer
linguística	gramática
lingüística	gramática
locomotivas	passageiro
lógica	paradoxo/contradição/proposição/demonstração/evidência/prova
matematica	equaçao/equações/matrizes/equação/demonstração/evidência/matriz/fórmula/prova/função/regra
matemática	equaçao/equações/matrizes/equação/demonstração/evidência/matriz/fórmula/prova/função/regra
mecânica	reação
medicina	amputar/sanar/narcotizar/sarar/dopar/drogar/curar
mercantilismo	comercializar/empenhar/exportar/importar/comprar/vender/obter/adquirir/atingir
meteorologia	nítido/fronte/clima/tempo
música	musico/músico/tema/cantar/compor/escrever/rápido/tocar
narcótico	dependência
navegação	velejar
navio	desvio
navios	desvio
negócio	chinês/cine/cinema/cadeia
ofensa	plagiar/remir/abduzir/raptar/seqüestrar/sequestrar/resgatar
patologia	tumores
pecuária	semear/plantar/produzir/fazer
pilotagem	velejar
planta	flora/vegetação/domar/domesticar/naturalizar/cultivar
política	conjuração/civilização/conspiração/manifestação
preparação	bater
psicologia	molecular/stress/fadiga/inibição/costume/hábito/tensão
psicopatologia	angústia/ansiedade
psicopatologias	angústia/ansiedade
psiquiatria	angústia/ansiedade
pugilismo	murro/soco
quimica	molécula/absorção/átomo
química	molécula/absorção/átomo
radiodifusão	transmitir
religião	submundo/inferno
rio	curva/canal
ser	arapuca/sacrificio/armadilha/pastar/sacrifício/gregário/corpo/rede
serviço	pregação/prédica/igrejas/sermão/igreja/templo
show	ensaio
teatro	actuar/assento/cadeira/atuar/lugar/representar/fazer
telefonia	telefonar/chamar
televisão	televisor/tv/tevê
terrorismo	terrorista
tevê	televisor/tv/televisão
trem	passageiro
tv	televisor/televisão/tevê
vegetal	flora/vegetação/domar/domesticar/naturalizar/cultivar
vertebrado	sangue/costela/sangue
veículo	tracção/túnel/tração/passageiro
viatura	tracção/túnel/tração/passageiro
virologia	vírus
xadrez	xeque/rei/cavalo
ônibus	passageiro
