abdome	torso/tronco/corpo
abdómen	torso/tronco/corpo
abdômen	torso/tronco/corpo
acelerador	auto/aeroplano/automóvel/avião/viatura/carro/veículo
acostamento	via/rodovia/estrada/caminho
ala	insectos/insetos/morcego/quirópteros/aeroplano/ave/hemípteros/pássaro/anjo/avião/insecto/inseto
alfândega	pé
alínea	texto
anatomia	alguém/indivíduo/alma/humano/pessoa
anca	torso/tronco/corpo
andar	prédio/edifício
anexo	prédio/edifício
ano	decênio/década
anoitecer	véspera/tarde/noite
antecâmara	prédio/edifício
antessala	prédio/edifício
anúncio	marketing/mercadologia/marketing
aposento	prédio/edifício
aquecimento	prédio/edifício
arco	barril/muro/barril/parede
arco-íris	céu
artelho	pé
artigo	shopping
asa	insectos/insetos/morcego/quirópteros/aeroplano/ave/hemípteros/prédio/pássaro/anjo/avião/insecto/inseto/edifício
ascensor	prédio/edifício
assoalho	aposento/saguão/quarto/salão/sala
ato	balé/ópera/drama/teatro
aula	curso
bagageira	auto/automóvel/viatura/carro/veículo
balanço	contabilidade/conta
banheira	banheiro
banheiro	morada/aposento/moradia/domicílio/residência/habitação/lar/casa
bar	botequim/pub/boteco/taberna
barba	face/rosto/cara
barriga	abdome/abdômen/torso/estômago/ventre/abdómen/tronco/corpo
base	vasilhame/candeeiro/luminária/vasilha/vaso/caixa
berma	via/rodovia/estrada/caminho
bico	ave/pássaro
bife	vacas/bovinos/gado
bochecha	face/rosto/cara
braço	humano/corpo
bumbum	torso/tronco/corpo
bunda	torso/tronco/corpo
buzina	auto/automóvel/viatura/carro/veículo
cabeça	criatura/animal/besta/bicho/ser/corpo
cachoeira	rio
cadeia	bici/biciclo/bicicleta
caixa	aparelhador/cómoda/gaveteiro/cômoda/escrivaninha/mesa/secretária
calcanhar	pé
calefacção	prédio/edifício
calefação	prédio/edifício
cama	dormitório/quarto
camarote	aeronave/aeroplano/avião
campo	estádio/arena
capítulo	texto
cara	divisa/peça/cabeça/humano/moeda/prata
característica	natureza
caricatura	publicação/edição
carne	alguém/vacas/bovinos/gado/indivíduo/alma/humano/pessoa
carpo	braço
carta	correio/correspondência
cartoon	publicação/edição
casca	galho/ovo/raíz/ramo/raiz
cascata	rio
catarata	rio
caveira	cabeça
cela	monastério/mosteiro/convento
cena	ato
chaminé	túnel/mina
chifre	bode/cabrito/cabra/bode
chinchilla	face/rosto/cara
chip	calculadora/computador
chão	aposento/saguão/terra/mundo/quarto/salão/sala
cintura	torso/tronco/corpo
classe	escolas/colégio/departamento/sociedade/escola
colheita	agricultura/pecuária/cultivo
conclusão	discurso
conferência	aula/curso
corno	bode/cabrito/cabra/bode
coroa	divisa/peça/moeda/prata
corpo	alguém/indivíduo/alma/humano/pessoa
corrente	bici/biciclo/bicicleta
cotovelo	braço
cozinha	morada/aposento/moradia/domicílio/residência/habitação/lar/casa
crepúsculo	anoitecer/véspera/tarde/noite
cruzamento	via/rodovia/estrada/caminho
crâneo	cabeça
crânio	cabeça
curva	grafo/via/rodovia/gráfico/estrada/caminho
curvas	grafo/gráfico
cérebro	cabeça
céu	terra/mundo
decênio	centúria/século/séculos/século
dedo	mão/pata/pé
degrau	escadaria/escada
domingo	fim-de-semana
dormitório	morada/aposento/moradia/domicílio/residência/habitação/lar/casa
década	centúria/século/séculos/século
elevador	prédio/edifício
encruzilhada	via/rodovia/estrada/caminho
encéfalo	cabeça
era	histórico/história
escada	prédio/edifício
escadaria	prédio/edifício
escritório	vivenda/habitação/casa
estante	aparelhador/cómoda/empório/gaveteiro/mercado/mercadinho/quitanda/sacolão/cômoda/supermercado/armário/feira/mercado
estrato	sociedade
estudio	vivenda/habitação/casa
estômago	torso/tronco/corpo
expedição	comercialismo/mercantilismo/comércio
face	cabeça/humano
faringe	pescoço
fechadura	portas/gaveta/tampa/porta/portão/caixa
feição	temperamento/personalidade/pessoa
garganta	pescoço
gaveta	aparelhador/cómoda/gaveteiro/cômoda/escrivaninha/mesa/secretária
golpe	peleja/pugna/disputa/combate/batalha/luta
gramado	estádio/arena
hardware	calculadora/computador
hemisfério	terra/mundo
hora	dia
idade	histórico/história
intestino	abdome/abdômen/estômago/ventre/abdómen/tronco/barriga
intestinos	abdome/abdômen/estômago/ventre/abdómen/tronco/barriga
introdução	discurso
leito	dormitório/quarto
lentigem	pele
linha	missiva/carta
lição	aula/curso
lâmina	gládio/faca/espada
língua	faringe/garganta/boca
mala	auto/automóvel/viatura/carro/veículo
manchete	periódico/jornal/folha
mandíbula	caveira/crâneo/crânio
mansarda	vivenda/habitação/casa
margem	lauda/escudeiro/página
meia-noite	noitada/tarde/noite
melodia	missiva/carta
memória	calculadora/computador
mento	face/rosto/cara
mercadoria	shopping
microchip	calculadora/computador
min	hora
minuto	hora
missiva	correio/correspondência
molho	prato
muro	aposento/prédio/saguão/edifício/quarto/salão/sala
mão	braço/humano
nariz	face/rosto/cara
noitada	dia
noite	dia
nuvem	céu
nádegas	torso/tronco/corpo
olfato	face/rosto/cara
olho	face/rosto/cara
ombro	torso/tronco/corpo
orelha	cabeça
parede	aposento/prédio/saguão/edifício/quarto/salão/sala
parágrafo	texto
passagem	texto
pastagem	campo
pasto	campo
pata	braço/humano
pavimento	aposento/prédio/saguão/edifício/quarto/salão/sala
peculiaridade	temperamento/personalidade/pessoa
peito	torso/tronco/corpo
pena	ave/pássaro
personalidade	alguém/indivíduo/alma/pessoa
período	histórico/história
pescoço	corpo
pessoa	alguém/indivíduo/alma
pico	gládio/lápis/espada
piso	aposento/prédio/saguão/edifício/quarto/salão/sala
plano	película/cinema/filme/produção
pluma	ave/pássaro
plumagem	ave/pássaro
polegada	pé
ponta	gládio/lápis/espada
popô	torso/tronco/corpo
porrada	peleja/pugna/disputa/combate/batalha/luta
porta-bagagem	auto/automóvel/viatura/carro/veículo
porta-malas	auto/automóvel/viatura/carro/veículo
porção	repasto/refeição
poço	túnel/mina
prado	campo
prateleira	aparelhador/cómoda/empório/gaveteiro/mercado/mercadinho/quitanda/sacolão/cômoda/supermercado/estante/armário/feira/mercado
prato	repasto/refeição
processo	julgamento
produto	shopping
promoção	marketing/mercadologia/marketing
propaganda	marketing/mercadologia/marketing
publicidade	marketing/mercadologia/marketing
pulso	braço
punho	braço
pálpebra	óculo/olho
pátio	prédio/edifício
pé	jarda/assento/humano/cadeira
quadril	torso/tronco/corpo
quadrinhos	periódico/jornal/folha
qualidade	natureza
quarto	morada/aposento/moradia/prédio/domicílio/residência/edifício/habitação/lar/casa
queixo	face/rosto/cara
rabo	torso/tronco/corpo
rebordo	vasilhame/vasilha/vaso
relevo	terra/mundo
rosto	cabeça/humano
ruga	pele
s	min/minuto
saguão	prédio/edifício
sala	enfermaria/prédio/hospital/edifício
sarda	pele
sardas	pele
sec	min/minuto
segundo	min/minuto
seio	torso/tronco/corpo
semana	mês
sintoma	doenças/doença
sobrancelha	face/rosto/cara
sobrolho	face/rosto/cara
solo	terra/mundo
sulco	pele
supercílio	face/rosto/cara
sílaba	verbo/vocábulo/termo/palavra
síndroma	doenças/doença
síndrome	doenças/doença
sótão	vivenda/habitação/casa
súber	galho/raíz/ramo/raiz
talhe	torso/tronco/corpo
tampa	vasilha/garrafa/caixa
tarde	dia
televisor	televisão/tevê
televisão	tevê
telhado	prédio/edifício
temperamento	alguém/indivíduo/alma/pessoa
terra	mundo
testa	face/rosto/cara
teto	aposento/prédio/saguão/edifício/quarto/salão/sala
tevê	televisão
texto	publicação/edição
torso	corpo
transportação	comercialismo/mercantilismo/comércio
transporte	comercialismo/mercantilismo/comércio
trapeira	vivenda/habitação/casa
traseiro	torso/tronco/corpo
traço	face/rosto/cara
tronco	torso/corpo
tubo	revóvel/revólver/arma
tv	televisão/tevê
têmpora	cabeça
ventre	torso/tronco/corpo
vestíbulo	prédio/edifício
vidro	copo
ático	vivenda/habitação/casa
átomo	molécula
átrio	prédio/edifício
ânus	torso/tronco/corpo
época	histórico/história
óculo	face/rosto/cara
