abalroar	naufragar/afundar
activar	ocorrer/suceder/acontecer/passar
afetar	sentir/experimentar
afixar	aderir/grudar/colar
afundar	naufragar
agradar	gostar
ajuntar	encontrar/reunir
aleijar	doer
alimentar	papar/comer
alçar	ascender/subir
amargar	ressentir
amargurar	ressentir
amedrontar	recear/apavorar/temer
apor	aderir/grudar/colar
aposentar	aposentar-se
aprazer	gostar
apresentar	enxergar/olhar/ver
arruinar	destruir/quebrar
assustar	recear/apavorar/temer
atemorizar	recear/apavorar/temer
aterrar	aterrissar/pousar
aterrissar	aterrar/pousar
aterrizar	aterrar/aterrissar/pousar
aterrorizar	recear/apavorar/temer
avultar	entumescer/inflar/inchar
circular	deslocar/mover/mexer
clicar	comprender/compreender/entender
colapsar	ruir/desabar/desmoronar/quebrar
colar	aderir/grudar
comover	sentir/experimentar
comprazer	gostar
cravar	aderir/grudar/colar
dar	ter
decidir	resolver
derramar	manar/fluir/correr
desagradar	antipatizar/desgostar
desencadear	ocorrer/suceder/acontecer/passar
desgostar	antipatizar
deslocar	mover/mexer
despontar	comprender/compreender/entender
destruir	quebrar
efetuar	ocorrer/suceder/acontecer/passar
elevar	ascender/subir
embevecer	gostar
encantar	gostar
encharcar	beber/tomar
entender	comprender/compreender
entornar	manar/fluir/correr
entregar	ter
envenenar	ressentir
erguer	ascender/levantar/subir
espairecer	descontrair/relaxar
evacuar	mudar-se/mudar
ferir	doer
formar	bacharelar/formar-se/graduar
gelar	congelar
graduar	bacharelar/formar-se/formar
impressionar	sentir/experimentar
inchar	entumescer/inflar
injuriar	ressentir
inquietar	preocupar-se
insultar	ressentir
intimidar	recear/apavorar/temer
irritar	ressentir
islamizar	converter
juntar	encontrar/reunir
levantar	ascender/subir
licenciar	bacharelar/formar-se/graduar/formar
machucar	doer
marchar	caminhar/andar
matar	perecer/falecer/expirar/morrer
mobilizar	deslocar/mover/mexer
mostrar	enxergar/olhar/ver
mover	deslocar/mexer
ocasionar	ocorrer/suceder/acontecer/passar
odorizar	recender/cheirar
ofender	ressentir
organizar	encontrar/reunir
parecer	sentir/experimentar
passar	suceder/atravessar
perceber	comprender/compreender/entender
posar	sentar-se/sentar
preocupar	preocupar-se
produzir	ocorrer/suceder/acontecer/passar
projectar	surgir/aparecer
provocar	ocorrer/suceder/acontecer/passar
pôr	sentar-se/sentar
realizar	comprender/compreender/entender
recordar	recordar-se/lembrar-se/lembrar
relaxar	descontrair
reunir	encontrar
satisfazer	gostar
sentar	sentar-se/sentar-se
sentar-se	sentar
soar	comprender/compreender/entender
submergir	naufragar/afundar
tencionar	surgir/aparecer
verter	manar/fluir/correr
viajar	caminhar/ir/andar

