absinto	absíntio/artemijem/erva-de-são-joão/losna
acetilene	oxiacetileno
acetileno	oxiacetileno/oxiacetileno
acetilênio	oxiacetileno
adenina	adn/arn/dna
adobe	adobo/adobo
aipim	tapioca
alcino	oxiacetileno
algodao	algodão/enchimento
algodão	enchimento
aluminio	bauxita/duralumínio/papel-alumínio
alumínio	bauxita/duralumínio/papel-alumínio
amino-ácido	proteina/proteína/proteínas/proteínas
aminoácido	proteina/proteína/proteínas/proteínas
aminoácidos	proteina/proteina/proteína/proteína/proteínas/proteínas/proteínas/proteínas
anfíbola	anfibolito
anis	absinto/absíntio/artemijem/erva-de-são-joão/losna/pastis/absinto
antimonio	estibina
antimónio	estibina/estibina
antimônio	estibina
antipartícula	anti-matéria/antimatéria
ar	vento
areia	formigão/betão/praia/concreto/faixa
argila	olaria/tijolo/cerâmica/telha
argon	ar
argónio	ar
argônio	ar
arsénico	arsenopirita/auripigmento/herbicida/inseticida/realgar/realgar
arsénio	arsenopirita/arsenopirita/auripigmento/auripigmento/herbicida/herbicida/inseticida/inseticida/realgar/realgar/realgar/realgar
arsênico	arsenopirita/auripigmento/herbicida/inseticida/realgar/realgar
arsênico-branco	arsenopirita/auripigmento/herbicida/inseticida/realgar/realgar
arsênio	arsenopirita/auripigmento/herbicida/inseticida/realgar/realgar
assadeira	lata/folha
aveleiro	avelã
azeite	azeitona
azoto	ar
banha	sus/suíno/porco
berilio	berilo/crisoberilo/gadolinita/água-marinha
berílio	berilo/crisoberilo/gadolinita/água-marinha
boro	borax/bórax
bromo	salmoura
cacau	chocolate
cadmio	calamina
cafeina	chá/café
cafeína	chá/café
calcio	calcário/fluorita/gipsita/gipsita/cal/gesso
calcita	calcário
camomila-romana	camomila/camomila
cana-brava	bambu/bambu
canabis	baseado/baseado
canábis	baseado/baseado
capsaicina	pimentão/pimenta
carbono	hulha/carvão/calcário/petróleo-bruto/petróleo/óleo
carvalho	carvalho-vermelho
casca	cuticula/cutícula/carapaça/concha
celulose	thread/thread/fibras/fibras/fibra/fibra/papel/papel
cerio	gadolinita/monazita
chicle	chicla/chuinga/chiclete
chumbo	galena
cimento	formigão/formigão/betão/betão/concreto/concreto/argamassa/argamassa/cafelo/cafelo/rebouco/rebouco/almofariz/almofariz/morteiro/morteiro/massa/massa
citosina	adn/arn/dna
cloropreno	neoprene/neopreno
coalhada	queijo
cobre	calcocita/calcocita/calcopirita/calcopirita/cuprita/cuprita/latão/latão/malaquita/malaquita/bronze/bronze/bronze/bronze
cocaina	coca
cocaína	coca
colmo	enchimento
colágeno	osso/cartilagem/tendão
copra	côco/coco
corindon	esmeril/esmeril
coríndon	esmeril/esmeril/esmeril/esmeril
cripton	ar
criptónio	ar
criptônio	ar
cromio	cromita
cromo	cromita
cré	giz/griz
crípton	ar/ar
crómio	cromita/cromita
crômio	cromita
cádmio	calamina
cálcio	calcário/calcário/fluorita/fluorita/gipsita/gipsita/gipsita/gipsita/cal/cal/gesso/gesso
cânabis	baseado/baseado
cânfora	celuloide/celuloide/celulóide/celulóide
cânhamo	toa/lona/corda/cabo
cério	gadolinita/monazita
césio	polucita
côco	coco
edredão	edredom
efluentes	espacial/esgoto
enxofre	sulfeto/sulfetos/sulfureto
enxôfre	sulfeto/sulfetos/sulfureto
epóxi	cimento
erbio	gadolinita/gadolinita
erva	baseado/baseado
erva-doce	absinto/absíntio/artemijem/erva-de-são-joão/losna/pastis/absinto
esmeril	lixa/lixa
estanho	cassiterita
európio	monazita
evaporito	salmoura
farinha	pasta/pão/massa/pastel
ferro	aço
fisostigmina	medicamento/remédio
fluor	criolita/fluorita
flúor	criolita/fluorita
fosfolipido	membrana
fosfolípido	membrana
fosforo	apatita
fubá	polenta
fósforo	apatita
gadolinio	gadolinita
gadolíneo	gadolinita
gadolínio	gadolinita
galio	bauxita
gelo	geleira/glaciares/glaciares/glaciar
gibbsita	bauxita
gim	gim-tônica/martini/martíni
gin	gim-tônica/martini/martíni
gins	gim-tônica/martini/martíni
glucosamina	polissacarídeo/polissacarídeo/polissacarídeos/polissacarídeos/quitina/quitina
goethita	ferrugem
goma-arábica	acácia
greda	olaria/tijolo/cerâmica/telha
guanina	adn/arn/dna
gálio	bauxita
hematita	esmeril/esmeril
heme	citocromo/hemoglobina/mioglobina
hemo	citocromo/hemoglobina/mioglobina
hemoglobina	eritrócito/hemácia
hidrogénio	água
hidrogênio	água
holmio	gadolinita
hólmio	gadolinita
imunoglobina	plasma
iodo	salmoura
isotiocianato	mostarda/rábano-silvestre/rábanodecavalo/rábano/rabanete/sinapis/sinapis/cebola
iterbio	gadolinita/monazita/xenótimo
itrio	gadolinita/gadolinita/xenótimo/xenótimo
itérbio	gadolinita/monazita/xenótimo
juta	toa/corda/cabo
laca	goma-laca
lanígero	tweed
larice	alerce/lariço/lariço-europeu
lignina	madeira
lárix	alerce/lariço/lariço-europeu/larice
lã	tweed
lítio	ambligonita/ambligonita/lepidolite/lepidolite/zinnwaldita/zinnwaldita
macaxeira	tapioca
maconha	toa/lona/corda/cabo/baseado/baseado/baseado/baseado
madeira	viga/trave
magnesio	carnallita/dolomita/espinela/magnesita/olivina
magnetita	esmeril/esmeril/ímã
magnésio	carnallita/dolomita/espinela/magnesita/olivina
magnêsio	carnallita/dolomita/espinela/magnesita/olivina
mandioca	tapioca
marfim	colmilho/colmilho
mata-ratos	arsenopirita/auripigmento/herbicida/inseticida/realgar/realgar
mel	hidromel/hidromel
melanina	pele/plumagem/pluma/pena/pele
mineral	rocha/pedra
minérios	rocha/pedra
mucina	muco
neodimio	monazita
neodímio	monazita
neon	ar
neve	coca
neão	ar
neón	ar
neónio	ar
neônio	ar
nicotina	tabaco/fumo
niobio	niobite
niquel	garnierita
nitroglicerina	cordite/dinamite
nitrogénio	ar
nitrogênio	ar
nióbio	niobite
nogueira	juglans/nogueira-comum
nogueira-comum	juglans/nogueira
noz-de-cola	cola/coca
noz-moscada	macis
néon	ar/ar
níquel	garnierita
olmo	ulmo/ulmeiro
opsina	rodopsina
osso	chifre/corno
ouro	dourado
oxigénio	água/ar/ozono/ozónio/ozônio
oxigênio	água/ar/ozono/ozónio/ozônio
palha	enchimento
papel	lauda/escudeiro/página
pigmento	tinta/pintura/cor
pigmentos	pigmento/tinta/pintura/cor
pinheiro	abeto
pinho	pinheiro
piperina	pimenta-do-reino/pimenta-preta
piroxena	basalto
plagioclase	basalto/dacito/dacito
plagióclase	basalto/dacito/dacito
potassio	carnallita/salmoura
potássio	carnallita/salmoura
praseodimio	monazita
praseodímio	monazita
prata	acantita
progesterona	pílula
proteina	vianda/ovo/leite/carne/legume/vegetal
proteína	vianda/ovo/leite/carne/legume/vegetal
proteínas	vianda/vianda/ovo/ovo/leite/leite/carne/carne/legume/legume/vegetal/vegetal
páprica	pimentão/pimento/pimento
queratina	plumagem/pluma/cabelo/pena
ribose	arn/arn
rubidio	carnallita/lepidolite/polucita
rubídio	carnallita/lepidolite/polucita
rum	zumbi
salitre	fertilizante/estrume
samario	monazita
samário	monazita
saqué	arroz/arroz
saquê	arroz
selenio	pirita
selénio	pirita/pirita
selênio	pirita
silicone	areia/argila/greda/feldspato/granito/quartzo/quarço/silício
silício	areia/argila/greda/feldspato/granito/quartzo/quarço/silicone
sinapis	mostarda
sodio	halita/salmoura
soja	kinako/shoyu/shōyu
soro	sangue/sangue
sílica	cristal/cristobalita/quartzo/quarço/tridimita
sódio	halita/salmoura
taboca	bambu/bambu
talio	blenda
tantalo	niobite/tantalita
tantálio	niobite/niobite/tantalita/tantalita
tapioca	mandioca
taquara	bambu/bambu
tecido	organismo/ser
tequila	agave-azul/agave-azul
terbio	apatita/gadolinita/monazita
tilia	tília/til
timina	adn/dna
titanio	ilmenita/rutilo/rútilo
titânio	ilmenita/rutilo/rútilo
torio	monazita
triacilglicerol	lípidos/gordura
trinitrocelulose	celuloide/celulóide/cordite
tulio	apatita/monazita/xenótimo
tungstenio	scheelita
tungsténio	scheelita/scheelita
tungstênio	scheelita
tálio	blenda
tántalo	niobite/tantalita
tântalo	niobite/tantalita
térbio	apatita/gadolinita/monazita
tório	monazita
túlio	apatita/monazita/xenótimo
ulmeiro	ulmo/olmo
ungüento	balsâmina
uracilo	arn
urdume	têxteis/pano/tecido/fazenda
urânio	pechblenda
vanadio	carnotita/vanadinita/vanadinita
vanilina	baunilha
vanádio	carnotita/vanadinita/vanadinita
vapor	nuvem
vinagre	etodolaco
vinho	uva
volfrâmio	scheelita
xenonio	ar
xenão	ar
xenón	ar
xenónio	ar
xenônio	ar
zirconio	zircão
zircónio	zircão/zircão
zircônio	zircão
ácer	bordo/roble
água	perspiração/sudorese/gelo/lágrima/suor/transpiração
água-de-coco	côco/coco
árgon	ar/ar
érbio	gadolinita
índio	blenda/blenda
ítrio	gadolinita/xenótimo
óleo	margarina
ópio	opioides

