acompanhante	compromisso
agente	polícia/lei
alguém	população/gente/pessoal/povo
alma	população/gente/pessoal/povo
automotora	caminhos-de-ferro/locomotivas/trem/comboio
automóvel	caminhos-de-ferro/locomotivas/trem/comboio
bezerro	vacas/bovinos/gado
bicha	tabela
bovinos	grei/manada/rebanho/gado
cachorro	matilha
carneiro	grei/manada/rebanho/rebanho/gado
carro	caminhos-de-ferro/locomotivas/trem/comboio
cepa	espécie/espécies/espécie
coluna	tabela
comboio	caminhos-de-ferro/locomotivas/trem
companheiro	casal/casamento
consorte	casal/casamento
constituintes	eleitorado
cão	matilha
cónjuge	casal/casamento
cônjuge	casal/casamento
departamento	autoridades/regime/governo
director	junta/comité/comitê/conselho
diretor	junta/comité/comitê/conselho
divisão	autoridades/regime/governo
eleitor	eleitorado
eleitores	eleitorado
elenco	pessoal/companhia
esposa	casal/casamento
esposo	casal/casamento
estirpe	espécie/espécies/espécie
ficante	compromisso
flora	biota/biologia
gado	grei/manada/rebanho
galáxia	cosmo/universo/mundo/criação
guarda	polícia/lei
indivíduo	população/gente/pessoal/povo
júri	juizado/juizado/tribunal/tribunal/corte/corte
legislatura	autoridades/regime/governo
livro	jogo/grupo
locomotiva	caminhos-de-ferro/locomotivas/trem/comboio
locomotivas	caminhos-de-ferro/trem/comboio
marido	casal/casamento
máquina	caminhos-de-ferro/locomotivas/trem/comboio
nebulosa	cosmo/universo/mundo/criação
ovelha	grei/manada/rebanho/rebanho/gado
ovinos	grei/manada/rebanho/rebanho/gado
parente	clã/familia/tribo/família
pessoa	população/gente/pessoal/povo
policial	polícia/lei
polícia	lei
terneiro	vacas/bovinos/gado
trem	caminhos-de-ferro/locomotivas/comboio
vacas	grei/manada/rebanho/gado
vagão	caminhos-de-ferro/locomotivas/trem/comboio
vagões	caminhos-de-ferro/locomotivas/trem/comboio
variante	espécie/espécies/espécie
vegetação	biota/biologia
vitelo	vacas/bovinos/gado
votante	eleitorado
votantes	eleitorado

