acatar	esposar/adoptar/adotar
aceitar	admitir
achar	determinar
acontecer	tornar/virar/mudar
actuar	atuar/representar/fazer
aderir	colar
admitir	aceitar
adquirir	incorrer/comprar/obter/receber
afundar	abalroar/submergir
agarrar	apanhar/capturar
agasalhar	vestir-se/arrumar-se/vestir
aguentar	sofrer
ajudar	servir
alastrar	circular/espalhar
andar	deslocar/mover
antecipar	aguardar/esperar
aparelhar	vestir-se/arrumar-se/vestir
aperfeiçoar	melhorar
assistir	servir
atingir	golpear/acertar/comprar/bater
atirar	tirotear
atuar	representar/fazer
aturar	sofrer
auferir	conquistar/adquirir/fazer
balançar	sacudir
balear	tirotear/atirar
bater	golpear/acertar
cair	precipitar
caminhar	deslocar/mover
cerrar	fechar
chamar	organizar
checar	conferir
cobrir	tratar
colapsar	desistir/abandonar
colar	aderir
colidir	golpear/acertar/bater
combinar	harmonizar/compatibilizar/concordar
comprar	incorrer/obter/receber
compreender	afigurar/envisionar/figurar/visualizar/ver
concordar	harmonizar/compatibilizar
conformar	esposar/adoptar/adotar
confundir	disconcertar
congelar	gelar
consentir	outorgar/permitir/conceder/dar
construir	criar/fazer
convocar	organizar
corresponder	harmonizar/compatibilizar/concordar
criar	fazer
dançar	bailar
dar	ajudar/transmitir/servir
deixar	legar/entregar/passar/dar/outorgar/permitir/conceder/transmitir/dar
desabar	desistir/abandonar
descobrir	determinar/achar
desenhar	traçar/delinear
desmoronar	desistir/abandonar
desperdiçar	torrar
destruir	arruinar
difundir	circular/espalhar
disparar	tirotear/atirar
disseminar	circular/espalhar
embalar	balançar/sacudir
encontrar	reganhar/achar
endereçar	tratar
enrolar	disconcertar/confundir
entender	afigurar/envisionar/figurar/visualizar/ver
entregar	transmitir/dar
escovar	varrer
escrever	compor
espalhar	circular
exercitar	malhar
falar	tratar
fazer	atuar/criar/representar
forjar	trabalhar
formar	trabalhar
funcionar	operar
ganhar	conquistar/adquirir/fazer
girar	revolver/revirar/rodar
grudar	aderir/colar
indagar	questionar/perguntar
ir	deslocar/mover
largar	cair
legar	transmitir/dar
ler	proclamar
levantar	erguer
lidar	tratar
malhar	exercitar
modelar	trabalhar
moldar	trabalhar
morrer	perecer/falecer/expirar
mudar	converter/substituir/trocar
naufragar	abalroar/submergir/afundar
obter	incorrer/comprar/receber
papar	comer
passar	transmitir/dar
pedir	solicitar/requerer
perceber	afigurar/envisionar/figurar/visualizar/ver
perguntar	questionar
permitir	outorgar/conceder/dar
perplexar	disconcertar/confundir
produzir	criar/fazer
publicar	compor/escrever
quebrar	arruinar/desmoronar/desistir/destruir/abandonar/dividir/separar
queimar	combustir/conflagrar/acender
re-adquirir	reganhar/encontrar/achar
realizar	afigurar/envisionar/figurar/visualizar/ver
receber	incorrer/obter
reconquistar	reganhar/encontrar/achar
recuperar	reganhar/encontrar/achar
reganhar	encontrar/achar
representar	atuar/fazer
requerer	solicitar
requisitar	solicitar/requerer
rolar	revolver/revirar/rodar
romper	desmoronar/dividir/separar
ruir	desistir/abandonar
saber	conhecer/entender
seguir	esposar/adoptar/adotar
segurar	apanhar/capturar
sentar	posar/sentar-se/pôr
sentar-se	posar/sentar/pôr
servir	ajudar
solicitar	requerer
soltar	cair
suportar	sofrer
tampar	cobrir
ter	apresenta/dispõe
tolerar	sofrer
tornar-se	tornar/virar/mudar
transformar	tornar/virar/mudar
transformar-se	tornar/virar/mudar
transmitir	circular/espalhar
tratar	endereçar/lidar/falar/cobrir
treinar	malhar/exercitar
verificar	checar/conferir
vestir	vestir-se/arrumar-se
viajar	deslocar/mover
virar	revolver/revirar/rodar/tornar/derrubar/mudar
