agente	polícia/lei
alguém	população/gente/pessoal/povo
alma	população/gente/pessoal/povo
associado	associação/sociedade/união/organização/ordem
associação	organização
audiência	mundo/gente/povo
cidadã	população/gente/povo
cidadão	nação/população/gente/povo
companheiro	casal/casamento
consorte	casal/casamento
corpo	exército/exército
criança	família
cónjuge	casal/casamento
cônjuge	casal/casamento
departamento	empresa
divisão	empresa
equipe	homens/mão-de-obra
espectador	mundo/gente/povo
esposa	casal/casamento
esposo	casal/casamento
estado	país/nação/terra
estrela	galáxia/nebulosa
filho	família
flora	biota/biologia
galáxia	cosmo/universo/mundo/criação
genitor	família
gente	humanidade/mundo/homem/povo
guarda	polícia/lei
indivíduo	população/gente/pessoal/povo
júri	juizado/tribunal/corte
marido	casal/casamento
menino	família
militar	exército
mãe	família
nebulosa	cosmo/universo/mundo/criação
pai	família
parente	clã/familia/tribo/família
partida	homens/mão-de-obra
pessoa	população/gente/pessoal/povo
pessoal	humanidade/mundo/homem/povo
policial	polícia/lei
polícia	lei
população	humanidade/mundo/homem/povo
potro	égua/cavalo
povo	humanidade/mundo/homem
progenitor	família
província	país/nação/terra
súdito	nação/gente/povo
time	homens/mão-de-obra
vegetação	biota/biologia
árvore	bosque/mata/floresta
