aborrecer	enervar-se/irritar-se
acamar	jazer
acatar	esposar/adoptar/adotar
aceitar	admitir
acercar	chegar
achar	detectar/determinar/observar/descobrir/descobrir
acomodar	aconchegar-se/aconchegar/acariciar
aconchegar	aconchegar-se/acariciar
acontecer	tornar/virar/virar/mudar
actuar	performar/performar/atuar/representar/passar/fazer
aderir	colar
adicionar	somar
admitir	permitir/aceitar
adquirir	incorrer/comprar/obter/receber
advertir	desaconselhar/admoestar/prevenir/avisar
afundar	abalroar/submergir
agarrar	apanhar/capturar
agasalhar	vestir-se/arrumar-se/vestir
agastar	enervar-se/irritar-se
agir	simular/atuar/fingir/fingir
agradar	satisfazer
aguentar	sofrer
ajudar	servir
alastrar	circular/espalhar
alertar	desaconselhar/admoestar/prevenir/avisar/advertir
amassar	cultivar/trabalhar
amolar	enervar-se/irritar-se
ampliar	expandir/estender/aumentar
andar	deslocar/mover/passear/acompanhar/caminhar/levar
antecipar	aguardar/esperar
anunciar	advogar/promover/lutar/agitar
apanhar	guardar
aparelhar	vestir-se/arrumar-se/vestir
aparentar	atuar/fingir
aperfeiçoar	melhorar
aplicar	empregar/utilizar/usar
apoiar	endorsar/aprovar
aporrinhar	enervar-se/irritar-se
aprazer	satisfazer
apresentar	familiarizar/noticiar/notificar/informar
aprovar	endorsar/apoiar
arredar	puxar/forçar
assegurar	afiançar
assegurar-se	afiançar
assistir	servir
atingir	golpear/acertar/comprar/bater
atirar	tirotear
atrair	retrair
atraiçoar	vender
atuar	performar/performar/simular/fingir/fingir/representar/passar/fazer
aturar	sofrer
auferir	lucrar/conquistar/adquirir/fazer
avaliar	estimar
avisar	desaconselhar/admoestar/prevenir/advertir
avizinhar	chegar
balancear	equilibrar-se/equilibrar
balançar	embalar/sacudir
balear	tirotear/atirar
bater	golpear/acertar/enganar
berrar	bradar/exclamar/chamar/gritar
bifurcar	desgalhar/ramificar-se/ramificar
blasfemar	maldizer/praguejar
boiar	flutuar
brincar	recrear/divertir
brotar	desgalhar/ramificar-se/ramificar
cair	precipitar
caminhar	deslocar/mover/passear/acompanhar/levar/andar
capturar	guardar
centrar	interessar/fascinar
cerrar	fechar
certificar-se	afiançar
chamar	cumprimentar/endereçar/organizar
chatear	enervar-se/irritar-se
checar	assegurar/assegurar/averiguar/averiguar/conferir/conferir/conferir/verificar/verificar/controlar/controlar
choramingar	chorar
citar	mencionar
cobrir	tratar/circundar/encapar/enfronhar/englobar/abarcar/compreender/conter
colapsar	desistir/abandonar
colar	aderir
colidir	golpear/acertar/bater
combinar	harmonizar/compatibilizar/concordar
comover	motivar/propulsar/incentivar/estimular/provocar
compensar	equilibrar-se/balancear/equilibrar
comportar-se	simular/atuar/fingir/fingir
comprar	incorrer/obter/receber
comprazer	satisfazer
compreender	afigurar/envisionar/figurar/visualizar/caber/conter/ver/ver
comprometer	dar
concentrar	interessar/fascinar
concordar	harmonizar/compatibilizar
condizer	combinar
conferir	assegurar/averiguar/checar/verificar/controlar
conformar	esposar/adoptar/adotar
confundir	disconcertar
congelar	gelar
consagrar	dar
consentir	outorgar/permitir/conceder/dar
considerar	julgar/pensar
construir	criar/fazer
contar	afirmar/declarar/dizer
conter	caber
convalescer	recuperar
convocar	chamar/organizar
corresponder	harmonizar/compatibilizar/combinar/concordar
cozinhar	acender/fazer
cravar	espetar
criar	fazer
dançar	bailar
dar	deixar/ajudar/transmitir/servir
declinar	desprezar/recusar/rejeitar
dedicar	dar
deitar-se	jazer
deixar	legar/entregar/passar/dar/outorgar/permitir/conceder/sair/transmitir/partir/ir/dar/dar
deliberar	julgar/pensar/considerar
denominar	cumprimentar/endereçar
derramar	entornar/entornar/verter/verter
derrotar	enganar
desabar	colapsar/desistir/abandonar
desbravar	capitanear
descobrir	detectar/determinar/observar/achar/achar
desenhar	traçar/delinear
desenvolver	elaborar
desmoronar	colapsar/desistir/abandonar
desnudar	desnudar-se/despir-se/despir
desperdiçar	torrar
despir	desnudar-se/despir-se/desnudar
despojar	desnudar-se/despir-se/desnudar/despir
destruir	arruinar
devotar	dar
difundir	circular/espalhar
diminuir	reduzir
disparar	tirotear/atirar
disseminar	circular/espalhar
divulgar	advogar/promover/lutar/agitar
dizer	afirmar/declarar
educar	preparar-se/preparar/treinar/construir/desenvolver/melhorar
embalar	balançar/sacudir
embevecer	satisfazer
encantar	satisfazer
encher	estufar
encontrar	reunir/ver/reganhar/achar
endereçar	tratar/circundar/englobar/abarcar/compreender/conter
endossar	endorsar/apoiar/aprovar
enrolar	disconcertar/confundir
entender	afigurar/envisionar/figurar/visualizar/compreender/ver/ver
entornar	verter/derramar
entregar	deixar/transmitir/dar
enxergar	assistir/ver
equilibrar	equilibrar-se/balancear
errar	passear/vagar
escovar	varrer
escrever	compor
espalhar	circular
estender	expandir/aumentar
estender-se	jazer
estimar	avaliar
estofar	estufar
esvaziar	remover
executar	justiçar
exercitar	malhar
experimentar	tentar/provar
expirar	morrer/falhar/morrer/acabar
extrair	puxar/sacar/tirar
falar	tratar/circundar/englobar/abarcar/afirmar/compreender/conter/declarar/dizer
falecer	morrer/falhar/morrer/acabar
fazer	performar/performar/atuar/produzir/estabelecer/criar/representar/passar
ferrar	arder
fingir	atuar
focar	interessar/fascinar
forjar	trabalhar
formar	trabalhar
forçar	empurrar
funcionar	operar
ganhar	lucrar/conquistar/adquirir/fazer
garantir	afiançar
gerar	produzir/estabelecer
germinar	brotar
girar	revolver/revirar/rodar
gostar	satisfazer
gotejar	pingar
gritar	bradar/exclamar/berrar/chamar
grudar	aderir/colar
guardar	olhar
igualar	combinar
importunar	enervar-se/irritar-se
incluir	caber/conter
incomodar	enervar-se/irritar-se
indagar	questionar/perguntar/perguntar
iniciar	começar
instruir	preparar-se/preparar/treinar/construir/desenvolver/melhorar
insultar	maldizer/praguejar/blasfemar
introduzir	familiarizar/noticiar/notificar/informar
ir	deslocar/mover/passear/acompanhar/viajar/caminhar/levar/conduzir/andar/andar/andar
irritar	enervar-se/irritar-se
jogar	recrear/divertir/disputar/apostar
largar	afundar/cair
lavar	lavar-se/limpar
lavar-se	limpar
legar	deixar/transmitir/dar
ler	proclamar/dizer
levantar	erguer
levar	transportar/trazer/trazer/tirar/transmitir/trazer/carregar/pegar
lidar	tratar/circundar/englobar/abarcar/compreender/conter
liderar	capitanear
limpar	remover
malhar	exercitar
manter	guardar/olhar
medir	estimar/avaliar
melhorar	recuperar
modelar	trabalhar
modernizar	construir/desenvolver/melhorar
moldar	trabalhar
molestar	enervar-se/irritar-se
morrer	perecer/falecer/expirar/falhar/acabar
mudar	converter/substituir/trocar/trocar
nadar	flutuar
naufragar	abalroar/submergir/afundar
negar	abnegar/abster/recusar
nomear	cumprimentar/endereçar
obter	incorrer/comprar/receber
olhar	assistir/ver
originar-se	desenvolver
pairar	levitar
papar	comer/comer
parecer	simular/atuar/fingir/fingir
partir	sair/ir
passar	deixar/transmitir/dar
pedir	reservar/segurar/solicitar/requerer
perambular	errar/passear/vagar
perceber	afigurar/envisionar/figurar/visualizar/compreender/ver/ver
perecer	morrer/falhar/morrer/acabar
perguntar	questionar
permitir	outorgar/conceder/dar
perplexar	disconcertar/confundir
perturbar	enervar-se/irritar-se
picar	arder
pingar	gotejar
plantar	semear
praticar	empregar/utilizar/usar
preocupar-se	inquietar/preocupar
preparar	preparar-se/acender/treinar/construir/desenvolver/melhorar/fazer
preservar	conservar
pretextar	atuar/fingir
produzir	criar/fazer
promover	advogar/lutar/agitar
provir	desenvolver
publicar	compor/escrever
publicitar	advogar/promover/lutar/agitar
puxar	forçar
quebrar	colapsar/arruinar/desmoronar/desistir/destruir/abandonar/dividir/separar
queimar	combustir/conflagrar/arder/acender
ramificar	desgalhar/ramificar-se
re-adquirir	reganhar/encontrar/achar
realizar	afigurar/envisionar/figurar/visualizar/compreender/ver/ver
receber	incorrer/obter
reconquistar	reganhar/encontrar/achar
recuar	decorrer
recuperar	reganhar/encontrar/achar
recusar	desprezar/rejeitar
redigir	escrever
reduzir	diminuir
reganhar	encontrar/achar
rejeitar	desprezar/recusar
representar	performar/performar/atuar/passar/fazer
requerer	solicitar
requisitar	solicitar/requerer
reservar	pedir
resgatar	extrair/sacar/tirar
respaldar	endorsar/apoiar/aprovar
ressuscitar	reviver/acordar
reter	guardar/olhar
retirar	extrair/sacar/tirar
retroceder	decorrer
reunir	encontrar/ver
reviver	ressuscitar/acordar
rolar	revolver/revirar/rodar
romper	desmoronar/dividir/separar
ruir	colapsar/desistir/abandonar
saber	conhecer/entender
sacar	extrair/puxar/tirar/tirar
sacudir	balançar/embalar
sair	partir/ir
secundar	endorsar/apoiar/aprovar
seguir	esposar/adoptar/adotar
segurar	pedir/apanhar/capturar/guardar/olhar
selar	chancelar/lacrar
sentar	assentar-se/posar/sentar-se/sentar-se/assentar/pôr
sentar-se	assentar-se/posar/assentar/sentar/sentar/pôr
servir	ajudar
simular	atuar/fingir
solicitar	requerer
soltar	afundar/cair
somar	adicionar
substituir	suplantar/sobrepor
superar	enganar
suportar	sofrer
surgir	desenvolver
tampar	encapar/enfronhar/cobrir
ter	apresenta/dispõe/caber/conter
tirar	trazer/levar/extrair/puxar/puxar/forçar/transmitir/trazer/sacar/sacar/pegar
tocar	repetir/executar
tolerar	sofrer
tornar-se	tornar/girar/virar/virar/mudar
trabalhar	cultivar
trair	vender
transformar	tornar/virar/virar/mudar
transformar-se	tornar/virar/virar/mudar
transmitir	circular/espalhar
transportar	trazer/levar/transmitir/trazer/carregar/pegar
tratar	endereçar/lidar/falar/cobrir/circundar/englobar/abarcar/compreender/conter
trazer	transportar/levar/levar/tirar/produzir/estabelecer/transmitir/pegar
treinar	preparar-se/malhar/exercitar/preparar/construir/desenvolver/melhorar
ultrapassar	enganar
urrar	bradar/exclamar/berrar/chamar/gritar
usar	empregar/utilizar
utilizar	empregar/usar
vadiar	errar/passear/vagar
vagabundear	errar/passear/vagar
vagar	errar/passear
vaguear	errar/passear/vagar
vedar	chancelar/lacrar/selar
vencer	enganar
ver	encontrar/reunir/assistir
verificar	assegurar/assegurar/averiguar/averiguar/checar/checar/checar/conferir/conferir/conferir/controlar/controlar
verter	entornar/entornar/derramar/derramar
vestir	vestir-se/arrumar-se
vexar	enervar-se/irritar-se
viajar	deslocar/mover
vir	chegar
virar	revolver/revirar/rodar/tornar/derrubar/girar/mudar
virar-se	girar
voar	atravessar
xingar	maldizer/praguejar/blasfemar

