armada	frota
associação	associado
autoridades	legislatura/departamento/divisão
biologia	flora/vegetação
biota	flora/vegetação
bovinos	bezerro/terneiro/vitelo
caminhos-de-ferro	automotora/locomotiva/vagões/automóvel/locomotivas/trem/vagão/carro/comboio/máquina
casal	cónjuge/consorte/cônjuge/esposa/esposo/marido/companheiro
casamento	cónjuge/consorte/cônjuge/esposa/esposo/marido/companheiro
cavalo	potro
clã	parente
comboio	automotora/locomotiva/vagões/automóvel/locomotivas/trem/vagão/carro/máquina
constelação	estrela
corte	júri
cosmo	galáxia/nebulosa
criação	galáxia/nebulosa
eleitorado	voto
exército	militar/corpo
familia	parente
família	parente
frota	embarcação/navios/navio/barco
gado	bezerro/ovinos/terneiro/vitelo/ovelha/carneiro
galáxia	estrela
gente	alguém/indivíduo/alma/pessoa/audiência/espectador
governo	legislatura/departamento/divisão
grei	ovinos/ovelha/carneiro
juizado	júri
lei	policial/polícia/agente/guarda
locomotivas	automotora/locomotiva/vagões/automóvel/trem/vagão/carro/comboio/máquina
manada	ovinos/ovelha/carneiro
marinha	frota
mundo	galáxia/nebulosa/audiência/espectador
nebulosa	estrela
ordem	associado
organização	associado/associação
pessoal	alguém/indivíduo/alma/pessoa
polícia	policial/agente/guarda
população	alguém/indivíduo/alma/pessoa
povo	alguém/indivíduo/alma/pessoa/audiência/espectador
rebanho	ovinos/ovelha/carneiro
regime	legislatura/departamento/divisão
sociedade	associado
série	número
trem	automotora/locomotiva/vagões/automóvel/locomotivas/vagão/carro/comboio/máquina
tribo	parente
tribunal	júri
universo	galáxia/nebulosa
união	associado
vacas	bezerro/terneiro/vitelo
égua	potro
