abdome	torso/tronco/corpo
abdómen	torso/tronco/corpo
abdômen	torso/tronco/corpo
abside	igrejas/igreja/templo
ala	insectos/insetos/ave/hemípteros/pássaro/anjo/insecto/inseto
aleta	peixe
algibeira	vestuário/roupa
alicerce	edifício/tecido/estrutura
alpendre	vivenda/habitação/casa
alvo	programa
alça	brocha/escova/pincel
anatomia	organismo/ser
anca	torso/tronco/corpo
andar	prédio/edifício
anexo	prédio/edifício
ano	decênio/década
aposento	prédio/edifício
aquecimento	prédio/edifício
arco	ponte/ponte
arco-íris	céu
arma	armamento/munição
armamento	munição/arma
arte	publicação/edição
artelho	perna
artigo	shopping
asa	insectos/insetos/ave/hemípteros/prédio/pássaro/anjo/insecto/inseto/edifício
assoalho	aposento/quarto/sala
astro	cosmo/universo/mundo/criação
banda	torso/tronco/corpo
banheira	banheiro
banheiro	morada/aposento/moradia/domicílio/residência/habitação/lar/casa
barbatana	peixe
barriga	torso/tronco/corpo
base	edifício/tecido/estrutura
batalha	guerra
biblioteca	vivenda/habitação/casa
boca	face/rosto/cara
bochecha	face/rosto/cara
bolso	vestuário/roupa
bumbum	torso/tronco/corpo
bunda	torso/torso/tronco/tronco/corpo/corpo
buraco	agulha
cabeça	criatura/animal/besta/bicho/ser/corpo
cabo	brocha/escova/pincel
cadeia	molécula
calefacção	prédio/edifício
calefação	prédio/edifício
campo	estádio/arena
canela	perna
canto	prédio/edifício
cara	criatura/animal/besta/bicho/cabeça/humano/ser
característica	natureza
carta	correio
caráter	temperamento/personalidade/pessoa
casca	ovo
casco	ungulados/ungulados
cauda	vertebrado
chapéu	fungo/fungos
chinchilla	face/rosto/cara
chão	aposento/terra/mundo/quarto/sala
classe	sociedade
colarinho	vestuário/roupa
colchão	cama/leito
colo	seio/peito
combate	guerra
componente	totalidade
comércio	mercado
conclusão	discurso
costa	elevação
costas	torso/tronco/corpo
cozinha	morada/aposento/moradia/domicílio/residência/habitação/lar/casa
curva	via/rodovia/estrada/caminho
célula	organismo/ser
céu	terra/mundo
declive	elevação
declives	elevação
decênio	centúria/século/séculos/século
dedo	vertebrado
desenho	publicação/edição
dia	semana
domínio	país/nação/terra
década	centúria/século/séculos/século
dígito	vertebrado
empresa	mercado
encosta	elevação
estação	ano
estrato	sociedade
estrela	cosmo/universo/mundo/criação
estômago	torso/tronco/corpo
etapa	jornada/viagem
evento	episódio
expedição	comercialismo/mercantilismo/comércio
face	criatura/animal/besta/bicho/cabeça/humano/ser
feição	temperamento/personalidade/pessoa
fenda	superfície
fenestra	auto/automóvel/prédio/viatura/carro/edifício/veículo
fragmento	flora/planta/vegetal
fundilhos	torso/tronco/corpo
função	programa
gola	colarinho
golpe	peleja/pugna/disputa/combate/batalha/luta
gramado	estádio/arena
gráfico	publicação/edição
guarda-lama	auto/automóvel/viatura/carro/veículo
hardware	calculadora/computador
hemisfério	terra/mundo
hipótese	teoria
hora	dia
hortaliça	erva
idade	vida
ilustração	publicação/edição
incidente	episódio
industria	mercado
ingrediente	prato
intenção	programa
item	listagem/lista
janela	auto/automóvel/prédio/viatura/carro/edifício/veículo
joelho	perna
jogo	esporte/rodada/turno/tempo
jornada	dia
ladeira	elevação
legume	erva
lei	jurisprudência/teoria
leis	jurisprudência/lei
linha	missiva/carta
lombo	humano
louça	mesa
luta	guerra
língua	faringe/garganta/boca
maléolo	perna
manhã	jornada/dia
manobra	esporte
mansarda	vivenda/habitação/casa
medicamento	tratamento
meio-dia	dia
melodia	missiva/carta
mento	face/rosto/cara
mercadoria	shopping
meta	programa
metade	futebol/rodada/turno/jogo/tempo
min	hora
minuto	hora
missiva	correio
molho	prato
muralha	aposento/prédio/edifício/quarto/sala
muro	aposento/prédio/edifício/quarto/sala
mês	ano
nalga	torso/tronco/corpo
natureza	temperamento/personalidade/pessoa
negócio	mercado
noitada	dia
noite	dia
nuvem	céu
nádega	torso/tronco/corpo
nádegas	torso/tronco/corpo
objectivo	programa
ombro	torso/tronco/corpo
orquestra	teatro/casa
parada	jornada/viagem
parede	aposento/prédio/edifício/quarto/sala
parte	flora/planta/vegetal/todo/unidade/unidade
passado	vida
pata	ungulados
pavimento	aposento/prédio/edifício/quarto/sala
peculiaridade	temperamento/personalidade/pessoa
pedaço	unidade
peito	torso/seio/tronco/corpo/vertebrado
perna	corpo
personalidade	alguém/temperamento/indivíduo/alma/pessoa/pessoa
período	ano/vida
pessoa	alguém/indivíduo/alma
pezunho	ungulados
piso	aposento/prédio/edifício/quarto/sala
popô	torso/tronco/corpo
porrada	peleja/pugna/disputa/combate/batalha/luta
porção	repasto/refeição/todo/unidade/unidade
possibilidade	teoria
prato	repasto/repasto/refeição/refeição
produto	shopping
pé	edifício/tecido/estrutura
qualidade	natureza
quarto	prédio/edifício
queixo	face/rosto/cara
quina	prédio/edifício
rabo	torso/tronco/corpo/vertebrado
radical	molécula
recanto	prédio/edifício
relevo	terra/mundo
remédio	tratamento
rincão	prédio/edifício
rodada	esporte
rosto	criatura/animal/besta/bicho/cabeça/humano/ser
ruga	pele/pele
s	min/minuto
sala	prédio/edifício
sazão	ano
sec	min/minuto
secção	unidade
segmento	todo/unidade
segundo	min/minuto
seio	torso/tronco/corpo/vertebrado
semana	mês
setor	economia/sociedade
seção	todo/unidade
sintoma	doenças/doença
solo	terra/mundo
sub-rotina	programa/programa
subida	elevação
subrotina	programa
sulco	pele/pele
suposição	teoria
sílaba	verbo/vocábulo/termo/palavra
sótão	vivenda/habitação/casa
taramela	brocha/escova/pincel
tarde	dia
telhado	prédio/edifício
temperamento	alguém/indivíduo/alma/pessoa
tempo	esporte/ano
terapia	tratamento
terra	mundo
testa	face/rosto/cara
teto	prédio/edifício
texto	publicação/edição
tomo	unidade
tornozelo	perna
torso	corpo
transportação	comercialismo/mercantilismo/comércio
transporte	comercialismo/mercantilismo/comércio
trapeira	vivenda/habitação/casa
traseiro	torso/torso/tronco/tronco/corpo/corpo/vertebrado
traço	face/rosto/cara
trinco	brocha/escova/pincel
tronco	torso/corpo/corpo
turno	esporte/rodada/jogo/tempo
têmpora	cabeça
tórax	seio/peito
umbigo	abdome/abdômen/estômago/ventre/abdómen/tronco/barriga
vegetal	erva
ventre	torso/tronco/corpo
verdura	erva
vidro	copo
vão	superfície
ábside	igrejas/igreja/templo
água	infraestructura/infraestrutura/infra-estrutura/superfície
ático	vivenda/habitação/casa
átomo	molécula
ânus	torso/tronco/corpo
época	vida
índole	temperamento/personalidade/pessoa

