abandonar	protestar
abarcar	apresenta/dispõe
abreviar	cortar
absolver	balizar/avaliar/julgar
acordar	capotar/sonecar/dormir/dormitar/cochilar
aderir	grudar/juntar
adquirir	seleccionar/selecionar/pagar/escolher
agachar	aprumar
alavancar	afrouxar
alcançar	competir/concorrer/viajar/caminhar/ir/andar
alisar	esfregar
aliviar	ingerir/consumir/tomar
aludir	denotar/significar
amarrar	fixar/prender
amassar	golpear/bater
apagar	esfregar
apodrecer	recender/cheirar
apreciar	despender/gastar/esgotar
arar	cavar
arrolhar	inserir/introduzir
arrombar	afrouxar
articular	proferir/verbalizar/conversar/falar/dizer
asfixiar	tampar/cobrir
assistir	enxergar/olhar/ver/mirar/observar/olhar/ver
atalhar	cortar
atar	fixar/prender
atingir	seleccionar/selecionar/tentar/pagar/procurar/escolher
avionar	voar
beber	deglutir/ingurgitar/engolir
bombear	entornar/verter/derramar
brigar	competir/concorrer
brindar	beber/tomar
calotear	iludir/lograr/enganar
carregar	deslocar/mover/mexer/deslocar/mover
castigar	aproximar/adivinhar/chutar/estimar/avaliar/julgar
categorizar	comparar
cavar	retirar/remover/tirar
chancelar	fixar/prender
chegar	viajar/caminhar/ir/andar
chutar	deslocar/mover
classificar	comparar
colar	grudar/juntar
comboiar	proteger/defender
comer	deglutir/ingurgitar/mastigar/mascar/engolir
comerciar	comprar/vender/obter/adquirir/atingir
compactar	prensar/pressionar/apertar
completar	registar/registrar
comprar	seleccionar/selecionar/pagar/escolher
comprimir	prensar/pressionar/apertar
conceber	acasalar/copular
conceder	acordar/concordar
condenar	balizar/balizar/avaliar/avaliar/julgar/julgar
confidenciar	crer
confundir	relembrar/recordar/lembrar
congelar	solidificar
conseguir	tentar/procurar
consumar	foder/pinar/copular/meter/transar/trepar/montar/comer
conter	apresenta/dispõe
corresponder	redigir/escrever
corresponder-se	redigir/escrever
corrigir	ler
criticar	balizar/avaliar/julgar
crucificar	privar-se/abster-se/abster/privar
curvar	aprumar
debandar	apressar/correr/correr
declamar	proferir/verbalizar/conversar/falar/dizer
defender	brigar/disputar/lutar
defraudar	iludir/lograr/enganar
deixar	perecer/falecer/expirar/morrer
desamarrotar	esquentar/aquecer
descasar	casar-se/esposar/casar/juntar
descobrir	aperceber/aperceber-se/perceber/entender
descumprir	prometer
desemaranhar	partir/dividir/separar
desembaralhar	partir/dividir/separar
desembaraçar	partir/dividir/separar
desempoeirar	retirar/remover/tirar
desenhar	traçar/delinear
desenrolar	partir/dividir/separar
desertar	protestar
desfigurar	lesionar/lesar/ferir/machucar
desfrutar	despender/gastar/esgotar
deslindar	partir/dividir/separar
despender	gastar/consumir
desperdiçar	gastar/consumir
despertar	capotar/sonecar/dormir/dormitar/cochilar
devorar	comer
diferenciar	comparar
digerir	ingerir/consumir/tomar
direcionar	viajar/caminhar/ir/andar
dirigir	viajar/caminhar/ir/ir/andar
discernir	aperceber/aperceber-se/perceber/entender
discursar	falar/dizer
disputar	competir/competir/concorrer/concorrer
dissipar	gastar/consumir
distinguir	comparar
dividir	partir/separar
divorciar	casar-se/esposar/casar/juntar
dizer	proferir/verbalizar/conversar/falar
dobrar	aprumar
empalar	perfurar/furar
empatar	jogar
empurrar	prensar/deslocar/mover/pressionar/apertar/mexer
encobrir	tampar/cobrir
encrostar	secar
enfileirar	aguardar/esperar
engravidar	acasalar/copular
ensaboar	lavar-se/lavar/limpar
ensurdecer	ressoar/soar
enterrar	tampar/cobrir
entornar	deglutir/ingurgitar/engolir
entrar	atuar/representar/fazer
enunciar	proferir/verbalizar/conversar/falar/dizer
enviar	transferir
escavar	cavar/retirar/remover/tirar
escolher	comparar/desempenhar/executar/fazer
escoltar	proteger/defender
esconder	tampar/cobrir
escutar	ouvir/sentir
esgotar	gastar/consumir
espiar	apurar/averiguar/investigar
esterçar	viajar/caminhar/ir/andar
estevar	cavar
estrangular	comprimir/contrair
estudar	ler
examinar	mirar/observar/olhar/ver
exercer	trabalhar
exercitar	deslocar/mover/mexer
experimentar	aperceber/aperceber-se/perceber/entender
extinguir	tampar/cobrir
falar	dizer/proferir/verbalizar/conversar/dizer
farejar	cheirar
fisgar	consumir/usar
forçar	prensar/deslocar/mover/pressionar/apertar/mexer
ganhar	competir/concorrer
gastar	consumir
gostar	aprovar
gozar	despender/gastar/esgotar
hospedar	ingerir/consumir/tomar
identificar	classificar
iluminar	pintar
imigrar	vir/chegar
imprimir	prensar/pressionar/apertar
inalar	fumar
inclinar	aprumar
incluir	apresenta/dispõe
indentar	golpear/bater
infestar	manar/fluir/correr
inocentar	balizar/avaliar/julgar
inspecionar	mirar/observar/olhar/ver
instigar	animar/excitar/provocar
intimidar	alertar/avisar/advertir
jogar	competir/concorrer
juntar	roçar
lacrar	fixar/prender
lavar	enxaguar
lavrar	cavar
laçar	fixar/prender
levantar	levantar-se
levantar-se	capotar/sonecar/dormir/dormitar/cochilar
levar	vir/vir
levitar	ascender/subir
libar	deglutir/ingurgitar/engolir
liderar	competir/concorrer
liquidar	vender
lixar	esfregar
lustrar	esfregar/esfregar
lutar	competir/concorrer
malhar	deslocar/mover/mexer
mamar	beber/tomar
mapear	mensurar/quantificar
marrar	ler
masturbar	afagar/acariciar
metralhar	tirotear/atirar
minar	cavar
minerar	cavar
mirar	enxergar/olhar/ver
misturar	amalgamar/unificar
mortificar	privar-se/abster-se/abster/privar
mover	jogar
notar	aperceber/aperceber-se/perceber/entender
observar	aperceber/aperceber/aperceber-se/aperceber-se/enxergar/perceber/perceber/olhar/entender/entender/ver
obter	seleccionar/selecionar/pagar/escolher/computar/calcular
ocultar	tampar/cobrir
olhar	enxergar/ver
optar	comparar
ouvir	escutar/sentir
pairar	ascender/subir
papar	deglutir/ingurgitar/mastigar/mascar/engolir
parir	ter
patinar	dançar
pegar	vir
penalizar	aproximar/adivinhar/chutar/estimar/avaliar/julgar
perceber	aperceber/aperceber/aperceber-se/aperceber-se/entender/entender
perder	competir/concorrer/viajar/caminhar/ir/andar
perjurar	depor
perseverar	viver
pilotar	voar
pixar	tampar/cobrir
polir	esfregar/esfregar
praticar	trabalhar
preencher	registar/registrar
preferir	comparar
preparar	cozinhar
pronunciar	proferir/verbalizar/conversar/falar/dizer
provocar	animar/excitar
punhetar	afagar/acariciar
punir	aproximar/adivinhar/chutar/estimar/avaliar/julgar
putrefazer	recender/cheirar
queixar-se	afligir-se/magoar/sofrer
ranger	esfregar
recitar	proferir/verbalizar/conversar/falar/dizer
referir-se	denotar/significar
registrar	aperceber/aperceber-se/perceber/entender
resistir	viver
resolver	raciocinar
ressonar	capotar/sonecar/dormir/dormitar/cochilar
reusar	poupar/preservar/conservar/guardar/manter
reutilizar	poupar/preservar/conservar/guardar/manter
revisar	reparar/emendar/consertar
roncar	capotar/sonecar/dormir/dormitar/cochilar
roubar	cobrar
saciar	ingerir/consumir/tomar
saquear	estraçalhar/destroçar/arruinar/destruir
saraivar	atirar/jogar/lançar
saudar	gesticular
seduzir	foder/pinar/copular/meter/transar/trepar/montar/comer
selar	fixar/prender
separar	comparar
sobreviver	convalescer/recuperar/melhorar/viver/viver
solucionar	raciocinar
sonhar	capotar/sonecar/dormir/dormitar/cochilar
subjugar	privar-se/abster-se/abster/privar
sublimar	evaporar/vaporizar
suceder	tentar/procurar
sufocar	tampar/cobrir
superar	convalescer/recuperar/melhorar
suplementar	prover/abastecer/fornecer/suprir
surrar	golpear/bater
suspender	penalizar/punir/castigar
tampar	inserir/introduzir
ter	aperceber/aperceber-se/perceber/entender/computar/calcular
tirar	vir
tocar	denotar/significar
tomar	deglutir/ingurgitar/engolir
transferir	deslocar/mover
transmitir	vir
transplantar	deslocar/mover/mexer
transportar	vir
trapacear	iludir/lograr/enganar
trazer	vir/vir/vir
tropeçar	caminhar/ir/andar
truncar	cortar
unir	fundir/combinar/misturar
usar	vestir-se/arrumar-se/vestir
vencer	competir/concorrer
vender	entregar/dar
ver	aperceber/aperceber-se/enxergar/perceber/olhar/entender/mirar/mirar/observar/observar/olhar/olhar
vestir	vestir-se/arrumar-se
viciar	consumir/usar
viver	existir/ser
ziguezaguear	virar-se/tornar-se/virar

