agente	polícia/lei
alguém	população/gente/pessoal/povo
aliado	coalizão/coligação/aliança
alma	população/gente/pessoal/povo
aluno	audiências/ouvintes/público
arenavirus	família/classe
arenavírus	família/classe
associado	associação/sociedade/união/organização/ordem
associação	organização
auditor	audiências/ouvintes/público
audiência	mundo/gente/povo
bandido	gangue/quadrilha
bicha	tabela
bunyaviridae	família/classe
burguesa	burguesia
burguês	burguesia
caixilho	exército
carta	baralho
cepa	espécie/espécies/espécie
cidadã	população/gente/povo
cidadão	nação/população/gente/gente/povo/povo
classe	filo/filo
clérigo	clero
coluna	tabela
comissário	junta/comissão/comité/comitê
companheiro	casal/casamento
consorte	casal/casamento
corpo	exército/exército/exército/exército
criança	família
cónjuge	casal/casamento
cônjuge	casal/casamento
dama	baralho
departamento	país/empresa/nação/terra
divisão	empresa
elenco	pessoal/companhia
equipagem	tripulação
equipe	homens/mão-de-obra/tripulação
espectador	mundo/gente/povo
esposa	casal/casamento
esposo	casal/casamento
espécies	filo/filo
estado	país/nação/terra
estirpe	espécie/espécie/espécies/espécies/espécie/espécie
estrela	galáxia/nebulosa
exército	corpo
fauna	biota/biologia
filho	família
flaviviridae	família/classe
flavivírus	família/classe
flora	biota/biologia
frade	irmandade/fraternidade/ordem
galáxia	cosmo/universo/mundo/criação
gangster	gangue/quadrilha
genitor	família
gente	humanidade/mundo/homem/povo
guarda	polícia/lei
gângster	gangue/quadrilha
género	família/classe
gênero	família/família/classe/classe
indivíduo	população/gente/pessoal/povo
irmã	família
irmão	irmandade/fraternidade/família/ordem
jurado	júri/júri
juror	júri/júri
júri	juizado/juizado/tribunal/tribunal/corte/corte
lenda	mitologia/mitologia
linha	tabela
livro	jogo/grupo
marginal	gangue/quadrilha
marido	casal/casamento
menino	família
mestre	colégio/escola
militar	exército
milícia	corpo
mito	mitologia/mitologia
mãe	família
naipe	baralho
nebulosa	cosmo/universo/mundo/criação
ouvinte	audiências/ouvintes/público
pai	família
parente	clã/familia/tribo/família
partida	homens/mão-de-obra
pastor	clero
pelotão	companhia
pessoa	população/gente/pessoal/povo
pessoal	humanidade/mundo/homem/povo
plebeu	galera/vulgo/nação/gente/pessoal/povo
policial	polícia/lei
polícia	lei
população	humanidade/mundo/homem/povo
potro	égua/cavalo
povo	humanidade/mundo/homem
professor	colégio/escola
progenitor	família
província	país/nação/terra
pároco	clero
quorum	organização
quórum	organização
raça	espécie/espécies/espécie
rhabdovirus	família/classe
rhabdovírus	família/classe
sacerdote	clero
súdito	nação/gente/povo
time	homens/mão-de-obra
tribo	família/classe
tropas	corpo
variante	espécie/espécies/espécie
vegetação	biota/biologia
zoologia	biota/biologia
árvore	bosque/mata/floresta

