afável	índole/natureza
agencioso	atividade
alto	grau/altitude/altura
ambicioso	ambição/aspiração
amável	índole/natureza
antigo	idade
aprimorado	perfeição
assexual	sexualidade/gênero/sexo
ativo	atividade/atividade
ausente	presença
baixa	grau
baixo	grau
belo	beleza
bom	qualidade
bonito	belo/beleza
caloroso	temperatura/temperatura/calor
capaz	habilidade/capacidade/poder/habilidade/talento
certo	pose/altivez/aprumo/desembaraço/certeza/certeza/segurança/fé
ciente	consciência/conhecimento/saber
científica	ciência
científico	ciência
colorido	tez/cor
comercial	comercialismo/mercantilismo/comércio
confortável	conforto
conservador	ideologia
contente	felicidade/felicidade/alegria/alegria
criador	criatividade/criatividade
criativo	criatividade/criatividade
crítico	crise
delicado	força
dependente	independência/liberdade
deprimido	altitude/altura
desconfortável	conforto
desnecessária	necessidade
desnecessário	necessidade
destemido	consternação/temor/terror/medo
devagar	rapidez/velocidade
diferente	similardidade/semelhança/diferença
difícil	dificuldade
direita	local/lugar/posição
direito	local/lugar/posição
distante	distância/distância/distância/distância
débil	força
efectivo	realidade
efetivo	efetividade/eficiência/eficácia/realidade
eficaz	efetividade/eficiência/eficácia
eficiente	efetividade/eficiência/eficácia
escuso	contorno
esquerdo	local/lugar/posição
essencial	necessidade
estúpido	inteligência
existente	existência/existência/ser
extrovertido	curso
feia	belo/beleza
feio	belo/beleza
feliz	felicidade/felicidade/alegria/alegria
forgoso	temperatura/temperatura/calor
formoso	belo/beleza
forte	força
fresco	temperatura/temperatura/calor
frio	temperatura/temperatura/temperatura/temperatura/calor/calor
funcional	propósito/função
gay	transa/sexo
gentil	índole/natureza
grande	tamanho/dimensão/medida/magnitude
hetero	transa/sexo
heterossexual	transa/sexo
homo	transa/sexo
homossexual	transa/sexo
ilegal	legalidade
imaturo	idade
imoral	moralidade/moral/virtude
imperfeito	perfeição
importante	importância/magnitude/significação/significado
impossível	possibilidade/chance
impotente	potencia/eficácia/potência/poder/força
imóvel	movimento
inativo	atividade
incapaz	habilidade
incerto	pose/altivez/aprumo/desembaraço/certeza/certeza/certeza/segurança/fé
incómodo	conforto
incômodo	conforto
independente	independência/liberdade
ineficaz	potencia/eficácia/potência/força
infeliz	felicidade/felicidade/alegria/alegria
informado	consciência/conhecimento/saber
inodoro	odor/cheiro
inseguro	pose/altivez/aprumo/desembaraço/certeza/certeza/segurança/fé
intelectual	inteligência
inteligente	inteligência
intensivo	grau
intenso	grau
intrincado	dificuldade
inútil	efetividade/eficiência/eficácia
jovem	idade
legal	legalidade
lento	rapidez/velocidade
lerdo	inteligência
leve	peso
lhano	índole/natureza
liberal	ideologia
limpo	asseio/limpeza
lindo	belo/beleza
livre	liberdade
longe	distância/distância
longínquo	distância/distância
macho	sexualidade/gênero/sexo
maduro	idade
maior	maioridade/ascendência/maioria
maturo	idade
mensurável	grandeza/magnitude/número
mesmo	similardidade/semelhança
moral	moralidade/virtude
morto	animação/vida
movente	movimento
nao-maduro	idade
necessário	necessidade
novo	idade
original	criatividade/criatividade
ortodoxo	ortodoxia
pequeno	tamanho/dimensão/medida/magnitude
perfeito	perfeição
perto	distância/distância
pesado	peso
poderoso	poder
popular	popularidade
positivo	qualidade
possível	potenciabilidade/potencial/possibilidade/chance
potencial	potenciabilidade
potente	potencia/eficácia/potência/força
presente	presença
próximo	distância/distância/distância/distância
puro	moralidade/moral/virtude
quente	temperatura/temperatura/calor
real	realidade
receoso	consternação/temor/terror/medo
regular	regularidade
relutante	temperamento/disposição
reto	contorno
ruim	qualidade
rápida	rapidez/velocidade
rápido	rapidez/velocidade
semvida	animação/vida
sexual	sexualidade/gênero/sexo
significante	significação/significado
significativo	significação/significado
similar	similardidade/semelhança
suave	grau
suja	asseio/limpeza
sujado	asseio/limpeza
sujo	asseio/limpeza
torto	contorno
triste	felicidade/felicidade/alegria/alegria
vantajoso	qualidade
varão	sexualidade/gênero/sexo
velho	idade/idade
veloz	rapidez/velocidade
verdadeiro	realidade
vertical	atitude/postura/posição
vivo	animação/vida
vizinho	distância/distância
vão	efetividade/eficiência/eficácia
árduo	dificuldade

