abdome	umbigo
abdómen	umbigo
abdômen	umbigo
agulha	buraco
alguém	temperamento/personalidade/pessoa
alma	temperamento/personalidade/pessoa
animal	cabeça/face/rosto/cara
anjo	ala/asa
aposento	assoalho/muralha/muro/pavimento/piso/chão/parede/cozinha/banheiro
apresentação	atuação/representação/interpretação
arena	gramado/campo
auto	guarda-lama/fenestra/janela
autocarro	fenestra/janela
automóvel	guarda-lama/fenestra/janela
autoridades	administração/organização
ave	ala/asa
banheiro	banheira
barriga	umbigo
barril	arco/arco
basquete	metade
basquetebol	metade/metade
batalha	porrada/golpe
besta	cabeça/face/rosto/cara
bicho	cabeça/face/rosto/cara
boca	língua
bode	chifre/chifre/corno/corno
bola-ao-cesto	metade
boteco	bar
botequim	bar
braço	carpo/pulso/punho
brocha	taramela/trinco/alça/cabo
cabeça	têmpora/face/rosto/cara
cabra	chifre/corno
cabrito	chifre/corno
caixa	fechadura
calculadora	hardware
cama	colchão
caminho	curva
caneca	taramela/trinco/alça/cabo
cara	bochecha/chinchilla/mento/testa/queixo/traço/boca
carro	guarda-lama/fenestra/janela
carta	melodia/linha
casa	mansarda/trapeira/sótão/ático/cozinha/banheiro/alpendre/biblioteca
caverna	fundo
cavernas	fundo
centúria	decênio/década
chapéu-de-chuva	taramela/trinco/alça/cabo
civilização	sub-área/subcultura/subcultura
coluna	capitel/capitel
combate	porrada/golpe
comercialismo	transportação/transporte/expedição
computador	hardware
comércio	transportação/transporte/expedição
copo	vidro
corpo	abdome/abdômen/bumbum/popô/torso/bunda/estômago/nádegas/ombro/seio/ventre/abdómen/ânus/peito/cabeça/tronco/tronco/barriga/rabo/traseiro/fundilhos/nalga/nádega/bunda/anca/costas/banda/perna/traseiro
correio	missiva/carta
correspondência	missiva/carta
cosmo	astro/estrela
criatura	cabeça/face/rosto/cara
criação	astro/estrela
cultura	sub-área/subcultura/subcultura
céu	arco-íris/nuvem
decênio	ano
desempenho	atuação/representação/interpretação
dia	noitada/tarde/hora/noite/meio-dia/jornada
discurso	conclusão
disputa	porrada/golpe
doença	sintoma
doenças	sintoma
domicílio	cozinha/banheiro
dormitório	cama/leito
década	ano
economia	setor
edifício	calefacção/aposento/aquecimento/calefação/muralha/muro/pavimento/piso/parede/telhado/anexo/asa/teto/quarto/sala/andar/alicerce/recanto/rincão/fenestra/quina/janela/canto/pé/base
edição	texto/arte/gráfico/ilustração/desenho
escada	degrau
escadaria	degrau
escova	taramela/trinco/alça/cabo
estrada	curva
estrutura	alicerce/pé/base
estádio	gramado/campo
estômago	umbigo
face	bochecha/chinchilla/mento/testa/queixo/traço/boca
faringe	língua
flora	fragmento/parte
furna	fundo
futebol	metade
garganta	língua
gaveta	fechadura
gol	trava/barra
governo	administração/organização
grafo	curvas/curva
gruta	fundo
grutas	fundo
gráfico	curvas/curva
guarda-chuva	taramela/trinco/alça/cabo
habitação	mansarda/trapeira/sótão/ático/cozinha/banheiro/alpendre/biblioteca
hemípteros	ala/asa
hora	min/minuto
humano	face/rosto/cara/lombo
igreja	abside/ábside
igrejas	abside/ábside
indivíduo	temperamento/personalidade/pessoa
insecto	ala/asa
insectos	ala/asa
inseto	ala/asa
insetos	ala/asa
interpretação	atuação/representação
jarda	pé
jurisprudência	leis/lei
lar	cozinha/banheiro
lei	leis
leito	colchão
lista	item
listagem	item
luta	porrada/golpe
marketing	venda/venda
mercadologia	venda
mercantilismo	transportação/transporte/expedição
mesquita	minarete/minarete
mesquitas	minarete
min	sec/s/segundo
minuto	sec/s/segundo
missiva	melodia/linha
molécula	átomo/radical/cadeia
morada	cozinha/banheiro
moradia	cozinha/banheiro
morcego	ala/asa
mundo	chão/hemisfério/relevo/céu/solo/terra/astro/estrela
mão	dedo
mês	semana
natureza	característica/qualidade
oca	fundo
olho	cristalino/lente
ovo	casca
palavra	sílaba
pata	dedo
peito	colo/tórax
peixe	aleta/barbatana
pele	ruga/ruga/sulco/sulco
peleja	porrada/golpe
performance	atuação/representação/interpretação
personalidade	feição/peculiaridade/índole/caráter/natureza
pescoço	faringe/garganta
pessoa	feição/peculiaridade/temperamento/personalidade/índole/caráter/natureza/personalidade
pilar	capitel
pincel	taramela/trinco/alça/cabo
planta	fragmento/parte
ponte	arco/arco
porta	fechadura/fechadura
portas	fechadura
portão	fechadura/fechadura
prato	molho/ingrediente
programa	sub-rotina/sub-rotina/subrotina/função
prédio	calefacção/aposento/aquecimento/calefação/muralha/muro/pavimento/piso/parede/telhado/anexo/asa/teto/quarto/sala/andar/recanto/rincão/fenestra/quina/janela/canto
pub	bar
publicação	texto/arte/gráfico/ilustração/desenho
pugna	porrada/golpe
pássaro	ala/asa
quarto	assoalho/cama/muralha/muro/pavimento/piso/chão/leito/parede
quirópteros	ala/asa
refeição	porção/prato/prato
regime	administração/organização
repasto	porção/prato/prato
residência	cozinha/banheiro
rodovia	curva
rosto	bochecha/chinchilla/mento/testa/queixo/traço/boca
saguão	assoalho/muralha/muro/pavimento/piso/chão/parede
sala	assoalho/muralha/muro/pavimento/piso/chão/parede
salão	assoalho/muralha/muro/pavimento/piso/chão/parede
seio	colo/tórax/peito
ser	cabeça/face/rosto/cara
shopping	mercadoria/produto/artigo
sociedade	estrato/classe/setor
sombrinha	taramela/trinco/alça/cabo
século	decênio/decênio/década/década
séculos	decênio/década
taberna	bar
tampa	fechadura
tecido	alicerce/pé/base
temperamento	feição/peculiaridade/índole/caráter/natureza/personalidade
templo	abside/ábside
termo	sílaba
terra	chão/hemisfério/relevo/céu/solo
torso	abdome/abdômen/bumbum/popô/bunda/estômago/nádegas/ombro/seio/ventre/abdómen/ânus/peito/tronco/barriga/rabo/traseiro/fundilhos/nalga/nádega/bunda/anca/costas/banda/traseiro
tronco	abdome/abdômen/bumbum/popô/bunda/estômago/nádegas/ombro/seio/ventre/abdómen/ânus/peito/barriga/rabo/traseiro/fundilhos/nalga/nádega/bunda/umbigo/anca/costas/banda/traseiro
universo	astro/estrela
vegetal	fragmento/parte
ventre	umbigo
verbo	sílaba
veículo	guarda-lama/fenestra/janela
via	curva
viatura	guarda-lama/fenestra/janela
vivenda	mansarda/trapeira/sótão/ático/alpendre/biblioteca
vocábulo	sílaba
óculo	cristalino/lente
ônibus	fenestra/janela

