abastado	quantidade
abrangente	plenitude
absorvente	absorbency
abundante	quantidade
aceitável	admissibilidade
acessível	disponibilidade/acessibilidade
acreditável	credibilidade
acromático	nuança/tonalidade/matiz/tom
acurado	acurácia/exactidão/exatidão/correção/precisão/rigor
adequado	adequação
admissível	admissibilidade
adoentado	bem-estar/saúde
adventício	colocação/localização/posição
afetado	naturalidade
afoito	denodo/coragem/ânimo
afável	índole/natureza
agencioso	atividade
alarmante	estupefação/consternação/medo
alta	gritaria/volume
alto	gritaria/volume/grau/estatura/altitude/altura/altura
ambicioso	ambição/aspiração
amigo	amizade
amigável	amizade
amistoso	amizade
amplo	anchura/largura/plenitude
amável	índole/natureza/amabilidade
analfabeto	alfabetismo/alfabetização
anormal	normalidade
antigo	idade
antinatural	naturalidade
análogo	igualdade
apagado	extinção
aprimorado	perfeição
arrojado	denodo/coragem/ânimo/ousadia/audácia
assexual	sexualidade/gênero/sexo
ativo	atividade/atividade
atrativo	magnetismo/magnetismo
atual	cronometragem/momento
audacioso	ousadia/audácia
audaz	ousadia/audácia
audível	audibilidade
ausente	presença
baixa	grau
baixo	grau/estatura/altura
bastante	quantidade/quantidade
basto	quantidade
belo	beleza
bem-sucedido	éxito/êxito
benigno	benevolência/amabilidade
berrante	gritaria/volume
bivalente	valência
boa	bondade/virtude
boa!	bondade
bom	bondade/virtude/qualidade
bonito	belo/beleza
boreal	união/norte/norte
brava	denodo/coragem/ânimo
bravo	denodo/coragem/ânimo/ousadia/audácia
brilhante	luminosidade
brunícoma	tez
caloroso	temperatura/temperatura/calor
capaz	habilidade/potencialidade/adequação/capacidade/capacidade/capacidade/poder/habilidade/habilidade/talento/talento
casta	virgindade/castidade/pureza/virtude
castanícoma	tez
casto	virgindade/castidade/pureza/virtude
cedo	cronometragem/momento
ceremonioso	formalidade
certo	correcção/pose/altivez/aprumo/corretude/desembaraço/certeza/certeza/segurança/fé
chato	tédio
cheio	plenitude
ciente	consciência/conhecimento/saber
científica	ciência
científico	ciência
claro	luminosidade
cobarde	cobardia/covardia
colorido	tez/cor/cor
comercial	comercialismo/mercantilismo/comércio
comilão	gula
completo	integralidade/inteireza/plenitude
complexo	complexidade
conciso	prolixidade
confiante	confiança
confortável	conforto
confuso	lucidez/transparência
conservador	ideologia
contemporâneo	modernidade
contente	felicidade/felicidade/alegria/alegria
contínuo	persistência/continuidade
convencional	convenção
conveniente	conveniência
copioso	quantidade
corajoso	denodo/coragem/ânimo/ousadia/audácia
correto	correcção/honestidade/corretude/honestidade
corriqueiro	convenção
corrupto	honestidade/honestidade/corrupção
cortês	civilidade/cortesia
covarde	cobardia/covardia
covardemente	cobardia/covardia
criador	criatividade/criatividade
criativo	criatividade/criatividade
cromático	nuança/tonalidade/matiz/tom
crítico	crise
crível	credibilidade
curto	duração
deficiente	quantidade
delicado	força
dependente	independência/liberdade
deprimido	altitude/altura
desconfortável	conforto
desconhecido	familiaridade
descortês	cortesia
desinteressante	fundura/profundidade/profundeza/tédio
desnecessária	necessidade
desnecessário	necessidade
desnivelado	invariabilidade
desobediente	obediência
desonesto	honestidade/honestidade
desonroso	honestidade
despadronizado	invariabilidade
destemido	consternação/temor/terror/medo/ousadia/audácia
desumano	humanidade
desuniforme	invariabilidade
detalhado	plenitude
devagar	rapidez/velocidade
diferente	similardidade/semelhança/similitude/similardidade/diferença/semelhança
difícil	dificuldade
direita	local/lugar/posição
direito	local/lugar/posição
disponível	disponibilidade/acessibilidade
disposto	prontidão/rapidez/preparação
distante	distância/distância/distância/distância
doente	bem-estar/saúde
doentio	bem-estar/saúde
dominante	status/condição/estado/classe/posição
dura	solidez
duradouro	permanência
duro	solidez
débil	força
educado	civilidade
efectivo	realidade
efetivo	efetividade/eficiência/eficácia/realidade
eficaz	efetividade/eficácia/eficiência/eficácia/eficácia
eficiente	efetividade/eficácia/eficiência/eficácia/eficácia
emocionante	excitamento/excitação
errado	verdade/correcção/corretude
esbelto	peso
escasso	suficiência/suficiente/adequação/quantidade
escuro	luminosidade
escuso	contorno
específico	generalidade
espesso	espessura/consistência/grossura/grossura/viscosidade
esquerdo	local/lugar/posição
essencial	necessidade
estranho	familiaridade
estreita	anchura/largura
estreito	anchura/largura
estrepitante	gritaria/volume
estéril	fertilidade/fertilidade
estúpido	inteligência
exacto	acurácia/exactidão/exatidão/correção/precisão/rigor
exato	acurácia/exactidão/exatidão/correção/precisão/rigor
exaustivo	plenitude
excitante	excitamento/excitação
existente	realidade/realismo/realidade/verdade/existência/existência/ser
extenso	plenitude
externo	colocação/localização/posição
extincto	extinção
extinto	extinção
extrovertido	curso
falso	verdade
familiar	familiaridade
farto	quantidade
fecundo	fertilidade/fertilidade
feia	belo/beleza
feio	belo/beleza
feliz	felicidade/felicidade/alegria/alegria
fiel	lealdade
fino	textura/espessura/grossura
flavo	tez
forgoso	temperatura/temperatura/calor
formal	formalidade/formalidade
formoso	belo/beleza
forte	força
fracionário	integridade
fresco	temperatura/temperatura/calor/frescura
frio	temperatura/temperatura/temperatura/temperatura/calor/calor
frívolo	seriedade
funcional	propósito/função
fundo	fundura/profundidade/profundeza
fuscícoma	tez
futuro	cronometragem/momento
fácil	facilidade/simplicidade
fértil	fertilidade/fertilidade
fútil	seriedade
gay	transa/sexo
gentil	índole/polidez/natureza/cortesia
geral	generalidade
gordo	peso
grande	tamanho/dimensão/medida/magnitude
grosseiro	civilidade
grosso	espessura/grossura
guloso	gula
hetero	transa/sexo
heterossexual	transa/sexo
hidrófilo	absorbency
homo	transa/sexo
homossexual	transa/sexo
honrado	honestidade
honroso	honestidade
horizontal	orientação
humanitário	humanidade
humano	humanidade/humanidade
idêntico	igualdade
igual	igualdade
ilegal	legalidade/legalidade
iletrado	alfabetismo/alfabetização
iluminado	luminosidade
imaturo	idade/maturidade
imediato	imediatez/imediação
imoral	moralidade/honestidade/moral/virtude
imperfeito	perfeição
impolido	polidez/cortesia
importante	importância/magnitude/significação/significado
impossível	possibilidade/chance
impotente	potencia/eficácia/potência/poder/força
improdutivo	fertilidade/fertilidade
improvável	probabilidade
impróprio	utilidade
imutável	mutabilidade
imóvel	movimento
inacessível	disponibilidade/disponibilidade/acessibilidade/acessibilidade
inacreditável	credibilidade
inadequado	adequação
inadmissível	admissibilidade
inalterável	mutabilidade
inapto	utilidade
inativo	atividade
inaudível	audibilidade
incapaz	habilidade/potencialidade/capacidade/capacidade/habilidade/talento
incerto	pose/altivez/aprumo/desembaraço/certeza/certeza/certeza/segurança/fé
inclinado	orientação
incompleto	integralidade/inteireza/plenitude
incorreto	correcção/corretude
incoveniente	conveniência
incrível	credibilidade
incómodo	conforto
incômodo	conforto
indelicado	polidez/cortesia
independente	independência/liberdade
indisponível	disponibilidade/acessibilidade
individual	individualidade/individualismo/personalidade
ineficaz	potencia/eficácia/potência/força
infeliz	felicidade/felicidade/alegria/alegria
inferior	calibre/qualidade
infiel	fidelidade/lealdade
informado	consciência/conhecimento/saber
informal	formalidade/formalidade
infértil	fertilidade/fertilidade
injusto	equanimidade/eqüidade/justiça
inodoro	odor/cheiro
inquietante	estupefação/consternação/medo
insalubre	bem-estar/saúde
inseguro	confiança/pose/altivez/aprumo/desembaraço/certeza/certeza/segurança/fé
insuficiente	quantidade/quantidade
insípido	sabor
integral	integridade/integralidade/inteireza/plenitude
inteiro	integridade
intelectual	inteligência
inteligente	inteligência
intensivo	grau
intenso	grau
interno	colocação/colocação/localização/localização/posição/posição
intrincado	dificuldade/complexidade
inumano	humanidade
inútil	efetividade/eficiência/utilidade/eficácia
irreal	realidade/realismo/realidade/verdade
jovem	idade
justo	acurácia/correcção/honestidade/corretude/exactidão/exatidão/correção/honestidade/precisão/rigor
júnior	senioridade
lacónico	prolixidade
lacônico	prolixidade
largo	anchura/largura
lauto	quantidade
leal	lealdade
legal	legalidade
lento	rapidez/velocidade
lerdo	inteligência
leve	peso
lhano	índole/natureza
liberal	ideologia/generosidade
limpo	asseio/limpeza
lindo	belo/beleza
liquidado	extinção
livre	liberdade
loiro	tez
longe	distância/distância
longínquo	distância/distância
lotado	plenitude
luminoso	luminosidade
lícito	admissibilidade/legalidade
lógico	lógica
macho	sexualidade/gênero/sexo
macio	solidez
maduro	idade/maturidade
magnético	magnetismo/magnetismo
magro	peso
maior	maioridade/ascendência/maioria
malvado	mal/maldade
maléfico	mal/maldade
manso	domesticação
marronícoma	tez
maturo	idade/maturidade
mau	mal/maldade
maçante	luminosidade
mediano	cronometragem/momento
mensurável	grandeza/magnitude/número
meridional	sul
mesmo	similardidade/semelhança
moderado	temperança/moderação
moderno	modernidade
modesto	modéstia/pudor
molhado	humidade/umidade
monótono	tédio
moral	moralidade/virtude
morena	tez
morto	animação/animação/vida
movente	movimento
mutável	mutabilidade
nao-maduro	idade
natural	naturalidade
necessário	necessidade
nobre	nobreza
normal	normalidade
nortista	norte
novo	idade
nórdico	norte
obediente	obediência
obscurícoma	tez
opaco	opacidade
oriental	levante/oriente/oriente/nascente
original	criatividade/criatividade/originalidade
ortodoxo	ortodoxia
outro	alteridade/distinção
padrão	quantia/quantitativo/medida/quantidade
parcial	integridade
parecido	similitude/similardidade/semelhança
parelho	igualdade
partido	integridade
passado	cronometragem/momento
pequeno	tamanho/dimensão/medida/magnitude
perfeito	perfeição
permanente	permanência
permissivo	tolerância
perpendicular	orientação
perto	distância/distância
pesado	peso
plano	invariabilidade
pleno	plenitude
poderoso	poder
polido	civilidade
polivalente	valência
popular	popularidade
positivo	qualidade
possível	potenciabilidade/potencial/possibilidade/chance
posterior	colocação/localização/posição
potencial	potenciabilidade
potente	potencia/eficácia/potência/força
preciso	acurácia/exactidão/exatidão/correção/precisão/rigor
precoce	cronometragem/momento
preparado	prontidão/rapidez/preparação
presente	presença/cronometragem/momento
prestes	prontidão/rapidez/preparação
profunda	fundura/profundidade/profundeza
profundo	fundura/profundidade/profundeza
prolixo	prolixidade
pronto	prontidão/rapidez/preparação
provável	probabilidade
próspero	éxito/êxito
próximo	distância/distância/distância/distância
puro	moralidade/moral/virtude
quebrado	integridade
quente	temperatura/temperatura/calor
rabo	colocação/localização/posição
radiante	luminosidade
rala	consistência/grossura/viscosidade
raso	fundura/profundidade/profundeza
razoável	sensatez
real	realidade
recente	frescura
receoso	consternação/temor/terror/medo
regular	regularidade
relutante	temperamento/disposição
respeitável	reputação/fama/honra/renome
responsável	responsabilidade
reto	contorno
revogado	extinção
ruim	mal/qualidade/maldade
rápida	rapidez/velocidade
rápido	rapidez/velocidade
sagrada	santidade
sagrado	santidade
salubre	bem-estar/saúde
santa	santidade
santo	santidade
sarcástico	sarcasmo/sátira/ironia
saudável	bem-estar/saúde
seco	humidade/umidade
semelhante	similitude/similardidade/semelhança
semvida	animação/animação/vida
sensível	sensibilidade/sensibilidade
separado	separação
setentrional	união/norte/norte/norte
sexual	sexualidade/gênero/sexo
significante	significação/significado
significativo	significação/significado
similar	similardidade/semelhança/similitude/similardidade/semelhança
simples	complexidade
singelo	complexidade
suave	gritaria/volume/grau
subordinada	status/condição/estado/classe/posição
subordinado	status/condição/estado/classe/posição
sucinto	prolixidade
suficiente	quantidade
suja	asseio/limpeza
sujado	asseio/limpeza
sujo	asseio/limpeza
sulista	sul
superficial	fundura/profundidade/profundeza
superior	calibre/qualidade
susceptível	susceptibilidade/suscetibilidade
suscetível	susceptibilidade/suscetibilidade
são	bem-estar/saúde
sério	seriedade
sênior	senioridade
tacanho	generosidade
tardio	cronometragem/momento
temporário	permanência
temporão	cronometragem/momento
torto	contorno
totalizado	integralidade/inteireza/plenitude
traseiro	colocação/localização/posição
triste	felicidade/felicidade/alegria/alegria
tímido	confiança
valente	denodo/coragem/ânimo
valoroso	denodo/coragem/ânimo
vantajoso	qualidade
variável	mutabilidade
varão	sexualidade/gênero/sexo
vazio	plenitude
velho	idade/idade
veloz	rapidez/velocidade
verdadeiro	verdade/realidade
vertical	orientação/atitude/postura/posição
vivo	animação/animação/vida
vivído	luminosidade
vizinho	distância/distância
vário	diversidade
vão	efetividade/eficiência/utilidade/eficácia
vívido	alma/vida
árduo	dificuldade
ávaro	generosidade
ávido	generosidade
útil	utilidade

