abastado	rica/rico
aberto	explícito/público
abrangente	totalizado/geral/integral/completo
abundante	rica/rico
aceitável	satisfatório
acessível	conveniente
acordado	alerta/consciente
actual	moderno/contemporâneo/novo
acurado	correcto/precisa/correto/exato/preciso/certo/justo
adequado	satisfatório/correto/certo/apropriado/justo
afoito	arrojado/audacioso/audaz/corajoso/bravo/destemido
agradável	boa!
agressivo	assertivo/peremptório/ofensivo/malvado
airoso	sofisticado
alegre	animador/animado/contente
alerta	desperto/acordado/vívido
alta	barulhento/ruidoso
alto	barulhento/ruidoso/grande
alvo	claro
amigo	cálido/social
amigável	cálido/social
amistoso	cálido/social
amplo	totalizado/geral/integral/completo
animado	grato/alegre/feliz/contente
animador	grato/alegre/feliz/contente
antipático	desagradável
apaixonado	entusiástico/esquentado/entusiasta/quente
apertado	tenso
aprimorado	correcto/exato/preciso/certo
apropriado	próprio/conveniente/adequado
arrojado	afoito/brava/valoroso/valente/audacioso/audaz/corajoso/bravo/destemido
assertivo	agressivo
atento	cautelosa/cauto/cuidadosa/cauteloso/prudente
ativo	vívido
atraente	belo/formoso/lindo/bonito
atual	moderno/contemporâneo/novo
audacioso	afoito/brava/valoroso/arrojado/valente/corajoso/bravo
audaz	afoito/brava/valoroso/arrojado/valente/corajoso/bravo
automático	mecânico
autêntico	honesta/sincera/honesto/sincero/existente/verdadeiro
barulhento	berrante/estrepitante/alta/alto
bastante	rica/rico
basto	rica/rico
belo	atraente
bem	saudável
berrante	barulhento/ruidoso
boa!	simpático/agradável
bom	saudável
bonito	atraente
branco	claro
brava	arrojado/audacioso/audaz/corajoso/bravo/destemido
bravo	afoito/brava/valoroso/arrojado/valente/audacioso/audaz/corajoso/destemido
calmo	pacífico
caloroso	forgoso/quente
capaz	habilitado/competente/satisfatório
característico	típico
caraterístico	típico
caro	valioso/precioso
cautelosa	cauto/cauteloso/prudente/atento
cauteloso	cautelosa/cuidadosa/prudente/atento
cauto	cautelosa/cuidadosa/prudente/atento
cedo	primeiro
certo	acurado/precisa/aprimorado/exacto/exato/preciso/próprio/conveniente/perfeito/verdadeiro/justo/adequado
claro	cândido/alvo/branco
comovente	impressionante
comparável	paralela/paralelo
competente	qualificado/talentoso/habilidoso/eficiente/capaz
completo	abrangente/detalhado/exaustivo/extenso/integral/inteiro/amplo
complexo	intrincado/árduo/difícil
comum	costumeiro/rotineiro/solidário/geral/genérico/normal/usual/conjunto/ordinário/habitual
concreto	prático/existente
conjunto	integrado/comum
consciente	desperto/acordado/voluntário
conservador	ortodoxo
considerável	grande
constante	estável
contemporâneo	actual/atual/corrente/novo
contente	animador/grato/animado/alegre/feliz
conveniente	correto/acessível/certo/apropriado/justo
cooperativo	serviçal/prestativo/prestável
copioso	rica/rico
corajoso	afoito/brava/valoroso/arrojado/valente/audacioso/audaz/bravo/destemido
correcto	acurado/precisa/aprimorado/exacto/exato/preciso/perfeito/justo
corrente	moderno/contemporâneo/novo
correto	acurado/honesta/sincera/exacto/exato/honesto/preciso/próprio/sincero/conveniente/verdadeiro/justo/adequado
costumeiro	geral/genérico/usual/ordinário/habitual/comum
cuidadosa	cauto/cauteloso/prudente/atento
cálido	amistoso/amigável/amigo
cândido	claro
definitivo	inconfundível/explícito
delicado	débil
desagradável	antipático/ofensivo/horrível
desajeitado	feio
desassossegado	desconfortável/tenso
desconfortável	desassossegado
desperto	alerta/consciente
destemido	afoito/brava/valoroso/arrojado/valente/corajoso/bravo
detalhado	totalizado/geral/integral/completo
detalhista	limpo/organizado
devagar	gradual
dianteiro	progressivo
distante	longe/longínquo
duradouro	estável
duro	experimentado/vivido/experiente
débil	delicado
efetivo	eficiente/poderoso/potente/útil
eficaz	eficiente/poderoso/potente/útil
eficiente	habilitado/competente/efetivo/eficaz/poderoso/potente/útil
elegante	sofisticado
elegível	qualificado
emocionante	interessante/impressionante
encorajador	serviçal/prestativo/prestável
entranhado	intenso
entusiasta	passional/apaixonado
entusiástico	passional/apaixonado
equitativo	imparcial
esbelto	sofisticado
escorregadio	liso/macio
espesso	gordo
esquentado	passional/apaixonado
esquerdista	socialista/liberal
esquisito	feio
essencial	necessário/primário
estranho	feio
estreita	limitado/estreito
estreito	estreita/limitado
estrepitante	barulhento/ruidoso
estável	permanente/constante/imutável/duradouro
evidente	explícito/aberto
exacto	correcto/precisa/correto/exato/preciso/certo/justo
exato	acurado/correcto/precisa/aprimorado/exacto/correto/preciso/certo/perfeito/justo
exaustivo	totalizado/geral/integral/completo
excitante	interessante
exigente	limpo/organizado
existente	realístico/concreto/autêntico/genuíno/legítimo
experiente	talentoso/habilidoso/grosso/duro/resistente
experimentado	talentoso/habilidoso/grosso/duro/resistente
explícito	definitivo/público/aberto
extenso	totalizado/geral/integral/completo
extraordinário	impressionante/superior
farto	rica/rico
feio	desajeitado/esquisito/estranho
feliz	animador/grato/animado/alegre/contente
fino	liso/macio
forgoso	caloroso
formoso	atraente
fresco	novo/frio
frio	frígido/fresco
fronteiro	progressivo
frígido	frio
garboso	sofisticado
genuíno	honesta/sincera/honesto/sincero/existente/verdadeiro
genérico	comum
geral	abrangente/detalhado/exaustivo/extenso/amplo/comum
gordo	espesso/grosso
gracioso	sofisticado
gradual	lento/devagar
grato	animador/animado/contente
gregário	social
grosso	experimentado/vivido/experiente/gordo
habilidoso	experimentado/habilitado/vivido/competente/experiente
habilitado	qualificado/talentoso/habilidoso/eficiente/capaz
habitual	comum
honesta	honroso/honrado/correto/autêntico/genuíno/legítimo/verdadeiro/justo
honesto	honroso/honrado/correto/autêntico/genuíno/legítimo/verdadeiro/justo
honrado	honesta/sincera/honesto/sincero/moral/nobre
honroso	honesta/sincera/honesto/sincero/moral/nobre
horrível	desagradável
importante	significativo
impressionante	comovente/emocionante
imprevisto	surpreendente
imutável	estável/plano
inconfundível	precisa/definitivo/preciso
independente	livre/separado
industrial	progressivo
inesperado	surpreendente
inseguro	vulnerável
integrado	solidário/conjunto
integral	abrangente/detalhado/totalizado/exaustivo/extenso/inteiro/completo/amplo
inteiro	totalizado/integral/completo
intenso	entranhado/profundo
interessante	emocionante/excitante
interno	central
intrincado	árduo/difícil
justo	acurado/correcto/honesta/precisa/sincera/exacto/correto/exato/honesto/imparcial/preciso/próprio/sincero/certo/conveniente/verdadeiro/adequado
lauto	rica/rico
legítimo	honesta/sincera/honesto/sincero/existente/verdadeiro
lento	gradual
liberal	esquerdista
limitado	estreita/estreito
limpo	detalhista/organizado/exigente
lindo	atraente
liso	escorregadio/fino/plano
livre	independente
lógico	razoável/racional
macio	escorregadio/fino/plano
maduro	velho
malvado	ofensivo/agressivo/violento
maturo	velho
moderno	actual/atual/corrente/novo
moral	honroso/honrado
necessário	essencial
nobre	honroso/honrado
nocivo	tóxico
normal	costumeiro/geral/genérico/usual/ordinário/habitual/comum/padrão
novo	actual/fresco/atual/moderno/recente/corrente/contemporâneo
ofensivo	desagradável/agressivo/malvado
ordinário	costumeiro/geral/genérico/usual/habitual/comum
organizado	detalhista/limpo/exigente
original	primário/primeiro
ortodoxo	conservador
outro	separado
paciente	tolerante
pacífico	calmo/quieto
padrão	normal
paralela	comparável
paralelo	comparável
passional	entusiástico/esquentado/entusiasta/quente
peremptório	agressivo
perfeito	correcto/exato/preciso/certo
perigoso	vulnerável
permanente	estável
perpendicular	íngreme/íngrime
plano	liso/macio/imutável
poderoso	efetivo/eficaz/eficiente/potente
potente	efetivo/eficaz/eficiente/poderoso
precioso	caro
precisa	acurado/correcto/inconfundível/exacto/exato/preciso/certo/justo
preciso	acurado/correcto/inconfundível/precisa/aprimorado/exacto/correto/exato/certo/perfeito/justo
precoce	primeiro
prestativo	encorajador/cooperativo/útil
prestável	encorajador/cooperativo/útil
primeiro	precoce/primário/temporão/original/cedo
primário	original/primeiro/essencial
privilegiado	rica/rico
profundo	intenso
progressivo	fronteiro/dianteiro/industrial
prudente	cautelosa/cauto/cuidadosa/cauteloso/atento
prático	realístico/concreto
próprio	correto/certo/apropriado/justo
público	explícito/aberto
qualificado	elegível/habilitado/competente
quente	caloroso/passional/apaixonado
quieto	suave/pacífico
racional	razoável/lógico
razoável	válido/lógico/racional
realístico	prático/existente
recente	novo
regular	sistémico/sistemático
resistente	experimentado/vivido/experiente
rica	basto/copioso/lauto/abastado/farto/privilegiado/abundante/bastante
rico	basto/copioso/lauto/abastado/farto/privilegiado/abundante/bastante
rotineiro	costumeiro/geral/genérico/usual/ordinário/habitual/comum
ruidoso	berrante/estrepitante/alta/alto
sagrada	sagrado
santa	sagrado
santo	sagrado
satisfatório	aceitável/adequado/capaz
saudável	bom/bem
separado	independente/outro
serviçal	encorajador/cooperativo/útil
significante	significativo
significativo	significante/importante
silencioso	suave
simpático	boa!
sincera	honroso/honrado/correto/autêntico/genuíno/legítimo/verdadeiro/justo
sincero	honroso/honrado/correto/autêntico/genuíno/legítimo/verdadeiro/justo
sistemático	regular
sistémico	regular
social	amistoso/amigável/gregário/amigo
socialista	esquerdista
sofisticado	airoso/garboso/gracioso/elegante/esbelto
solidário	integrado/comum
suave	quieto/silencioso
surpreendente	imprevisto/inesperado
sênior	velho
sólido	dura/duro
talentoso	experimentado/habilitado/vivido/competente/experiente
temporão	primeiro
tenso	desassossegado/apertado
tolerante	paciente
totalizado	abrangente/detalhado/exaustivo/extenso/integral/inteiro/amplo
típico	característico/caraterístico
tóxico	nocivo
usual	comum
valente	arrojado/audacioso/audaz/corajoso/bravo/destemido
valioso	caro
valoroso	arrojado/audacioso/audaz/corajoso/bravo/destemido
velho	experimentado/sênior/vivido/experiente/maturo/maduro
verdadeiro	honesta/sincera/correto/honesto/sincero/autêntico/certo/genuíno/legítimo/justo
vertical	íngreme/íngrime
violento	malvado
vivido	talentoso/habilidoso/grosso/duro/resistente
voluntário	consciente
vulnerável	perigoso/inseguro
válido	razoável
vívido	alerta
ávido	entusiástico/entusiasta
íngreme	vertical/perpendicular
íngrime	vertical/perpendicular
óbvio	explícito/aberto
útil	serviçal/efetivo/prestativo/eficaz/prestável/eficiente
