abdome	intestino/intestinos/barriga
abdómen	intestino/intestinos/barriga
abdômen	intestino/intestinos/barriga
acesso	portas/umbral/limiar/porta/portão
acordo	termo/condição
administração	hierarquia
adn	gene/genes/genes/guen
aeronave	camarote
aeroplano	acelerador/ala/asa/camarote
agricultura	colheita
alguém	temperamento/anatomia/carne/personalidade/pessoa/corpo
alma	temperamento/anatomia/carne/personalidade/pessoa/corpo
amendoim	ginguba
animal	cabeça
anjo	ala/asa
ano	sazão/semestre/estação/tempo/período
anoitecer	crepúsculo
aparelhador	gaveta/prateleira/estante/caixa
aposento	assoalho/muralha/muro/pavimento/piso/chão/dormitório/parede/teto/cozinha/quarto/banheiro
arca	tampa
arco	flecha/seta
arena	gramado/campo
arma	armamento/tubo
armamento	arma
armação	óculos
armário	gaveta/prateleira/prateleira/estante/estante/caixa
aríete	chifre/corno
assento	pé
astronave	camarote
ato	cena
aula	conferência/lição
auto	bagageira/porta-bagagem/porta-malas/acelerador/buzina/mala
automóvel	bagageira/porta-bagagem/porta-malas/acelerador/buzina/mala
ave	plumagem/ala/bico/pluma/asa/pena
avião	acelerador/ala/asa/camarote
baga	fruto/fruta
balé	ato
banana-maçã	banana
banheiro	banheira
barco	convés/convés
barriga	intestino/intestinos
barril	galão/galão/arco/arco
batalha	porrada/golpe
baú	tampa
besta	cabeça
bicho	cabeça
bici	corrente/cadeia
bicicleta	corrente/cadeia
biciclo	corrente/cadeia
boca	beiço/lábio/língua
bode	chifre/chifre/corno/corno
boteco	bar
botequim	bar
bovinos	bife/carne
braça	jarda
braço	carpo/pulso/mão/cotovelo/punho/pata
brócolis	bróculos
bufete	gaveta/prateleira/estante/caixa
cabaceiro-amargoso	aboboreira/jerimum/abóbora
cabeça	caveira/crâneo/crânio/encéfalo/encéfalo/têmpora/crânio/orelha/cérebro/face/rosto/cara
cabra	chifre/corno
cabrito	chifre/corno
cachorro-quente	salsicha
cadeira	pé
caixa	fechadura/tampa/base
calculadora	chip/ci/hardware/microchip/memória
caminho	acostamento/berma/encruzilhada/cruzamento/curva
campo	pastagem/pasto/prado
cara	bochecha/chinchilla/mento/sobrancelha/sobrancelha/sobrolho/supercílio/testa/óculo/olho/nariz/olfato/queixo/barba/traço
carneiro	chifre/corno
carro	bagageira/porta-bagagem/porta-malas/acelerador/buzina/mala
carta	melodia/linha
cartucho	projétil/projétil/bala/bala
caráter	integridade
casa	estudio/mansarda/trapeira/palco/sótão/ático/dormitório/escritório/cozinha/quarto/teatro/banheiro
caveira	mandíbula
caxato	pico/ponta
ceco	apêndice/apêndice
centúria	decênio/década
cerejeira	ginja/cereja
cidade	praça
cinema	plano
circuito	curto-circuito
coitelo	pico/ponta
colégio	classe
combate	porrada/golpe
comercialismo	transportação/transporte/expedição
comitiva	escolta/guarda-costas/guarda
computador	chip/ci/hardware/microchip/memória
comércio	transportação/transporte/expedição
cone	pico/ponta
conta	balanço
contabilidade	balanço
conto	introdução/conclusão
convento	cela/cela
conventos	cela
copo	vidro
corpo	abdome/abdômen/bumbum/popô/talhe/torso/bunda/cintura/estômago/nádegas/ombro/pescoço/quadril/seio/ventre/abdómen/braço/ânus/peito/anca/cabeça/tronco/tronco/tronco/barriga/barriga/rabo/traseiro
correio	missiva/carta
corrente	jarda
correspondência	missiva/carta
corta-relva	lâmina/lâmina
costa	praia
criatura	cabeça
cromossoma	gene/genes/genes/guen
cromossomas	gene/genes/genes/guen
cromossomo	gene/genes/genes/guen
crâneo	mandíbula
crânio	mandíbula/mandíbula
cultivo	colheita
curso	aula/conferência/lição
cérebro	hemisfério
céu	arco-íris/nuvem
cómoda	gaveta/prateleira/estante/caixa
cômoda	gaveta/gaveta/prateleira/estante/caixa/caixa
cômodas	gaveta/prateleira/estante/caixa
decênio	ano
dedo	unha
departamento	classe
desenho	subtítulo/legenda/lenda/título
dia	manhã/noitada/tarde/turno/hora/noite
discurso	introdução/conclusão
disputa	porrada/golpe
divisa	coroa/cara
dna	gene/genes/genes/guen
doença	síndroma/sintoma/síndrome
doenças	síndroma/sintoma/síndrome
domicílio	dormitório/cozinha/quarto/banheiro
dormitório	cama/leito
drama	ato
década	ano
dígito	unha
edifício	antecâmara/antessala/ascensor/calefacção/escadaria/aposento/aquecimento/calefação/muralha/muro/pavimento/piso/saguão/vestíbulo/átrio/escada/parede/pátio/telhado/anexo/elevador/asa/teto/quarto/sala/sala/andar
edição	cartoon/caricatura/texto
elevação	declive/declives/subida/encosta/costa/ladeira
embarcação	convés/convés
empório	prateleira/estante
endoesqueleto	articulações/osso/articulação
endosqueleto	articulações/osso/articulação
enfermaria	sala
engrenagem	dente
entrada	portas/umbral/limiar/porta/portão
episódio	incidente/evento
erva	verdura/hortaliça/legume/vegetal
escada	degrau
escadaria	degrau
escola	classe
escolas	classe
escrivaninha	gaveta/caixa
escudeiro	margem
espada	lâmina/lâmina/pico/ponta
espaço	locação/localização/ponto/lugar
espaçonave	camarote
estante	prateleira/prateleira
estrada	acostamento/berma/encruzilhada/cruzamento/curva
estrofe	melodia/linha
estádio	gramado/campo
estômago	intestino/intestinos/barriga
eurasia	europa
eurásia	europa
explanação	fundação/base
explicação	fundação/base
faca	lâmina/lâmina/pico/ponta
face	bochecha/chinchilla/mento/sobrancelha/sobrancelha/sobrolho/supercílio/testa/óculo/olho/nariz/olfato/queixo/barba/traço
faringe	língua
farmacopéia	entorpecente/droga/medicamento/remédio
feijão	fava
feira	prateleira/estante
figueira-comum	figo
figura	subtítulo/legenda/lenda/título
filme	plano
fim-de-semana	domingo
folha	manchete/quadrinhos
fruta	pele/casca
gado	bife/carne
galho	súber/súber/casca/casca
garganta	língua
garrafa	tampa
gaveta	fechadura
gaveteiro	gaveta/prateleira/estante/caixa
gládio	lâmina/lâmina/pico/ponta
grafo	curvas/curva
gráfico	curvas/curva
guerra	combate/batalha/luta
habitação	estudio/mansarda/trapeira/sótão/ático/dormitório/escritório/cozinha/quarto/banheiro
hemípteros	ala/asa
hidrosfera	oceano
história	introdução/era/idade/época/conclusão/período
histórico	era/idade/época/período
hora	min/minuto
hospital	sala
humano	anatomia/braço/mão/carne/face/pata/rosto/cara/corpo/pé
ilustração	subtítulo/legenda/lenda/título
indivíduo	temperamento/anatomia/carne/personalidade/pessoa/corpo
infinito	locação/localização/ponto/lugar
insecto	ala/asa
insectos	ala/asa
inseto	ala/asa
insetos	ala/asa
jarda	pé
jardim	terraço/pátio
joalharia	gema/pedra
joalheria	gema/pedra
jornada	manhã
jornal	manchete/quadrinhos
julgamento	processo
jóia	gema/pedra
lar	dormitório/cozinha/quarto/banheiro
laranjeira	laranja
lauda	margem
limeira	limão
limoeiro	limão
litoral	praia
livro	regra
luta	porrada/golpe
lápis	pico/ponta
lâmpada	base
lâmpadas	base
machado	lâmina/lâmina
macieira	maçã
mala	tampa
mar	baía
marketing	propaganda/propaganda/promoção/promoção/publicidade/publicidade/anúncio/anúncio
maturidade	maioria
mercado	industria/prateleira/empresa/negócio/comércio/estante
mercado/mercadinho	prateleira/estante
mercadologia	propaganda/promoção/publicidade/anúncio
mercantilismo	transportação/transporte/expedição
mesa	gaveta/caixa/pé
milho	cereal/cereal
milénio	centúria/século/séculos/século
milênio	centúria/século/séculos/século
min	sec/s/segundo
mina	poço/chaminé
minuto	sec/s/segundo
missiva	melodia/linha
moeda	coroa/cara
molécula	átomo
monastério	cela
morada	dormitório/cozinha/quarto/banheiro
moradia	dormitório/cozinha/quarto/banheiro
morcego	ala/asa
mosteiro	cela
mundo	chão/hemisfério/relevo/céu/solo/terra
munição	armamento/arma
muralha	arco
muro	arco
mão	dedo
mês	semana
mímica	gesto
narração	introdução/conclusão
natureza	característica/qualidade
navio	convés/convés
navios	convés/convés
navios-veleiro	vela
noitada	meia-noite
noite	meia-noite/anoitecer/crepúsculo
olho	pálpebra
organismo	célula
organização	hierarquia
orla	praia
ortografia	caracter/caractér/carácter/letra
ovo	casca
pacto	termo/condição
palavra	sílaba
parede	arco
parque	baloiço/escorregador/escorrego/balanço
parquinho	baloiço/escorregador/escorrego/balanço
pata	dedo
pecuária	colheita
pele	lentigem/lentigem/ruga/ruga/sarda/sarda/sulco/sulco/sardas/sardas
peleja	porrada/golpe
película	plano
pente	projétil/bala
penteado	anel/cacho
pepino	pepineiro
periódico	manchete/quadrinhos
perna	maléolo/tornozelo/artelho/coxa/joelho/anca/pé
personalidade	feição/peculiaridade/integridade
perspectiva	horizonte
pescoço	faringe/garganta
pessoa	feição/peculiaridade/temperamento/anatomia/carne/personalidade/corpo
peça	coroa/cara
plataforma	calculadora/computador
playground	baloiço/escorregador/escorrego/balanço
porta	portas/umbral/fechadura/fechadura/limiar/portão
porta-seios	alcinha
portas	fechadura
portão	portas/umbral/fechadura/fechadura/limiar/porta
prata	coroa/cara
prateleiras	gaveta/prateleira/estante/caixa
prato	molho
produção	plano
programa	meta/alvo/objectivo/intenção
prédio	antecâmara/antessala/ascensor/calefacção/escadaria/aposento/aquecimento/calefação/muralha/muro/pavimento/piso/saguão/vestíbulo/átrio/escada/parede/pátio/telhado/anexo/elevador/asa/teto/quarto/sala/sala/andar
pub	bar
publicação	cartoon/caricatura/texto
pugna	porrada/golpe
página	margem
pássaro	plumagem/ala/bico/pluma/asa/pena
pé	calcanhar/alfândega/artelho/polegada/dedo
pórtico	portas/umbral/limiar/porta/portão
quarto	assoalho/cama/muralha/muro/pavimento/piso/chão/leito/parede/teto
quirópteros	ala/asa
quitanda	prateleira/estante
raiz	súber/casca
ramo	súber/casca
raíz	súber/casca
refeição	porção/prato
repasto	porção/prato
residência	dormitório/cozinha/quarto/banheiro
revólver	tubo
revóvel	tubo
rio	cachoeira/cascata/catarata
rod	jarda
rodovia	acostamento/berma/encruzilhada/cruzamento/curva
rosto	bochecha/chinchilla/mento/sobrancelha/sobrancelha/sobrolho/supercílio/testa/óculo/olho/nariz/olfato/queixo/barba/traço
roupa	algibeira/bolso/guarda-roupa/manga/banda/faixa
sacolão	prateleira/estante
saguão	assoalho/muralha/muro/pavimento/piso/chão/parede/teto
sala	assoalho/muralha/muro/pavimento/piso/chão/parede/teto
salário	ordenado/remuneração/retribuição
salão	assoalho/muralha/muro/pavimento/piso/chão/parede/teto
sandes	pão
sanduiche	pão
sanduíche	pão
sanduíches	pão
secretária	gaveta/caixa
semana	fim-de-semana
ser	célula/cabeça
shopping	mercadoria/produto/artigo
sistema	infraestructura/infraestrutura/infra-estrutura/módulo
sociedade	estrato/classe
stone	libra
supermercado	prateleira/estante
suspensório	alcinha
sutiã	alcinha
século	decênio/decênio/década/década
séculos	decênio/década
séquito	escolta/guarda-costas/guarda
taberna	bar
tamareira	tâmara/tâmara
tampa	fechadura
tarde	meia-noite/anoitecer/crepúsculo
teatro	palco/ato
telefonia	telefone
televisão	televisor/tv/tevê
telhado	ladrilho
temperamento	feição/peculiaridade
templo	coluna/pilar/coluna
teoria	possibilidade/suposição/hipótese
termo	sílaba
terra	chão/hemisfério/relevo/céu/solo
tesoura	lâmina/lâmina
tevê	televisor/tv/televisão
texto	alínea/parágrafo/capítulo/passagem
todo	segmento/seção
toiro	chifre/corno
torso	abdome/abdômen/bumbum/popô/talhe/bunda/cintura/estômago/nádegas/ombro/quadril/seio/ventre/abdómen/ânus/peito/anca/tronco/tronco/barriga/barriga/rabo/traseiro
touro	chifre/corno
traje	guarda-roupa
tratamento	terapia/medicamento/remédio
tripé	pé/pé
tronco	abdome/abdômen/bumbum/intestino/intestinos/popô/súber/talhe/bunda/cintura/estômago/nádegas/ombro/quadril/seio/ventre/abdómen/ânus/peito/anca/barriga/barriga/barriga/casca/rabo/traseiro
túnel	poço/chaminé
unidade	segmento/seção
vacas	bife/carne
vaquinha	aposta
vasilha	rebordo/tampa/base
vasilhame	rebordo/base
vaso	rebordo/base
veleiro	vela
ventre	intestino/intestinos/barriga
verbo	sílaba
vertebrado	costela/seio/cauda/peito/rabo/traseiro
vestido	guarda-roupa
vestimenta	guarda-roupa
vestuário	algibeira/bolso/guarda-roupa/manga/banda/faixa
veículo	bagageira/porta-bagagem/porta-malas/acelerador/buzina/mala
via	acostamento/berma/encruzilhada/cruzamento/curva
viatura	bagageira/porta-bagagem/porta-malas/acelerador/buzina/mala
vivenda	estudio/mansarda/trapeira/sótão/ático/escritório
vocábulo	sílaba
véspera	anoitecer/crepúsculo
zodíaco	signo
água	albufeira/reservatório/lago
íris	pupila/pupila
óculo	pálpebra
ópera	ato

