actor	héming/jr.
advogado	averróis
aldeia	aberdare/abidos/agrigento/antioquia/anzio/asheville/avinhão/bangor/bartlesville/bath/bellingham/bemidji/blackpool/boulder/brunsvique/calais/calé/cantuária/chalkedon/champaign/chartres/cnossos/columbia/columbo/cusco/decatur/dhahran/dubuque/enid/entebbe/eureka/fredericksburg/frederico/galveston/gettysburg/greenville/hamelin/hastings/hays/hershey/hipona/hohenlinden/interlaken/ithaca/jalalabad/kalamazoo/kennewick/lafayette/laramie/lawrence/lewiston/lufkin/mansfield/mariehamn/marquette/maçuá/mcallen/mcallen/medford/midland/moline/monterey/muskogee/natchez/nazaré/nogales/nyssa/ottumwa/pensacola/plateias/platéias/plymouth/plzen/plzeň/pocatello/princeton/reggane/rutland/salina/saqqara/sarasota/selma/skagway/stratford-upon-avon/stratford-upon-avon/sunderland/timgad/valdosta/vichy/waterloo/watertown/wausau/wilmington/yakima/yellowknife/áccio/âccio/belém/cairo/california/chablis/dunquerque/monroe/monroe/nome/paris/portsmouth/somerset/vancouver/acre/kansas
anexo	montmartre
arraial	aberdare/abidos/agrigento/antioquia/anzio/asheville/avinhão/bangor/bartlesville/bath/bellingham/bemidji/blackpool/boulder/brunsvique/calais/calé/cantuária/chalkedon/champaign/chartres/cnossos/columbia/columbo/cusco/decatur/dhahran/dubuque/enid/entebbe/eureka/fredericksburg/frederico/galveston/gettysburg/greenville/hamelin/hastings/hays/hershey/hipona/hohenlinden/interlaken/ithaca/jalalabad/kalamazoo/kennewick/lafayette/laramie/lawrence/lewiston/lufkin/mansfield/mariehamn/marquette/maçuá/mcallen/mcallen/medford/midland/moline/monterey/muskogee/natchez/nazaré/nogales/nyssa/ottumwa/pensacola/plateias/platéias/plymouth/plzen/plzeň/pocatello/princeton/reggane/rutland/salina/saqqara/sarasota/selma/skagway/stratford-upon-avon/stratford-upon-avon/sunderland/timgad/valdosta/vichy/waterloo/watertown/wausau/wilmington/yakima/yellowknife/áccio/âccio/belém/cairo/california/chablis/dunquerque/monroe/monroe/nome/paris/portsmouth/somerset/vancouver/acre/kansas
artista	héming/jr.
arvoredo	sherwood
assentamento	gibraltar/novaiorque
ator	héming/jr.
autor	colette/dumas/estêvão/hesse/leonardo/ourives/petrónio/petrônio/plínio/saki/stendhal/tolkien/voltaire/aragão/james/marisma
bairro	bloomsbury/harlem/montmartre/soho/soho/wembley/hollywood
balñaei	wiesbaden
barco	mayflower
barranco	areópago/flodden/gólgota/montescheviot/palatino/peninos/calvário/sião
beira-mar	eólia/barbária
bosque	sherwood
burgo	aberdare/abidos/agrigento/antioquia/anzio/asheville/avinhão/bangor/bartlesville/bath/bellingham/bemidji/blackpool/boulder/brunsvique/calais/calé/cantuária/chalkedon/champaign/chartres/cnossos/columbia/columbo/cusco/decatur/dhahran/dubuque/enid/entebbe/eureka/fredericksburg/frederico/galveston/gettysburg/greenville/hamelin/hastings/hays/hershey/hipona/hohenlinden/interlaken/ithaca/jalalabad/kalamazoo/kennewick/lafayette/laramie/lawrence/lewiston/lufkin/mansfield/mariehamn/marquette/maçuá/mcallen/mcallen/medford/midland/moline/monterey/muskogee/natchez/nazaré/nogales/nyssa/ottumwa/pensacola/plateias/platéias/plymouth/plzen/plzeň/pocatello/princeton/reggane/rutland/salina/saqqara/sarasota/selma/skagway/stratford-upon-avon/stratford-upon-avon/sunderland/timgad/valdosta/vichy/waterloo/watertown/wausau/wilmington/yakima/yellowknife/áccio/âccio/belém/cairo/california/chablis/dunquerque/monroe/monroe/nome/paris/portsmouth/somerset/vancouver/acre/kansas
cais	cesareia
cercania	montmartre
chão	america/américas/américa
cineasta	kieslowski/lucas
circunscrição	acádia/beócia/castela/catalunha/cataluña/darfur/kwazulu-natal/nunavut/sabá/sarawak/yukon/yukón/ática/aragão/acre/natal
colina	areópago/flodden/gólgota/montescheviot/palatino/peninos/calvário/sião
colônia	gibraltar/novaiorque
comarca	acádia/beócia/castela/catalunha/cataluña/darfur/kwazulu-natal/nunavut/sabá/sarawak/yukon/yukón/ática/aragão/acre/natal
compositor	dvorak/joaquim/leadbelly/mendelssohn/tchaikovsky/varese/villa-lobos/bach
comunidade	xhosa/xhosa/zulu
condado	berkshire/cornualha/cumbria/cúmbria/devon/essex/gloucestershire/hampshire/hertfordshire/leicestershire/lincolnshire/northamptonshire/northumberland/surrey/sussex/somerset
cordilheira	alpes/andes/apalaches/apeninos/caracórum/cárpatos/himalaia/hindukush/indocuche/kunlun/montanhasrochosas/pamir/pireneus/pirenéus/pirineus/pirinéus/ródope/cáucaso
costa	eólia/barbária
deidade	arhat/bodisatva/bodisatva/bodisatvas/demogorgon/hipnos/morfeu/quetzalcoatl/quetzalcóatl
deidades	arhat/bodisatva/bodisatva/bodisatvas/demogorgon/hipnos/morfeu/quetzalcoatl/quetzalcóatl
deus	arhat/arhat/bodisatva/bodisatva/bodisatva/bodisatva/bodisatvas/bodisatvas/demogorgon/demogorgon/hipnos/hipnos/morfeu/morfeu/quetzalcoatl/quetzalcoatl/quetzalcóatl/quetzalcóatl
deusa	arhat/bodisatva/bodisatva/bodisatvas/demogorgon/hipnos/morfeu/quetzalcoatl/quetzalcóatl
districto	acádia/beócia/castela/catalunha/cataluña/darfur/kwazulu-natal/nunavut/sabá/sarawak/yukon/yukón/ática/aragão/acre/natal
distrito	aberdare/abidos/acádia/agrigento/antioquia/anzio/asheville/avinhão/bangor/bartlesville/bath/bellingham/bemidji/beócia/blackpool/boulder/brunsvique/calais/calé/cantuária/castela/catalunha/cataluña/chalkedon/champaign/chartres/cnossos/columbia/columbo/cusco/darfur/decatur/dhahran/dubuque/enid/entebbe/eureka/fredericksburg/frederico/galveston/gettysburg/greenville/hamelin/hastings/hays/hershey/hipona/hohenlinden/interlaken/ithaca/jalalabad/kalamazoo/kennewick/kwazulu-natal/lafayette/laramie/lawrence/lewiston/lufkin/mansfield/mariehamn/marquette/maçuá/mcallen/mcallen/medford/midland/moline/monterey/muskogee/natchez/nazaré/nogales/nunavut/nyssa/ottumwa/pensacola/plateias/platéias/plymouth/plzen/plzeň/pocatello/princeton/reggane/rutland/sabá/salina/saqqara/sarasota/sarawak/selma/skagway/stratford-upon-avon/stratford-upon-avon/sunderland/timgad/valdosta/vichy/waterloo/watertown/wausau/wilmington/yakima/yellowknife/yukon/yukón/áccio/ática/âccio/aragão/belém/cairo/california/chablis/dunquerque/monroe/monroe/nome/paris/portsmouth/somerset/vancouver/acre/acre/kansas/natal
divindade	arhat/bodisatva/bodisatva/bodisatvas/demogorgon/hipnos/morfeu/quetzalcoatl/quetzalcóatl
divinidade	arhat/bodisatva/bodisatva/bodisatvas/demogorgon/hipnos/morfeu/quetzalcoatl/quetzalcóatl
documentos	ayurveda
domínio	acádia/beócia/castela/catalunha/cataluña/darfur/kwazulu-natal/nunavut/sabá/sarawak/yukon/yukón/ática/aragão/acre/natal
doutor	averróis/avicena/paracelso
dr.	averróis/avicena/paracelso
educacionista	comenius/willard
educador	comenius/willard
embarcação	mayflower
engenheiro	junkers
era	califados/califado
escapada	hégira
escape	hégira
escritor	colette/dumas/estêvão/hesse/leonardo/ourives/petrónio/petrônio/plínio/saki/stendhal/tolkien/voltaire/aragão/james/marisma
espirito	lúcifer/satanás/satã/deus/senhor/diabo
esposa	bate-seba/bate-seba/raquel/rebeca/rute/sara
estado	abecásia/assam/baviera/bihar/cabo/cabodaboaesperança/campeche/gansu/goa/guangdong/gujarat/hebei/hunan/karnataka/kosovo/manipur/orissa/sichuan/tabasco/tirol/transvaal/xinjiang/yunnan/bornéu/bósnia/chihuahua/guzerate/iucatã
estrela	sol/sol/acrux/becrux/deneb/pólux/regulus/spica
etapa	mesolítico/neolítico/neolítico/paleolítico
filho	esau/esaú
floresta	sherwood
florestas	sherwood
fronteira	rubicão
fronteiras	rubicão
fuga	hégira
garoto	esau/esaú
governador	tamerlão
governante	tamerlão
hebraica	cristo/lot/jesus
hebraico	cristo/lot/jesus
hebreia	cristo/lot/jesus
hebreu	cristo/lot/jesus
homem	adão/caim/jafé/sem/sete
idade	califados/califado
ilha	anglesey/anguila/anguilha/anguilla/antígua/aruba/açores/bali/barbuda/bermudas/bioko/bonaire/borneu/báli/canárias/capri/celebes/corsega/creta/culebra/curaçao/célebes/galápagos/groenlândia/gronelandia/gronelândia/groênlandia/guadalcanal/guadalupe/guam/guame/havai/hispaniola/hokkaido/hokkaidō/honshu/honshū/ilhota/ilhotas/ischia/islandia/isquia/iwojima/kahoolawe/kauai/krakatao/kyushu/kyūshu/kyūshū/lanai/lemnos/luzon/maiorca/mallorca/martinica/maui/mindanau/mindoro/molokai/monserrate/montserrat/nantucket/nevedfsd/oahu/redonda/saba/saipan/samatra/sardenha/shikoku/spitsbergen/sumatra/taiti/tenerife/terranova/timor/tobago/trinidad/vieques/zanzibar/zelândia/ísquia/ítaca/bahrein/barbados/barém/bornéu/cebu/chipre/cuba/córsega/formosa/formosa/grã-bretanha/haiti/havaí/irlanda/islândia/jamaica/java/madagascar/madagáscar/madeira/malta/manhattan/nauru/samoa/seicheles/seychelles/sicília/svalbard/taiwan/taiwan/tasmânia/cingapura/singapura
intérprete	héming/jr.
judeu	cristo/lot/jesus
judia	cristo/lot/jesus
jurista	averróis
ladeira	areópago/flodden/gólgota/montescheviot/palatino/peninos/calvário/sião
lago	aral/baical/cáspio/ijsselmeer/tanganyika/erié/erié/chade
limite	rubicão
litoral	eólia/barbária
livro	utopia
locação	latrão
lugar	latrão
mar	adriático/báltico/egeu/mardebering/mediterrâneo/caribe
mata	sherwood
menino	esau/esaú
montanha	areópago/flodden/gólgota/montescheviot/palatino/peninos/calvário/sião
monte	areópago/flodden/gólgota/montescheviot/palatino/peninos/calvário/sião
monumento	pirâmide
monumentos	pirâmide
morro	areópago/flodden/gólgota/montescheviot/palatino/peninos/calvário/sião
mulher	bate-seba/bate-seba/eva/raquel/rebeca/rute/sara
museu	louvre
museus	louvre
mãe	maria
médico	averróis/avicena/hipocrates/hipócrates/paracelso
navio	mayflower
navios	mayflower
nação	baamas/bahamas/burkina-faso/cabo-verde/ceilão/comores/domingos/dominica/domínica/etrúria/fidji/fiji/indonesia/indonésia/kiribati/kiribati/kiribáti/maldivas/mauricia/maurícia/maurícias/maurício/palau/quiribati/quiribáti/sri-lanka/timor-leste/tonga/turcomenistão/turquemenistão/turquia/tuvalu/ucrania/ucránia/ucrânia/urss/vanuatu/austrália/barbados/chipre/cuba/filipinas/granada/haiti/israel/jamaica/malta/micronésia/nauru/samoa/seicheles/seychelles/rússia/rússia
país	baamas/bahamas/burkina-faso/cabo-verde/ceilão/comores/domingos/dominica/domínica/etrúria/fidji/fiji/indonesia/indonésia/kiribati/kiribati/kiribáti/maldivas/mauricia/maurícia/maurícias/maurício/palau/quiribati/quiribáti/sri-lanka/timor-leste/tonga/turcomenistão/turquemenistão/turquia/tuvalu/ucrania/ucránia/ucrânia/urss/vanuatu/austrália/barbados/chipre/cuba/filipinas/granada/haiti/israel/jamaica/malta/micronésia/nauru/samoa/seicheles/seychelles/rússia/rússia
pedagogo	comenius/willard
período	califados/mesolítico/neolítico/neolítico/paleolítico/califado
planeta	hésperos/vénus/vênus
poeta	catulo/gilberto/goethe/hesiodo/hesíodo/homero/horacio/horácio/hugo/lucrécio/marcial/ovidio/ovídio/pindaro/pope/píndaro/virgílio/gray
poetas	catulo/gilberto/goethe/hesiodo/hesíodo/homero/horacio/horácio/hugo/lucrécio/marcial/ovidio/ovídio/pindaro/pope/píndaro/virgílio/gray
poetisa	catulo/gilberto/goethe/hesiodo/hesíodo/homero/horacio/horácio/hugo/lucrécio/marcial/ovidio/ovídio/pindaro/pope/píndaro/virgílio/gray
porto	acapulco/adem/aden/alborg/alexandria/annaba/antofagasta/antuerpia/antuérpia/antália/argel/arhus/assunção/auckland/auclanda/bacu/baku/baltimore/bancoc/banguecoque/banjul/barcelona/barranquilla/baçora/baçorá/beira/bengasi/bergen/bordeaux/bremerhaven/bridgetown/brindisi/bristol/brístol/calais/calé/cannes/cartagena/casablanca/castries/cesareia/chicago/chittagong/cidadedocabo/conacri/corinto/cork/corínto/cotonou/cumaná/cádis/dakar/dalian/dar-es-salaam/detroit/doha/dubai/dublim/dublin/dubrovnik/durban/durrës/freetown/galway/gante/glasgow/gotemburgo/haifa/haiphong/hamburg/hamburgo/hanóver/hanôver/helsinque/helsínque/helsínquia/hiroshima/hobart/hobart/hong-kong/hongkong/honolulu/houston/hull/incheon/jaffa/jidá/kobe/kōbe/lagos/lataquia/limerick/lisboa/liverpool/lobito/luanda/malaga/malmö/maracaibo/maracaíbo/mariehamn/marselha/mascate/mazatlán/maçuá/messina/mobile/mogadiscio/mogadíscio/mombaça/monrovia/monróvia/moulmein/murmansk/málaga/nagasaki/nantes/nápoles/orã/osaka/oslo/palermo/paramaribo/patras/pátras/ragusa/recife/reiquijavique/reykjavik/reykjavík/riga/rīga/salonica/salónica/salônica/santos/savannah/semarang/setubal/setúbal/sevilha/sousse/stabroek/stavanger/sunderland/swansea/tallinn/tampico/tiro/toulon/trondheim/tunes/túnis/valparaíso/varna/veracruz/victoria/waterford/xangai/yokohama/áden/ålborg/århus/belém/bordéus/cairo/cantão/djibouti/djibuti/dunquerque/hamilton/jibuti/newport/odessa/portsmouth/portsmouth/trípoli/vancouver/acre/charleston/maryland/alabama/texas
povoado	aberdare/abidos/agrigento/antioquia/anzio/asheville/avinhão/bangor/bartlesville/bath/bellingham/bemidji/blackpool/boulder/brunsvique/calais/calé/cantuária/chalkedon/champaign/chartres/cnossos/columbia/columbo/cusco/decatur/dhahran/dubuque/enid/entebbe/eureka/fredericksburg/frederico/galveston/gettysburg/greenville/hamelin/hastings/hays/hershey/hipona/hohenlinden/interlaken/ithaca/jalalabad/kalamazoo/kennewick/lafayette/laramie/lawrence/lewiston/lufkin/mansfield/mariehamn/marquette/maçuá/mcallen/mcallen/medford/midland/moline/monterey/muskogee/natchez/nazaré/nogales/nyssa/ottumwa/pensacola/plateias/platéias/plymouth/plzen/plzeň/pocatello/princeton/reggane/rutland/salina/saqqara/sarasota/selma/skagway/stratford-upon-avon/stratford-upon-avon/sunderland/timgad/valdosta/vichy/waterloo/watertown/wausau/wilmington/yakima/yellowknife/áccio/âccio/belém/cairo/california/chablis/dunquerque/monroe/monroe/nome/paris/portsmouth/somerset/vancouver/acre/kansas
progenitora	maria
província	abecásia/assam/baviera/bihar/cabo/cabodaboaesperança/campeche/gansu/goa/guangdong/gujarat/hebei/hunan/karnataka/kosovo/manipur/orissa/sichuan/tabasco/tirol/transvaal/xinjiang/yunnan/bornéu/bósnia/chihuahua/guzerate/iucatã
proximidade	montmartre
região	acaia/andaluzia/arcádia/assiria/assíria/austria-hungria/bengala/bitínia/boémia/boêmia/brandemburgo/caldeia/caldéia/caledónia/caledônia/canaã/capadocia/capadócia/carolinas/carélia/caucaso/caxemira/chechénia/chechênia/checoslovaquia/checoslováquia/cisjordânia/cítia/cólquida/dalmacia/dalmácia/elam/extremo-oriente/fenícia/frígia/galicia/galileia/galiléia/galiza/galícia/gália/hejaz/ibéria/iliria/ilíria/impériobizantino/jonia/judeia/judéia/jónia/jônia/labrador/lacónia/lacônia/lancashire/lapónia/lapônia/levante/livonia/livónia/livônia/lusitania/lusitânia/lícia/lídia/magrebe/maharashtra/manchúria/mesoamérica/mesopotamia/mesopotâmia/montenegro/moravia/morávia/médio-oriente/normandia/noroeste/néjede/patagónia/patagônia/prussia/prússia/pártia/renânia/saxónia/saxônia/servia/siberia/sibéria/sikkim/silesia/silésia/siquim/sudeste/sudoeste/suméria/sérvia/tanganica/tcheco-eslováquia/tchecoslováquia/tessália/transcaucasia/transilvania/transilvânia/trácia/tule/turquestão/turíngia/ulster/witwatersrand/yorkshire/áustria-hungria/áustria-hungria/épiro/babilónia/babilônia/barbária/caribe/cáucaso/escandinávia/frísia/frísia/macedónia/macedônia/mongólia/núbia/sul/sudeste/norte
regiões	extremo-oriente
reino	numídia
relevo	america/américas/américa
rio	amur/angara/aqueronte/congo/cócito/danúbio/ebro/escalda/estige/eufrates/ganges/garona/isère/jordão/loire/meuse/mosa/murrumbidgee/nilo/orinoco/outaouais/paraná/parnaíba/ródano/sena/tejo/tibre/tigre/tâmisa/volga/vístula/yang-tsé/zambeze/alabama/amarelo/amazonas/arcansas/madeira/níger/otava/reno/suriname/colorado/colorado/delaware/kansas/ohio/tennessee/alabama
roque	torredeeiffel
santo	beda/benedito/inácio/john/mateus/nicolau/pedro/peter/simão/thomas/tiago/tomás/tomé/eduardo/eduardo
selva	sherwood
serra	alpes/andes/apalaches/apeninos/caracórum/cárpatos/himalaia/hindukush/indocuche/kunlun/montanhasrochosas/pamir/pireneus/pirenéus/pirineus/pirinéus/ródope/cáucaso
solo	america/américas/américa
século	califados/califado
sítio	latrão
tempo	califados/mesolítico/neolítico/neolítico/paleolítico/califado
terra	america/américas/baamas/bahamas/burkina-faso/cabo-verde/ceilão/comores/domingos/dominica/domínica/etrúria/fidji/fiji/indonesia/indonésia/kiribati/kiribati/kiribáti/maldivas/mauricia/maurícia/maurícias/maurício/palau/quiribati/quiribáti/sri-lanka/timor-leste/tonga/turcomenistão/turquemenistão/turquia/tuvalu/ucrania/ucránia/ucrânia/urss/vanuatu/américa/austrália/barbados/chipre/cuba/filipinas/granada/haiti/israel/jamaica/malta/micronésia/nauru/samoa/seicheles/seychelles/rússia/rússia
território	acádia/beócia/castela/catalunha/cataluña/darfur/kwazulu-natal/nunavut/sabá/sarawak/yukon/yukón/ática/aragão/acre/natal
torre	torredeeiffel
torres	torredeeiffel
vila	aberdare/abidos/agrigento/antioquia/anzio/asheville/avinhão/bangor/bartlesville/bath/bellingham/bemidji/blackpool/boulder/brunsvique/calais/calé/cantuária/chalkedon/champaign/chartres/cnossos/columbia/columbo/cusco/decatur/dhahran/dubuque/enid/entebbe/eureka/fredericksburg/frederico/galveston/gettysburg/greenville/hamelin/hastings/hays/hershey/hipona/hohenlinden/interlaken/ithaca/jalalabad/kalamazoo/kennewick/lafayette/laramie/lawrence/lewiston/lufkin/mansfield/mariehamn/marquette/maçuá/mcallen/mcallen/medford/midland/moline/monterey/muskogee/natchez/nazaré/nogales/nyssa/ottumwa/pensacola/plateias/platéias/plymouth/plzen/plzeň/pocatello/princeton/reggane/rutland/salina/saqqara/sarasota/selma/skagway/stratford-upon-avon/stratford-upon-avon/sunderland/timgad/valdosta/vichy/waterloo/watertown/wausau/wilmington/yakima/yellowknife/áccio/âccio/belém/cairo/california/chablis/dunquerque/monroe/monroe/nome/paris/portsmouth/somerset/vancouver/acre/kansas
vizinhança	bloomsbury/harlem/montmartre/soho/soho/wembley/hollywood
vizinho	montmartre
época	califados/eoceno/eoceno/holoceno/holocénico/mioceno/oligoceno/paleoceno/pleistoceno/pleistocénico/plioceno/califado

