abarcar	apresenta/dispõe
absolver	balizar/avaliar/julgar
acordar	capotar/sonecar/dormir/dormitar/cochilar
aderir	grudar/juntar
adiar	cancelar
administrar	aplicar/dar
adquirir	seleccionar/selecionar/pagar/escolher
agitar	segurar
alcançar	viajar/caminhar/ir/andar
alisar	esfregar
amadurecer	envelhecer
amarrar	fixar/prender
amputar	dividir/cortar
andar	caminhar
articular	proferir/verbalizar/conversar/falar/dizer
asfixiar	tampar/cobrir
atar	fixar/prender
atingir	seleccionar/selecionar/tentar/pagar/procurar/escolher
atrasar	cancelar
avionar	voar
bailar	caminhar/andar
brandir	segurar
brigar	competir/concorrer
cair	destilar/condensar
calotear	iludir/lograr/enganar
caminhar	andar
carregar	deslocar/mover/mexer/deslocar/mover
castigar	aproximar/adivinhar/chutar/estimar/avaliar/julgar
cauterizar	esturricar
cevar	alimentar
chamar	discar
chegar	viajar/caminhar/ir/andar
chutar	deslocar/mover
classificar	comparar
colar	grudar/juntar
comer	deglutir/ingurgitar/mastigar/mascar/engolir
comerciar	comprar/vender/obter/adquirir/atingir
compor	grafar/soletrar/escrever
comprar	seleccionar/selecionar/pagar/escolher
congelar	solidificar
conseguir	tentar/procurar
conter	apresenta/dispõe
dançar	caminhar/andar
decidir	deliberar/debater
defender	brigar/disputar/lutar
defraudar	iludir/lograr/enganar
delongar	cancelar
despender	gastar/consumir
desperdiçar	gastar/consumir
despertar	capotar/sonecar/dormir/dormitar/cochilar
diferenciar	comparar
dirigir	ir
dispensar	aplicar/dar
disputar	competir/concorrer
dissipar	gastar/consumir
distinguir	comparar
dizer	proferir/verbalizar/conversar/falar
empurrar	prensar/deslocar/mover/pressionar/apertar/mexer
engordar	alimentar
enunciar	proferir/verbalizar/conversar/falar/dizer
escavar	cavar
escrever	grafar/soletrar
escutar	ouvir/sentir
esfregar	tocar/bater
esgotar	gastar/consumir
estrangular	comprimir/contrair
examinar	mirar/observar/olhar/ver
exercer	trabalhar
exercitar	deslocar/mover/mexer
falar	proferir/verbalizar/conversar/dizer
forçar	prensar/deslocar/mover/pressionar/apertar/mexer
fumar	expirar/inalar/inspirar/exalar
furar	dividir/cortar
gastar	consumir
identificar	classificar
incluir	apresenta/dispõe
inocentar	balizar/avaliar/julgar
inspecionar	mirar/observar/olhar/ver
ir	caminhar/andar
levantar	levantar-se
levantar-se	capotar/sonecar/dormir/dormitar/cochilar
lixar	esfregar
lustrar	esfregar
lutar	competir/concorrer
malhar	deslocar/mover/mexer
mexer	segurar
minar	cavar
minerar	cavar
mirar	enxergar/olhar/ver
observar	enxergar/olhar/ver
obter	seleccionar/selecionar/pagar/escolher
olhar	enxergar/ver
ouvir	escutar/sentir
papar	deglutir/ingurgitar/mastigar/mascar/engolir
parir	engravidar/conceber
penalizar	aproximar/adivinhar/chutar/estimar/avaliar/julgar
perfurar	dividir/cortar
pilotar	voar
polir	esfregar
pospor	cancelar
postergar	cancelar
praticar	trabalhar
precipitar	destilar/condensar
procrastinar	cancelar
pronunciar	proferir/verbalizar/conversar/falar/dizer
prorrogar	cancelar
protelar	cancelar
punir	aproximar/adivinhar/chutar/estimar/avaliar/julgar
queimar	esturricar
ranger	esfregar
reconhecer	conhecer
resolver	deliberar/debater/raciocinar
sentar	assentar-se/sentar-se/assentar
sentar-se	assentar-se/assentar/sentar
separar	comparar
solucionar	raciocinar
sonhar	capotar/sonecar/dormir/dormitar/cochilar
suceder	tentar/procurar
sufocar	tampar/cobrir
telefonar	discar
ter	engravidar/conceber
transferir	deslocar/mover
trapacear	iludir/lograr/enganar
vender	entregar/dar
ver	enxergar/olhar/mirar/observar/olhar
viver	existir/ser

