aliança	aliado
associação	associado
audiências	auditor/ouvinte/aluno
baralho	naipe/carta/dama
biologia	flora/vegetação/fauna/zoologia
biota	flora/vegetação/fauna/zoologia
bosque	árvore
burguesia	burguesa/burguês
casal	cónjuge/consorte/cônjuge/esposa/esposo/marido/companheiro
casamento	cónjuge/consorte/cônjuge/esposa/esposo/marido/companheiro
cavalo	potro
classe	arenavirus/arenavírus/bunyaviridae/flaviviridae/gênero/rhabdovirus/rhabdovírus/flavivírus/tribo/gênero/género
clero	pároco/sacerdote/clérigo/pastor
clã	parente
coalizão	aliado
coligação	aliado
colégio	mestre/professor
comissão	comissário
comité	comissário
comitê	comissário
companhia	elenco/pelotão
corpo	milícia/tropas/exército
corte	júri/júri
cosmo	galáxia/nebulosa
criação	galáxia/nebulosa
empresa	departamento/divisão
escola	mestre/professor
espécie	cepa/cepa/estirpe/estirpe/variante/variante/estirpe/estirpe/raça/raça
espécies	cepa/estirpe/variante/estirpe/raça
exército	caixilho/militar/corpo/corpo/corpo/corpo
familia	parente
família	genitor/parente/progenitor/pai/criança/filho/mãe/menino/arenavirus/arenavírus/bunyaviridae/flaviviridae/gênero/rhabdovirus/rhabdovírus/flavivírus/tribo/gênero/irmã/irmão/género
filo	espécies/espécies/classe/classe
floresta	árvore
fraternidade	frade/irmão
galera	plebeu
galáxia	estrela
gangue	gangster/gângster/bandido/marginal
gente	alguém/cidadã/cidadão/indivíduo/alma/pessoa/plebeu/súdito/audiência/cidadão/espectador
grupo	livro
homem	população/gente/pessoal/povo
homens	time/equipe/partida
humanidade	população/gente/pessoal/povo
irmandade	frade/irmão
jogo	livro
juizado	júri/júri
junta	comissário
júri	jurado/jurado/juror/juror
lei	policial/polícia/agente/guarda
mata	árvore
mitologia	mito/mito/lenda/lenda
mundo	galáxia/nebulosa/população/gente/pessoal/povo/audiência/espectador
mão-de-obra	time/equipe/partida
nação	província/estado/plebeu/súdito/cidadão/departamento
nebulosa	estrela
ordem	associado/frade/irmão
organização	associado/quorum/quórum/associação
ouvintes	auditor/ouvinte/aluno
país	província/estado/departamento
pessoal	alguém/elenco/indivíduo/alma/pessoa/plebeu
polícia	policial/agente/guarda
população	alguém/cidadã/cidadão/indivíduo/alma/pessoa
povo	alguém/cidadã/cidadão/indivíduo/alma/população/gente/pessoa/pessoal/plebeu/súdito/audiência/cidadão/espectador
público	auditor/ouvinte/aluno
quadrilha	gangster/gângster/bandido/marginal
sociedade	associado
tabela	coluna/bicha/linha
terra	província/estado/departamento
tribo	parente
tribunal	júri/júri
tripulação	equipagem/equipe
universo	galáxia/nebulosa
união	associado
vulgo	plebeu
égua	potro

