abelha	apoidea
aeronave	frota
aeroplano	frota
agente	polícia/lei
algodão	algodoeiro/gossypium
alguém	população/gente/pessoal/povo
alma	população/gente/pessoal/povo
anho	ovis
associado	associação/sociedade/união/organização/ordem
associação	organização
audiência	mundo/gente/povo
automotora	caminhos-de-ferro/locomotivas/trem/comboio
automóvel	caminhos-de-ferro/locomotivas/trem/comboio
ave	aves
avião	frota
barco	frota
bezerro	vacas/bovinos/gado
canídeo	canídeos
caracter	alfabeto
caractér	alfabeto
carneiro	grei/manada/rebanho/gado/ovis
carnívoro	carnivora/carnívoros
carro	caminhos-de-ferro/locomotivas/trem/comboio
carácter	alfabeto
cavalo	equus
celenterados	cnidarios/cnidários
cidadã	população/gente/povo
cidadão	nação/população/gente/povo
classe	ordem
comboio	caminhos-de-ferro/locomotivas/trem
companheiro	casal/casamento
companhia	batalhão
consorte	casal/casamento
cordeiro	ovis
corpo	exército/exército
criança	família
cão	canídeos
cónjuge	casal/casamento
cônjuge	casal/casamento
dente	dentama/dentição/dentadura
dentes	dentama/dentição/dentadura
departamento	autoridades/regime/governo/empresa
divisão	autoridades/regime/governo/empresa/corpo
embarcação	frota
equino	equidae/equídeos
equinodermo	equinoderme/equinodermes
equinodermos	equinoderme/equinodermes
equipe	homens/mão-de-obra
equídeo	equidae/equídeos
erva	poaceae
ervas	poaceae
espectador	mundo/gente/povo
espirito	oculto/sobrenatural/ocultismo
esposa	casal/casamento
esposo	casal/casamento
espécie	gênero/género
espécies	gênero/género
estado	país/nação/terra
estrela	constelação/galáxia/nebulosa
família	ordem
filho	família
filo	reino
flora	biota/biologia/plantae
frota	armada/marinha
fungo	fungi/fungos
fungos	fungi
galáxia	cosmo/universo/mundo/criação
genitor	família
gente	humanidade/mundo/homem/povo
gramínea	poaceae
gramíneas	poaceae
guarda	polícia/lei
hemípteros	enxame/nuvem
himenópteros	hymenoptera
hominídeo	hominidae
ilha	arquipélago
indivíduo	população/gente/pessoal/povo
insecto	enxame/nuvem
insectos	enxame/nuvem
inseto	enxame/nuvem
insetos	enxame/nuvem
irmã	sororidade
júri	juizado/tribunal/corte
lagarta	lepidoptera
larva	lepidoptera
legislatura	autoridades/regime/governo
leitão	dela/seu
letra	alfabeto
locomotiva	caminhos-de-ferro/locomotivas/trem/comboio
locomotivas	caminhos-de-ferro/trem/comboio
mamífero	placentalia/placentários
marido	casal/casamento
menino	família
militar	exército
molusco	moluscos
moluscos	molusco
máquina	caminhos-de-ferro/locomotivas/trem/comboio
mãe	família
navio	frota
navios	frota
nebulosa	cosmo/universo/mundo/criação
número	série
ouriço-do-mar	echinoidea
ovelha	grei/manada/rebanho/gado/ovis
ovinos	grei/manada/rebanho/gado/ovis
pai	família
parente	clã/familia/tribo/família
partida	homens/mão-de-obra
peixe	cardume
pessoa	população/gente/pessoal/povo
pessoal	humanidade/mundo/homem/povo
planta	plantae
policial	polícia/lei
polícia	lei
população	humanidade/mundo/homem/povo
porquinho	dela/seu
potro	égua/cavalo
povo	humanidade/mundo/homem
primata	primatas
progenitor	família
protozoário	protozoários
província	país/nação/terra
pássaro	aves
ruminante	ruminantia
ruminantes	ruminantia
soror	sororidade
súdito	nação/gente/povo
taxi	frota
terneiro	vacas/bovinos/gado
time	homens/mão-de-obra
trem	caminhos-de-ferro/locomotivas/comboio
táxi	frota
ungulados	equidae/equídeos
vagão	caminhos-de-ferro/locomotivas/trem/comboio
vagões	caminhos-de-ferro/locomotivas/trem/comboio
vegetal	plantae
vegetação	biota/biologia
vertebrado	craniata
vespa	apoidea
vitelo	vacas/bovinos/gado
voto	eleitorado
árvore	bosque/mata/floresta
égua	equus
