abdome	umbigo
abdómen	umbigo
abdômen	umbigo
agulha	buraco
alguém	temperamento/personalidade/pessoa
alma	temperamento/personalidade/pessoa
animal	cabeça/face/rosto/cara
anjo	ala/asa
ano	sazão/estação/tempo/período/mês
aposento	assoalho/muro/pavimento/piso/chão/parede/cozinha/banheiro
arena	gramado/campo
arma	armamento
armamento	arma
auto	guarda-lama/fenestra/janela
automóvel	guarda-lama/fenestra/janela
ave	ala/asa
banheiro	banheira
barriga	umbigo
batalha	porrada/golpe
besta	cabeça/face/rosto/cara
bicho	cabeça/face/rosto/cara
boca	língua
brocha	taramela/trinco/alça/cabo
cabeça	têmpora/face/rosto/cara
calculadora	hardware
cama	colchão
caminho	curva
cara	bochecha/chinchilla/mento/testa/queixo/traço/boca
carro	guarda-lama/fenestra/janela
carta	melodia/linha
casa	mansarda/trapeira/sótão/ático/cozinha/banheiro/alpendre/orquestra/biblioteca
centúria	decênio/década
colarinho	gola
combate	porrada/golpe
comercialismo	transportação/transporte/expedição
computador	hardware
comércio	transportação/transporte/expedição
copo	vidro
corpo	abdome/abdômen/bumbum/popô/torso/bunda/estômago/nádegas/ombro/seio/ventre/abdómen/ânus/peito/cabeça/tronco/barriga/rabo/traseiro/fundilhos/nalga/nádega/bunda/anca/costas/banda/perna/traseiro
correio	missiva/carta
cosmo	astro/estrela
criatura	cabeça/face/rosto/cara
criação	astro/estrela
céu	arco-íris/nuvem
decênio	ano
dia	manhã/noitada/tarde/hora/noite/meio-dia/jornada
discurso	conclusão
disputa	porrada/golpe
doença	sintoma
doenças	sintoma
domicílio	cozinha/banheiro
década	ano
economia	setor
edifício	calefacção/aposento/aquecimento/calefação/muro/pavimento/piso/parede/telhado/anexo/asa/teto/quarto/sala/andar/alicerce/recanto/rincão/fenestra/quina/janela/canto/pé/base
edição	texto/arte/gráfico/ilustração/desenho
elevação	declive/declives/subida/encosta/costa/ladeira
episódio	incidente/evento
erva	verdura/hortaliça/legume/vegetal
escova	taramela/trinco/alça/cabo
esporte	rodada/manobra/turno/jogo/tempo
estrada	curva
estrutura	alicerce/pé/base
estádio	gramado/campo
estômago	umbigo
face	bochecha/chinchilla/mento/testa/queixo/traço/boca
faringe	língua
flora	fragmento/parte
fungo	chapéu
fungos	chapéu
futebol	metade
garganta	língua
guerra	combate/batalha/luta
habitação	mansarda/trapeira/sótão/ático/cozinha/banheiro/alpendre/biblioteca
hemípteros	ala/asa
hora	min/minuto
humano	face/rosto/cara/lombo
igreja	abside/ábside
igrejas	abside/ábside
indivíduo	temperamento/personalidade/pessoa
infra-estrutura	água
infraestructura	água
infraestrutura	água
insecto	ala/asa
insectos	ala/asa
inseto	ala/asa
insetos	ala/asa
jogo	metade/turno
jornada	manhã/etapa/parada
jurisprudência	leis/lei
lar	cozinha/banheiro
lei	leis
leito	colchão
lista	item
listagem	item
luta	porrada/golpe
mercado	industria/empresa/negócio/comércio
mercantilismo	transportação/transporte/expedição
mesa	louça
min	sec/s/segundo
minuto	sec/s/segundo
missiva	melodia/linha
molécula	átomo/radical/cadeia
morada	cozinha/banheiro
moradia	cozinha/banheiro
mundo	chão/hemisfério/relevo/céu/solo/terra/astro/estrela
munição	armamento/arma
mês	semana
natureza	característica/qualidade
nação	domínio
organismo	célula/anatomia
ovo	casca
palavra	sílaba
país	domínio
peito	colo/tórax
peixe	aleta/barbatana
pele	ruga/sulco
peleja	porrada/golpe
perna	maléolo/tornozelo/artelho/joelho/canela
personalidade	feição/peculiaridade/índole/caráter/natureza
pessoa	feição/peculiaridade/temperamento/personalidade/índole/caráter/natureza/personalidade
pincel	taramela/trinco/alça/cabo
planta	fragmento/parte
ponte	arco
prato	molho/ingrediente
programa	meta/alvo/objectivo/intenção/sub-rotina/subrotina/procedimento/função
prédio	calefacção/aposento/aquecimento/calefação/muro/pavimento/piso/parede/telhado/anexo/asa/teto/quarto/sala/andar/recanto/rincão/fenestra/quina/janela/canto
publicação	texto/arte/gráfico/ilustração/desenho
pugna	porrada/golpe
pássaro	ala/asa
quarto	assoalho/muro/pavimento/piso/chão/parede
refeição	porção/prato
repasto	porção/prato
residência	cozinha/banheiro
rodada	metade/turno/jogo
rodovia	curva
rosto	bochecha/chinchilla/mento/testa/queixo/traço/boca
roupa	algibeira/bolso/colarinho
sala	assoalho/muro/pavimento/piso/chão/parede
seio	colo/tórax/peito
semana	dia
ser	célula/cabeça/anatomia/face/rosto/cara
shopping	mercadoria/produto/artigo
sociedade	estrato/classe/setor
superfície	água/vão/fenda
século	decênio/década
séculos	decênio/década
teatro	orquestra
tecido	alicerce/pé/base
temperamento	feição/peculiaridade/índole/caráter/natureza/personalidade
templo	abside/ábside
tempo	metade/turno/jogo
teoria	possibilidade/suposição/hipótese/lei
termo	sílaba
terra	chão/hemisfério/relevo/céu/solo/domínio
todo	segmento/seção/porção/parte
torso	abdome/abdômen/bumbum/popô/bunda/estômago/nádegas/ombro/seio/ventre/abdómen/ânus/peito/tronco/barriga/rabo/traseiro/fundilhos/nalga/nádega/bunda/anca/costas/banda/traseiro
totalidade	componente
tratamento	terapia/medicamento/remédio
tronco	abdome/abdômen/bumbum/popô/bunda/estômago/nádegas/ombro/seio/ventre/abdómen/ânus/peito/barriga/rabo/traseiro/fundilhos/nalga/nádega/bunda/umbigo/anca/costas/banda/traseiro
turno	metade/jogo
ungulados	casco/pezunho/casco/pata
unidade	segmento/seção/tomo/secção/porção/pedaço/parte
universo	astro/estrela
vegetal	fragmento/parte
ventre	umbigo
verbo	sílaba
vertebrado	seio/cauda/peito/rabo/traseiro/dígito/dedo
vestuário	algibeira/bolso/colarinho
veículo	guarda-lama/fenestra/janela
via	curva
viagem	etapa/parada
viatura	guarda-lama/fenestra/janela
vida	idade/época/passado/período
vivenda	mansarda/trapeira/sótão/ático/alpendre/biblioteca
vocábulo	sílaba
