abalroar	naufragar/afundar
abandonar	olvidar/esquecer
abarcar	endereçar/lidar/tratar/falar/cobrir
abnegar	negar
abster	negar
acabar	perecer/falecer/expirar/morrer
acatar	esposar/adoptar/adotar
aceitar	admitir/admitir/receber
acender	cozinhar/preparar/arrumar/organizar
acertar	colidir/atingir/bater
achar	re-adquirir/reconquistar/reganhar/recuperar/descobrir/encontrar/reganhar/determinar/compreender/encontrar/entender
acompanhar	caminhar/ir/andar
acontecer	calhar/ocorrer/tornar/suceder/virar/mudar
actuar	atuar/representar/fazer
aderir	grudar/colar/colar
adicionar	acrescer/somar/acrescentar
admitir	aceitar/possibilitar/providenciar/proporcionar/fornecer/permitir/aceitar/deixar
admoestar	alertar/avisar/advertir
adquirir	auferir/ganhar/incorrer/comprar/desenvolver/obter/receber
advertir	alertar/avisar
aerotransportar	avionar/pilotar/voar
afigurar	perceber/realizar/compreender/entender
afirmar	contar/falar/dizer/reivindicar/reclamar/julgar/considerar/manter
afluir	encostar/tocar
afundar	naufragar/largar/soltar/abalroar/submergir
agarrar	apanhar/capturar
agasalhar	vestir-se/arrumar-se/vestir
agitar	bater
agredir	assaltar/atacar
aguardar	antecipar
aguentar	sofrer
ajudar	servir/dar/servir
alastrar	circular/espalhar
alcançar	vir/chegar
aleitar	sugar/chupar
amamentar	sugar/chupar
andar	caminhar/ir/cavalgar/deslocar/mover/montar/viajar/ir
antecipar	aguardar/esperar
apanhar	agarrar/segurar
aparelhar	vestir-se/arrumar-se/vestir
aperfeiçoar	melhorar
apostar	jogar
aprender	determinar/achar
apresenta	ter/fruir/possuir/ter
arrumar-se	vestir-se/vestir
asfixiar	sufocar
assentar	sentar-se/sentar
assentar-se	sentar-se/sentar
assinalar	distinguir/diferenciar
assistir	enxergar/olhar/ver/servir
atacar	tirotear/assaltar/comover/afetar/impressionar/parecer/atirar/atingir
atingir	comover/golpear/acertar/afetar/comprar/impressionar/parecer/bater
atirar	tirotear/balear
atravessar	voar/avionar/vassourar/pilotar/varrer/encostar/voar
atribuir	imputar
atuar	comportar-se/agir/parecer/representar/fazer
aturar	sofrer
auferir	conquistar/adquirir/fazer
avaliar	medir/estimar
averiguar	determinar/achar
avionar	aerotransportar/voar
avisar	alertar/advertir
bailar	dançar
balancear	equilibrar/compensar
balançar	sacudir
balear	tirotear/atirar
bater	colidir/atingir/golpear/palpitar/acertar/pulsar/agitar
beber	tomar
beijar	foder/pinar/copular/meter/transar/trepar/montar/comer
brincar	atuar/representar/fazer
caber	incluir/compreender/conter/ter
cair	largar/soltar/tombar/precipitar
calcinar	incinerar/queimar
caminhar	ir/andar/deslocar/mover
capturar	agarrar/segurar
carregar	transportar/levar/parir/ter
casar	casar-se/esposar/juntar
causar	prover/dar
cerrar	fechar
chamar	convocar/organizar
checar	conferir
chegar	acercar/avizinhar/vir
chorar	choramingar
circundar	endereçar/lidar/tratar/falar/cobrir
cobrir	tampar/tratar
colapsar	desistir/abandonar
colar	aderir/grudar/aderir
colidir	golpear/acertar/bater
colocar	jogar
combinar	harmonizar/caber/compatibilizar/ajustar/concordar
comer	papar
começar	principiar/iniciar
compatibilizar	corresponder/combinar/concordar
competir	equiparar/igualar
comprar	obter/adquirir/atingir/incorrer/obter/receber
compreender	endereçar/lidar/tratar/perceber/realizar/falar/entender/cobrir/afigurar/envisionar/figurar/visualizar/considerar/achar/ver
conceder	consentir/permitir/deixar
concordar	corresponder/combinar/harmonizar/compatibilizar/acordar
conduzir	ir/exprimir/transmitir
conformar	esposar/adoptar/adotar
confundir	disconcertar
congelar	gelar
conquistar	auferir/ganhar
consentir	outorgar/permitir/conceder/dar
conservar	preservar
considerar	compreender/entender
constatar	determinar/achar
construir	educar/instruir/preparar/treinar/criar/fazer
conter	endereçar/incluir/lidar/tratar/compreender/ter/falar/cobrir
continuar	progredir/avançar/prosseguir/permanecer/seguir/ir
contrair	padecer/ter
convergir	encostar/tocar
converter	transmudar/transformar
convocar	organizar
corresponder	harmonizar/compatibilizar/concordar
crescer	desenvolver/adquirir
criar	fazer
cultivar	amassar/trabalhar
cumprimentar	denominar/chamar/nomear
dançar	bailar
dar	devotar/legar/dedicar/consagrar/comprometer/consentir/permitir/deixar/entregar/passar/prover/causar/ajudar/transmitir/provocar/servir
declarar	contar/falar/dizer
deixar	legar/entregar/passar/dar/olvidar/esquecer/outorgar/permitir/conceder/transmitir/dar
delinear	desenhar
demandar	custar
derrubar	virar
desabar	desistir/abandonar
desaconselhar	alertar/avisar/advertir
descobrir	achar/determinar/achar
desdobrar	esticar/estender
desenhar	traçar/delinear
desenvolver	educar/instruir/preparar/treinar/progredir/adquirir
deslocar	viajar/caminhar/ir/andar
desmoronar	romper/quebrar/desistir/abandonar
desperdiçar	torrar
destruir	arruinar
detectar	descobrir/achar
determinar	descobrir/achar
difundir	circular/espalhar
diminuir	reduzir
disparar	tirotear/atirar
disputar	jogar
dispõe	ter/fruir/possuir/ter
disseminar	circular/espalhar
dividir	romper/quebrar
dizer	ler/contar/falar
dizimar	aniquilar/devastar/massacrar/erradicar
embalar	balançar/sacudir
embarcar	vir/chegar
emprenhar	engravidar
empurrar	forçar/afugentar/desvanecer/rechaçar/afastar/tocar
encapar	tampar/cobrir
encontrar	re-adquirir/reconquistar/reganhar/recuperar/reganhar/encostar/achar/tocar
encostar	roçar/raspar/varrer/atravessar
endereçar	denominar/chamar/tratar/nomear
enfileirar	correr/passar
enfronhar	tampar/cobrir
englobar	endereçar/lidar/tratar/falar/cobrir
enrolar	disconcertar/confundir
entender	afigurar/envisionar/figurar/visualizar/considerar/achar/ver
entregar	transmitir/dar
envisionar	perceber/realizar/compreender/entender
equilibrar	balancear/compensar
equilibrar-se	balancear/equilibrar/compensar
erguer	levantar
errar	vadiar/vagabundear/vaguear/perambular/vagar
escovar	varrer
escrever	redigir/compor
espalhar	circular
esperar	antecipar/parir/ter
estender	extender/prorrogar/prolongar/desdobrar/esticar
estimar	medir/avaliar
estimular	comover/afetar/impressionar/parecer
estrangular	asfixiar/sufocar
etiquetar	marcar
executar	tocar/cumprir/efetuar/realizar/atingir
exercitar	malhar
exigir	custar
extrair	resgatar/retirar/sacar/tirar
falar	tratar
falhar	perecer/falecer/expirar/morrer
familiarizar	introduzir/apresentar
fascinar	centrar/concentrar/focar
fazer	auferir/cozinhar/ganhar/preparar/conquistar/atuar/arrumar/organizar/adquirir/criar/representar
fechar	cerrar
figurar	perceber/realizar/compreender/entender
filmar	fotografar
fincar	martelar/forjar
fingir	comportar-se/agir/atuar/parecer/atuar/representar/fazer
flutuar	boiar/nadar/vagar
forjar	trabalhar
formar	trabalhar
formular	desenvolver/adquirir
forrar	revestir
forçar	arredar/puxar/tirar
fotografar	filmar
fruir	apresenta/dispõe
funcionar	operar/servir
ganhar	convencer/persuadir/conquistar/desenvolver/adquirir/fazer
gelar	congelar
gerar	desenvolver/adquirir
girar	virar-se/tornar-se/virar/revolver/revirar/rodar
golpear	colidir/atingir/bater
grudar	aderir/colar
guardar	reter/segurar/manter
harmonizar	corresponder/combinar/concordar
igualar	equiparar
impulsionar	forçar
incentivar	comover/afetar/impressionar/parecer
incinerar	queimar
incorrer	comprar/obter/adquirir/receber
indagar	questionar/perguntar
informar	introduzir/apresentar
intencionar	denotar/significar
inter-relacionar	relacionar
inter-relatar	inter-relacionar/relacionar
interessar	centrar/concentrar/focar
ir	sair/partir/deixar/cavalgar/largar/deslocar/mover/montar/viajar/sair/partir/abandonar/deixar/andar
justiçar	executar
lactar	sugar/chupar
largar	cair
lavar-se	lavar
legar	transmitir/dar
ler	proclamar/compreender/entender
levantar	erguer
levar	caminhar/ir/andar/convencer/persuadir/gastar/consumir
lidar	tratar
limpar	lavar-se/lavar/desobstruir
lucrar	auferir/ganhar
malhar	exercitar
manchar	derreter/fundir
manter	progredir/avançar/prosseguir/permanecer/julgar/continuar/seguir/considerar/ir
marcar	etiquetar/rotular
martelar	forjar
melhorar	aperfeiçoar/educar/instruir/preparar/treinar
mergulhar	focar
modelar	trabalhar
moldar	trabalhar
morrer	perecer/falecer/expirar
motivar	comover/afetar/impressionar/parecer
mover	viajar/caminhar/ir/andar
mudar	converter/tornar/substituir/trocar/virar
naufragar	abalroar/submergir/afundar
noticiar	introduzir/apresentar
notificar	introduzir/apresentar
observar	descobrir/achar
obter	comprar/adquirir/receber/incorrer/comprar/receber
ocupar	gastar/consumir
olhar	reter/guardar/segurar/manter
organizar	convocar/chamar
outorgar	consentir/permitir/deixar
padecer	contrair/sofrer/ter
pagar	pegar
papar	comer
partir	sair/deixar/largar/sair/abandonar/deixar
passar	transmitir/dar
passear	vadiar/vagabundear/vaguear/errar/perambular/vagar/caminhar/ir/andar/perambular/vagar/ir
pedir	solicitar/requerer
pegar	vir/chegar
perceber	afigurar/envisionar/figurar/visualizar/ver
perguntar	indagar/questionar
permitir	consentir/admitir/deixar/possibilitar/providenciar/proporcionar/fornecer/outorgar/conceder/deixar/dar
perplexar	disconcertar/confundir
perseverar	subsistir/existir/sobreviver/viver
pilotar	aerotransportar/voar
posar	sentar-se/sentar
possuir	apresenta/dispõe
precisar	custar
preparar	educar/instruir/treinar
preparar-se	educar/instruir/preparar/treinar
preservar	progredir/avançar/prosseguir/permanecer/continuar/seguir/ir
prevenir	alertar/avisar/advertir
proclamar	ler
produzir	criar/fazer
propulsar	comover/afetar/impressionar/parecer
prover	causar/provocar/dar
provocar	comover/prover/afetar/impressionar/parecer/dar
publicar	compor/escrever
pulsar	palpitar
puxar	arredar/tirar
pôr	sentar-se/sentar
quebrar	arruinar/desmoronar/desistir/destruir/abandonar/dividir/separar
queimar	carburar/combustir/conflagrar/incinerar/acender
questionar	indagar/perguntar
raspar	vassourar/varrer/encostar
re-adquirir	reganhar/encontrar/achar
realizar	afigurar/envisionar/figurar/visualizar/cumprir/efetuar/executar/atingir/ver
receber	comprar/obter/adquirir/topar/incorrer/obter/aceitar
reconquistar	reganhar/encontrar/achar
recuperar	convalescer/melhorar/reganhar/encontrar/achar
recusar	negar
reduzir	diminuir
reganhar	re-adquirir/reconquistar/recuperar/encontrar/encontrar/achar
reivindicar	reclamar
repetir	tocar
representar	atuar/fazer
requerer	custar/solicitar
requisitar	custar/solicitar/requerer
resistir	subsistir/existir/sobreviver/viver
restar	jazer
retirar	desobstruir/limpar
revelar	transmitir/dar
rivalizar	equiparar/igualar
rolar	revolver/revirar/rodar
romper	desmoronar/dividir/separar
rotular	marcar
roçar	vassourar/varrer/encostar
ruir	desistir/abandonar
saber	conhecer/entender
sacar	resgatar/retirar/tirar
sair	partir/deixar/largar/partir/abandonar/deixar
saturar	encher/carregar
seguir	espionar/esposar/adoptar/adotar/mirar/observar/guardar/olhar/ver
segurar	apanhar/capturar
semear	plantar
sentar	sentar-se/posar/sentar-se/pôr
sentar-se	sentar/posar/sentar/pôr
separar	romper/quebrar
servir	dar/exercer/funcionar/ajudar
simular	comportar-se/agir/atuar/parecer/atuar/representar/fazer
sobrepor	substituir
sobreviver	subsistir/existir/viver
sofrer	aturar/tolerar/aguentar/suportar/padecer/ter
solicitar	requerer
soltar	cair
submergir	naufragar/afundar
sufocar	asfixiar
suplantar	substituir
suportar	sofrer
tampar	cobrir
ter	apresenta/dispõe/padecer/contrair/sofrer
tirar	resgatar/retirar/sacar
tirotear	balear
tolerar	sofrer
tomar	beber
topar	receber
tornar-se	transmudar/converter/tornar/transformar/virar/mudar
trabalhar	moldar/forjar/modelar/amassar/formar
transformar	transmudar/converter/tornar/virar/mudar
transformar-se	tornar/virar/mudar
transmitir	legar/deixar/entregar/passar/dar/exprimir/circular/espalhar
tratar	endereçar/lidar/falar/cobrir
trazer	exprimir/transmitir
traçar	desenhar/espionar/mirar/observar/guardar/olhar/ver
treinar	educar/instruir/preparar/malhar/exercitar
tremer	palpitar/pulsar
usar	jogar
utilizar	jogar
vagar	vadiar/vagabundear/vaguear/errar/perambular
varrer	vassourar/roçar/raspar/encostar/atravessar
vassourar	roçar/raspar/varrer/atravessar
ver	enxergar/perceber/olhar/realizar/compreender/entender/determinar/compreender/entender/achar
verbalizar	proferir/conversar/falar/dizer
verificar	checar/conferir/determinar/achar
vestir	vestir-se/arrumar-se
viajar	ir/deslocar/mover/ir/andar
virar	revolver/revirar/encarar/rodar/tornar/derrubar/mudar
visualizar	perceber/realizar/compreender/entender/afigurar/envisionar/figurar/ver
voar	aerotransportar/avionar/pilotar
