abelha	apoidea
acompanhante	compromisso
aeronave	frota
aeroplano	frota
agente	polícia/lei
alguém	população/gente/pessoal/povo
aliado	coalizão/coligação/aliança
alma	população/gente/pessoal/povo
amante	seguidores
anho	ovis
anás	anatidae
aranha	aranhas
autocarro	frota
automotora	caminhos-de-ferro/locomotivas/trem/comboio
automóvel	caminhos-de-ferro/locomotivas/trem/comboio
ave	aves
avião	frota
açucena	lírio
batata	solanum
bezerro	vacas/bovinos/gado
bicha	tabela
bode	capra
bovinos	grei/manada/rebanho/gado/bos
bufo	coruja/strigiformes
cabra	capra
cabrito	capra
cachorro	matilha/canis
caracter	alfabeto
caractér	alfabeto
carneiro	grei/manada/rebanho/gado/ovis
carro	caminhos-de-ferro/locomotivas/trem/comboio
carvalho	quercus
carvalho-vermelho	carvalho/quercus
carácter	alfabeto
cavalo	equus
cepa	espécie/espécies/espécie
cidadã	população/gente/povo
cidadão	população/gente/povo
coluna	tabela
comboio	caminhos-de-ferro/locomotivas/trem
companheiro	casal/casamento
consorte	casal/casamento
constituintes	eleitorado
cordeiro	ovis
coruja	strigiformes
corujas	coruja/strigiformes
corujão	coruja/strigiformes
criança	família
cão	matilha/canis
cónjuge	casal/casamento
cônjuge	casal/casamento
dente	dentama/dentição/dentadura
dentes	dentama/dentição/dentadura
departamento	autoridades/regime/governo/empresa
director	junta/comité/comitê/conselho
diretor	junta/comité/comitê/conselho
divisão	autoridades/regime/governo/empresa/corpo
eleitor	eleitorado
eleitores	eleitorado
elenco	pessoal/companhia
equipagem	tripulação
equipe	tripulação
escola	universidade
esposa	casal/casamento
esposo	casal/casamento
espécie	gênero/género
espécies	gênero/género
estado	país/nação/terra
estirpe	espécie/espécies/espécie
estrige	coruja/strigiformes
faculdade	universidade
feminista	feminismo
ficante	compromisso
filho	família
flora	biota/biologia/plantae
gado	grei/manada/rebanho/bos
galáxia	cosmo/universo/mundo/criação
genitor	família
gente	humanidade/mundo/homem/povo
guarda	polícia/lei
hemípteros	enxame/nuvem
ilha	arquipélago
indivíduo	população/gente/pessoal/povo
insecto	enxame/nuvem
insectos	enxame/nuvem
inseto	enxame/nuvem
insetos	enxame/nuvem
instituto	universidade
júri	juizado/tribunal/corte
legislatura	autoridades/regime/governo
lenda	mitologia
leopardo	panthera
letra	alfabeto
leão	panthera
livro	jogo/grupo
loba	canis
lobo	canis
locomotiva	caminhos-de-ferro/locomotivas/trem/comboio
locomotivas	caminhos-de-ferro/trem/comboio
marido	casal/casamento
menino	família
mito	mitologia
mocho	coruja/strigiformes
máquina	caminhos-de-ferro/locomotivas/trem/comboio
mãe	família
nebulosa	cosmo/universo/mundo/criação
noiva	boda/casamento
onça	panthera
ovelha	grei/manada/rebanho/gado/ovis
ovinos	grei/manada/rebanho/gado/ovis
pai	família
palma	arecaceae/palmeira
palmeira	arecaceae
parceiro	sócios
parente	clã/familia/tribo/família
pata	anatidae
pato	anatidae
peixe	cardume
pessoa	população/gente/pessoal/povo
pessoal	humanidade/mundo/homem/povo
pimenta-do-reino	piper
pimenta-preta	piper
planta	plantae
policial	polícia/lei
polícia	lei
pomba	columbidae
pombo	columbidae
população	humanidade/mundo/homem/povo
porco	dela/seu
povo	humanidade/mundo/homem
progenitor	família
província	país/nação/terra
pássaro	aves
salmão	salmonidae
strigiformes	coruja
sus	dela/seu
suíno	dela/seu
sócio	sócios
taxi	frota
terneiro	vacas/bovinos/gado
tigre	panthera
topeira	talpidae/toupeira
toupeira	talpidae
trem	caminhos-de-ferro/locomotivas/comboio
táxi	frota
vacas	grei/manada/rebanho/gado/bos
vagão	caminhos-de-ferro/locomotivas/trem/comboio
vagões	caminhos-de-ferro/locomotivas/trem/comboio
variante	espécie/espécies/espécie
vegetal	plantae
vegetação	biota/biologia
vespa	apoidea
vitelo	vacas/bovinos/gado
votante	eleitorado
votantes	eleitorado
águia	accipitridae
águias	accipitridae
árvore	bosque/mata/floresta
égua	equus
ônibus	frota
