abc	plural
abecedário	plural
abecê	plural
acessório	plural
activos	plural
agarro	gíria/calão/jargão
algema	plural
algemas	plural
alicate	plural
alicates	plural
alka-seltzer	marca
amanhecer	metáfora
amostra	plural
antigos	plural
aparelhagem	plural
apartamento	plural
arauto	formalidade
argolas	plural
arquibancada	plural
arrasa-quarteirão	metáfora
asa	plural
asas	plural
assalto	gíria/calão/jargão
ativo	plural
ativos	plural
atos	plural
aurora	metáfora
autoridade	plural
aveia	plural
bairro	gíria/calão/jargão
baquelite	marca
barriga	gíria/calão/jargão
base	plural
bens	plural
bermuda	plural
besteira	gíria/indecência/vulgaridade/calão/jargão/obscenidade/palavrão
besteirol	gíria/calão/jargão
binóculo	plural
binóculos	plural
bolinho	metáfora
boquete	gíria/calão/jargão
borra	plural
bosta	indecência/vulgaridade/obscenidade/palavrão
boxers	plural
brunch	palavra-valise
cacete	indecência/vulgaridade/obscenidade/palavrão
cadafalso	plural
cadeia	gíria/calão/jargão
cagalhão	indecência/vulgaridade/obscenidade/palavrão
calcinha	plural
calças	plural
camuflagem	plural
canal	plural
cara	sinedoque/sinédoque/plural
cara-pálida	gíria/calão/jargão
caralho	indecência/vulgaridade/obscenidade/palavrão
casca	plural
castanhola	plural
ceroulas	plural
chaminé	sinedoque/sinédoque
chance	plural
chances	plural
chaparreira	plural
chefão	coloquialismo
chinês	gíria/calão/jargão
chupada	gíria/calão/jargão
chuteira	plural
chuteiras	plural
cientista	gíria/calão/jargão
classe	coloquialismo
cocô	indecência/vulgaridade/obscenidade/palavrão
coelhinho	coloquialismo
coisa	plural
coisas	plural
colina	plural
collant	plural
comida	plural
condição	plural
condições	plural
conexão	plural
confraria	plural
congratulação	plural
contratempos	plural
convés	plural
cor	plural
cores	plural
coroa	plural
couve-de-bruxelas	plural
crepusculo	metáfora
crédito	plural
cueca	plural
cuecao	coloquialismo/plural
cuecas	plural
culote	plural
cumprimento	plural
cuzão	gíria/calão/jargão
debate	plural
decoração	plural
deliberação	plural
depredação	plural
desejo	plural
desempregado	plural
devastação	plural
dimensão	coloquialismo
direito	plural
diversão	coloquialismo
divertimento	coloquialismo
duralumínio	marca
dívida	plural
entranhas	coloquialismo
escada	plural
escadas	plural
escavação	plural
esmola	plural
espevitadeira	plural
espólio	plural
estado	coloquialismo
estima	plural
eta	plural
excavação	plural
expiração	eufemismo
face	coloquialismo/sinedoque/sinédoque
farpa	plural
farrapos	plural
fedayin	plural
fedor	gíria/calão/jargão
feitos	plural
felicitação	plural
ferraria	plural
figurão	coloquialismo
firewall	coloquialismo
fisiognomia	coloquialismo
fisionomia	coloquialismo
focinho	coloquialismo
foda	gíria/indecência/vulgaridade/calão/jargão/obscenidade/palavrão
foguete	plural
fole	plural
folharada	gíria/calão/jargão
forca	plural
freon	marca
frisbee	marca
fufa	gíria/calão/jargão
fureca	coloquialismo
fórceps	plural
fósseis	coloquialismo
fóssil	coloquialismo
gabardine	plural
galhofa	coloquialismo
garota	gíria/calão/jargão
gente	plural
habitação	plural
heroísmo	plural
homem	coloquialismo
idiota	coloquialismo
intenção	plural
invar	marca
irmãos	plural
jeans	plural
jeba	indecência/vulgaridade/obscenidade/palavrão
jodpurs	plural
judeu	gíria/calão/jargão
kleenex	marca
lar	sinedoque/sinédoque
lavanderia	plural
lente	metáfora
leotard	plural
limites	plural
linux	marca
loteria	plural
luto	plural
mandachuva	coloquialismo
maneira	plural
mantimento	plural
matriz	plural
mecanismo	plural
meia	plural
meia-calça	plural
merda	indecência/vulgaridade/obscenidade/palavrão
metida	gíria/indecência/vulgaridade/calão/jargão/obscenidade/palavrão
mexerico	gíria/calão/jargão
michê	coloquialismo
mijo	indecência/vulgaridade/obscenidade/palavrão
mina	gíria/calão/jargão
mobiliário	plural
mobília	plural
modo	plural
moleza	metáfora
monopólio	marca
moradia	plural
mordida	gíria/calão/jargão
morte	eufemismo
motel	palavra-valise
mpeg	acrografia/acrograma/acrónimo/acrônimo/sigla
mulher	coloquialismo
máfia	coloquialismo
móvel	plural
nervo	plural
neutralização	eufemismo
nicromo	marca
nimby	acrografia/acrograma/acrónimo/acrônimo/sigla
noite	metáfora
obra	plural
obras	plural
obrigação	plural
olho	coloquialismo
ordem	plural
pais	plural
palco	plural
papo-furado	indecência/vulgaridade/obscenidade/palavrão
parabéns	plural
patoá	francês
patíbulo	plural
pau	indecência/vulgaridade/obscenidade/palavrão
pegador	plural
pentelho	gíria/calão/jargão
perneiras	plural
pessoal	plural
pica	indecência/vulgaridade/obscenidade/palavrão
picha	indecência/vulgaridade/obscenidade/palavrão
pilhagem	plural
pinto	indecência/vulgaridade/obscenidade/palavrão
pipi	indecência/vulgaridade/obscenidade/palavrão
piroca	indecência/vulgaridade/obscenidade/palavrão
plasticina	marca
pobres	plural
pobreza	plural
podadeira	plural
policial	coloquialismo
população	plural
povo	plural
povos	plural
presídio	gíria/calão/jargão
prisão	gíria/calão/jargão
profundeza	plural
pyrex	marca
pénis	indecência/vulgaridade/obscenidade/palavrão
pê	indecência/vulgaridade/obscenidade/palavrão
quadrado	coloquialismo
quartel	plural
quartos	plural
rabo	gíria/calão/jargão
raridade	plural
receptador	coloquialismo
recursos	plural
refeitorio	plural
relação	plural
relações	plural
reparação	plural
repolhos-de-bruxelas	plural
respeito	plural
resto	plural
reticência	plural
ribalta	plural
rico	plural
ricos	plural
rodada	plural
rola	indecência/vulgaridade/obscenidade/palavrão
rollerblade	marca
ronda	plural
rosto	coloquialismo/sinedoque/sinédoque
rudimentos	plural
sabichona	coloquialismo
sabichão	coloquialismo
salina	plural
sapatilha	plural
sapatão	gíria/calão/jargão
saudação	plural
scrabble	marca
secateurs	plural
sede	plural
serviços	plural
sexo	gíria/indecência/vulgaridade/calão/jargão/obscenidade/palavrão
short	plural
shorts	plural
smog	palavra-valise
soco-inglês	plural
soluço	plural
soqueira	plural
spam	marca
sunga	plural
superfície	plural
suspensório	plural
tarde	metáfora
teaser	coloquialismo
tecido	plural
telecomunicação	plural
telecomunicações	plural
tenaz	plural
termo	plural
tesoura	plural
tesão	coloquialismo
textos	plural
tira	coloquialismo
tolete	indecência/vulgaridade/obscenidade/palavrão
tom	plural
torquês	plural
tralha	plural
trepada	gíria/indecência/vulgaridade/calão/jargão/obscenidade/palavrão
tronco	plural
turno	plural
umma	plural
urina	indecência/vulgaridade/obscenidade/palavrão
vara	indecência/vulgaridade/obscenidade/palavrão
vaselina	marca
velcro	marca
verga	indecência/vulgaridade/obscenidade/palavrão
vizinhança	gíria/calão/jargão
vísceras	coloquialismo
wader	plural
walkman	marca
winchester	marca
windows	marca
workaholic	palavra-valise
xixi	indecência/vulgaridade/obscenidade/palavrão
ânus	gíria/calão/jargão
óculo	coloquialismo
óculos	plural
