alegria	feliz/contente/infeliz/triste
altitude	deprimido/alto
altivez	certo/incerto/inseguro
altura	deprimido/alto
ambição	ambicioso
animação	vivo/semvida/morto
aprumo	certo/incerto/inseguro
ascendência	maior
aspiração	ambicioso
asseio	sujado/suja/limpo/sujo
atitude	vertical
atividade	ativo/agencioso/inativo/ativo
beleza	feio/belo/formoso/lindo/bonito
capacidade	capaz
certeza	certo/incerto/inseguro
chance	impossível/possível
cheiro	inodoro
ciência	científica/científico
comercialismo	comercial
comércio	comercial
conforto	confortável/incómodo/desconfortável/incômodo
conhecimento	ciente/informado
consciência	ciente/informado
consternação	receoso/destemido
contorno	escuso/torto/reto
cor	colorido
criatividade	criador/criativo/original
crise	crítico
curso	extrovertido
desembaraço	certo/incerto/inseguro
diferença	diferente
dificuldade	intrincado/árduo/difícil
dimensão	grande/pequeno
disposição	relutante
distância	longe/vizinho/longínquo/perto/distante/próximo
efetividade	efetivo/eficaz/eficiente/inútil/vão
eficiência	efetivo/eficaz/eficiente/inútil/vão
eficácia	efetivo/eficaz/eficiente/potente/ineficaz/impotente/inútil/vão
existência	existente
felicidade	feliz/contente/infeliz/triste
força	débil/delicado/potente/ineficaz/impotente/forte
função	funcional
fé	certo/incerto/inseguro
grandeza	mensurável
grau	suave/intenso/alto/baixa/baixo
gênero	sexual/assexual/varão/macho
habilidade	incapaz/capaz
idade	maturo/maduro/velho/novo/nao-maduro/imaturo/jovem/velho/antigo/novo
ideologia	conservador/liberal
importância	importante
independência	dependente/independente
inteligência	intelectual/lerdo/inteligente/estúpido
legalidade	legal/ilegal
liberdade	livre/dependente/independente
limpeza	sujado/suja/limpo/sujo
local	esquerdo/direita/direito
lugar	esquerdo/direita/direito
magnitude	mensurável/importante
maioria	maior
maioridade	maior
medida	grande/pequeno
medo	receoso/destemido
mercantilismo	comercial
moral	puro/imoral
moralidade	moral/puro/imoral
movimento	movente/imóvel
natureza	bem-humorado/lhano/afável/amável/gentil
necessidade	necessário/essencial/desnecessária/desnecessário
número	mensurável
odor	inodoro
ortodoxia	ortodoxo
perfeição	aprimorado/perfeito/imperfeito
peso	leve/pesado
poder	poderoso/impotente/capaz
popularidade	popular
pose	certo/incerto/inseguro
posição	esquerdo/direita/vertical/direito
possibilidade	impossível/possível
postura	vertical
potencia	potente/ineficaz/impotente
potenciabilidade	possível/potencial
potencial	possível
potência	potente/ineficaz/impotente
presença	ausente/presente
propósito	funcional
qualidade	positivo/vantajoso/ruim/bom
rapidez	lento/devagar/rápida/veloz/rápido
realidade	efectivo/efetivo/verdadeiro/real
regularidade	regular
saber	ciente/informado
segurança	certo/incerto/inseguro
semelhança	similar/mesmo/diferente
ser	existente
sexo	homo/homossexual/gay/sexual/assexual/hetero/heterossexual/varão/macho
sexualidade	sexual/assexual/varão/macho
significado	significante/significativo/importante
significação	significante/significativo/importante
similardidade	similar/mesmo/diferente
talento	capaz
tamanho	grande/pequeno
temor	receoso/destemido
temperamento	relutante
temperatura	caloroso/forgoso/fresco/quente/frio
terror	receoso/destemido
tez	colorido
transa	homo/homossexual/gay/hetero/heterossexual
velocidade	lento/devagar/rápida/veloz/rápido
vida	vivo/semvida/morto
virtude	moral/puro/imoral
índole	bem-humorado/lhano/afável/amável/gentil
