abaixo-assinado	aplicacao/cobrança/apelação/arrecadação/candidatura/demanda/solicitação/apelo/recurso
abalo	zanga/consternação/espírito/ira/cólera/temor/raiva/terror/humor/medo/alegria
abandonar	aposentar-se
abarcar	abranger/incluir/compreender/conter/ter
abastecer	apetrechar/aparelhar/equipar/suprir/carregar
aborrecer	assediar/molestar/importunar/irritar/provocar/incomodar
abortamento	aborto
abortação	aborto
abrigo	morada/seguros/apartamento/aposento/moradia/domicílio/residência/habitação/lar/seguro/casa
acadêmico	alumnus/dr./filósofo/historiador/historiografo/ph.d./cronista/dr./graduado/doutor
acalmar	tranqüilizar/aquietar/silenciar/tranquilizar
acendedor	fósforo
aceno	numeral/vareta/símbolo/selo/número
acertar	sintonizar/afinar/regular/ajustar
acidente	coincidência
acobertar	disfarçar/mascarar/encobrir/esconder
aconselhamento	indicação
acontecer	coincidir
acontecimento	cerimónia/cerimônia/festa
acordo	apólice/aluguel/parceria/consenso/sociedade
acorrer	assistir/ajudar/servir
acrescentamento	aumento
acréscimo	acumulação
acta	interdição/proibição
actualidade	momento
acção	critica/parto/juízo/rejeição/recuperação/julgamento/partida/produção
acúmulo	biota/exposições/galáxia/suma/transito/tránsito/trânsito/embalagem/embrulho/flora/guarda-roupa/nebulosa/tráfego/trânsito/vegetação/biologia/circulação/cúmulo/jurisprudência/mão/monte/tesouro/lei/montão/pacote/combinação/exposição/pilha/jogo/grupo
adaptar-se	condizer/obedecer/igualar/corresponder/combinar
adequar-se	condizer/obedecer/igualar/corresponder/combinar
adiar	delongar/pospor/postergar/protelar/prorrogar/procrastinar/atrasar
adivinhar	pressentir/prognosticar/apostar/predizer/prever
adição	anexo/asa
administrador	gestor/director/dirigente/diretor/gerente
administração	finança/tratamento
admissão	confissão
adorno	laço/ornamento
adquirir	beneficiar-se/re-adquirir/beneficiar/herdar/reconquistar/reganhar/auferir/colecionar/lucrar/recolher/apanhar/comprar/recuperar/coletar/ganhar/capturar/obter/encontrar/reunir/atingir/pegar
adulto	anfitrião/hospedeiro/partido/profissional/mulher/homem
adversário	inimigo
advertir	ameaçar
advogado	porta-voz/representante
aeroplano	bombardeiro
afagar	lamber
agarrar	apreender/apanhar/furtar/roubar/prender/segurar
agastar	assediar/aborrecer/molestar/importunar/irritar/provocar/incomodar
agenda	horário
agente	detective/detetive/policial/tira/substituto/representante
agir	troçar/caçoar
agitar	abanar/flabelar/ventilar/estremecer/tremular/tiritar/tremer
aglomeração	biota/exposições/galáxia/suma/transito/tránsito/trânsito/embalagem/embrulho/flora/guarda-roupa/nebulosa/tráfego/trânsito/vegetação/biologia/circulação/cúmulo/jurisprudência/mão/monte/tesouro/acúmulo/lei/montão/pacote/combinação/exposição/pilha/jogo/grupo
agredir	estuprar/violentar/assaltar/desonrar/atacar
agressão	violência/força
aguentar	gerenciar/engolir/aceitar
ajuda	auxilio/apoio/mão/suporte/bolsa/serviço
ajudante	manequim/secretário/secretária/modelo
ajudar	assistir/servir
ajustar	condizer/sintonizar/obedecer/afinar/igualar/corresponder/regular/combinar
alarme	buzina
alcance	espectro
alertar	ameaçar
alfaia	aparelhador/cómoda/gaveteiro/candeeiro/cômoda/luminária/assento/estante/mesa/armário/cadeira
alguém	aficionado/amadora/antagonista/cobaia/conhecida/engenheiro/habitante/homem-bomba/matador/proponente/pário/solicitante/utente/utilizador/adversário/amador/líder/morador/pretendente/sósia/usuário/adulto/candidato/cientista/escrava/especialista/espectador/igual/indivíduo/observador/opositor/parente/pupilo/sobrevivente/sócio/conhecido/defensor/parceiro/suspeito/advogado/amizade/assassino/autoridade/escravo/guerreiro/inimigo/radical/vizinho/aluno/caso/chefe/par/testemunha/trabalhador/amigo/estudante/representante
alimentar	pastar
alimento	bebida
aliviar	tranqüilizar/aquietar/silenciar/tranquilizar/acalmar
alma	aficionado/amadora/antagonista/cobaia/conhecida/engenheiro/habitante/homem-bomba/matador/proponente/pário/solicitante/utente/utilizador/adversário/amador/líder/morador/pretendente/sósia/usuário/adulto/assombração/candidato/cientista/escrava/especialista/espectador/igual/indivíduo/observador/opositor/parente/pupilo/sobrevivente/sócio/aparição/conhecido/defensor/espectro/parceiro/suspeito/advogado/amizade/assassino/autoridade/escravo/fantasma/guerreiro/inimigo/radical/vizinho/aluno/caso/chefe/par/testemunha/trabalhador/amigo/estudante/representante
almofada	coxim/travesseiro/descanso
alocação	quota/cota/atribuição
alojamento	morada/apartamento/aposento/moradia/domicílio/residência/abrigo/habitação/lar/casa
alterar	alargar/ativar/comercializar/desvirar/impactar/aperfeiçoar/endireitar/inverter/acertar/completar/afetar/modelar/investir/causar/formar/manchar/substituir/ajustar/corrigir/melhorar/encher/estender/trocar/reduzir/diminuir
alteração	decréscimo/falecimento/mutação/dano/estrago/flutuação/avaria/mutação/variação/prejuízo/surpresa/queda/diminuição/abatimento/morte/mudança
alternativa	cabimento/default/possibilidade/padrão
aluno	ouvinte
alvo	finalidade/intento/propósito/objectivo/objetivo/fim/intenção
alçar	bombear
ambiente	habitat/cenário
ambiência	trevas/atmosfera/cheiro/tom/cara
amedrontar	terrificar/horripilar/aterrorizar
amigo	conexão
amizade	companherismo/fé/conexão
amolar	assediar/aborrecer/molestar/importunar/irritar/provocar/incomodar
amplidão	anchura/largura
anca	regaço/colo/joelho
andar	cave/engatinhar/gatinhar/mansarda/porão/rastejar/rastejar-se/retroceder/serpear/trapeira/vadiar/vagabundear/vaguear/boiar/pisar/retirar-se/sótão/ático/devolver/pisotear/regressar/ascender/escorregar/nadar/recuar/errar/marchar/passear/perambular/vagar/deslizar/voar/apressar/retornar/acompanhar/atravessar/pular/saltar/caminhar/dirigir/correr/seguir/ir/subir/passar/cair
angústia	tormento/tortura/martírio/agonia/dor
animal	cria/embriões/predadores/embrião/prole/filhote/presa
aniversário	aniversario
anotação	menção/citação/referência
anseio	capricho/comichão/impertinência/ambição/caprichoso/pretensão/aspiração/fantasia/desejo
ansiar	suspirar/desejar
antagonista	inimigo
antecipar	conjecturar/hipotetizar/teorizar/pressupor/presumir/especular/supor/assumir
antenome	assinatura/visto
antipatizar	detestar/odiar/ressentir
anúncio	filipeta/reclame/panfleto/reclamo/propaganda/publicidade
aparato	reactor/reactores
aparelho	chibata/reactor/reactores/açoite/chicote/armamento/arma
apartamento	suíte
aparência	aspecto/efeito/cor/rosto/impressão
apelo	aplicacao/cobrança/apelação/arrecadação/candidatura/demanda/solicitação/recurso
aperceber	enxergar/ouvir/saborear/doer/escutar/cheirar/sentir/saber/olhar/ver
aperceber-se	enxergar/ouvir/saborear/doer/escutar/cheirar/sentir/saber/olhar/ver
aperfeiçoar	aprimorar/reparar/emendar/lustrar/consertar/polir/refinar/reformar/melhorar
apertar	esmagar/espremer
apetite	capricho/comichão/impertinência/ambição/caprichoso/pretensão/aspiração/fantasia/desejo
apoio	aprovaçã0/degrau/pedestal/prateleira/estante/suporte/barra/aprovação/pé/base
apontamento	menção/citação/referência
aporrinhar	assediar/aborrecer/molestar/importunar/irritar/provocar/incomodar
aposento	antecâmara/antessala/compartimento/estudio/vivenda/calabouço/hall/masmorra/saguão/vestíbulo/átrio/dormitório/bar/cela/escritório/habitação/cozinha/galeria/quarto/banheiro/sala/casa/classe
apostila	introdução
apresentar	actuar/atuar/representar/tocar/fazer
apresentação	magia/ilusão/truque/produção
aprovaçã0	adopção/adoção/aceitação
aprovação	laissez-passer/passe/adopção/adoção/aceitação
aquisição	dádiva/brinde/dom/doação/presente
ar	trevas/céu/atmosfera/cheiro/tom/cara
arapuca	armadilha
arbusto	rosa/rosas/rosa
arco	pneu
ardor	fervor/zelo
aresta	rebordo
argumento	ação
aria	tema
arma	gládio/projéctil/revóvel/míssil/projétil/revólver/espada/arco
armamento	gládio/projéctil/revóvel/míssil/projétil/revólver/espada/arma/arco
arranjar	agavelar/coordenar/empilhar/acumular/organizar
arrebentar	britar/estilhaçar/destroçar/estourar/explodir
arredar	arrastar/atrair
arremessar	quebrar
arremeter	arremessar/jogar
arrombar	britar/estilhaçar/destroçar
artigo	reportagem/boletim/estoque/estória/inventário/relato
artista	fotógrafa/fotógrafo/musico/músico/pintora/músico/pintor/mestre
arvoreta	rosa/rosas/rosa
ascendencia	supremacia/monopólio/domínio
ascender	galgar/trepar/montar/subir
aspecto	efeito/cor/rosto/aparência/impressão
assalariado	balconista/caixeiro
assaltar	estuprar/violentar/desonrar/atacar
assassinato	massacre
assassínio	massacre
assembléia	encontro/reunião
assento	banqueta/banquinho/cadeirão/canapé/tamborete/poltrona/sofá/banco/cadeira
asserção	acusação/afirmação/negação
assessoramento	repreensão
assistente	manequim/secretário/secretária/modelo
assistir	ajudar/servir
assistência	apoio/mão/ajuda/suporte/serviço
associação	guilda/clube/sociedade/ordem
assustar	terrificar/horripilar/aterrorizar
atacar	estuprar/violentar/assaltar/desonrar
atadura	esparadrapo/penso/ligadura/gesso
atemorizar	terrificar/horripilar/aterrorizar
atenção	concentração
aterrorizar	terrificar/horripilar
atirar	balear/arremessar/arremeter/disparar/jogar/lançar/quebrar
atitude	mentalidade/postura/cultura/tendência/posição
atleta	corredor
atmosfera	trevas/céu/cheiro/tom/cara
ato	critica/parto/juízo/rejeição/recuperação/julgamento/partida/produção
atrair	cativar/deliciar/deleitar/fascinar/encantar
atratividade	afinidade
atração	gravitação/gravidade/afinidade
atribuição	quota/cota
atributo	característica/qualidade
atuar	troçar/caçoar
aturar	engolir/aceitar
auferir	rentabilizar/lucrar
aula	seminário
aumentar	fanfarrear/vangloriar/vangloriar-se/ostentar
aumento	acréscimo/acumulação
ausência	penúria/escassez/fome/falta/carência
auto	ambulancia/taxi/ambulância/compacto/táxi
automóvel	ambulancia/taxi/ambulância/compacto/táxi
autor	ghost-writer/ghostwriter
autoridade	assessor/conselheiro/consultor/orientador
autoridades	corte
autorizar	credenciar/reconhecer
autorização	laissez-passer/passe
auxiliar	assistir/ajudar/servir
auxílio	apoio/mão/ajuda/suporte/serviço
avançar	favorecer/preferir
aventurar	pressentir/prognosticar/adivinhar/predizer/prever
avisar	ameaçar
aviso	demissão
avião	bombardeiro
azul	azul-ferrete/azul-marinho/naval/marinho
ação	critica/parto/juízo/rejeição/recuperação/julgamento/partida/produção
bafejar	bocejar/soluçar/suspirar
baga	morango
balancear	compensar
bandeira	estandarte
barco	batel/iate/balsa/bote/escaler
barreira	sebe/sebes
bastão	clava/porrete
batalha	combate/luta
batel	balsa
bater	esmurrar/oscular/prensar/beijocar/sobrepujar/golpear/beijar/sacanear/trapacear/afagar/colidir/pressionar/ultrapassar/exceder/apertar/chutar/derrotar/superar/roubar/atingir
beber	bebericar/sorver
bebida	álcoois/álcool/leite/chá/café
bem	especialidade/benefício/lucro/recurso
bem-estar	saúde
beneficiário	pensionista
benefício	lucro
berrar	bradar/gritar
besta	cria/embriões/predadores/embrião/prole/filhote/presa
bicha	filaúnica/umapósooutro/fila
bicho	cria/embriões/predadores/embrião/prole/filhote/presa
bisbilhotice	boato/diz-que-diz-que/rumor/fama/renome/fofoca
bisbolhetice	boato/diz-que-diz-que/rumor/fama/renome/fofoca
bloquear	obstaculizar/tolher/obstruir/atrapalhar
boca	arco
bode	cabrita/cabrito
bola	berlinde
bolbo	cebola
bolo	biscoito/cookie/bolacha
bondade	virtudes/virtude
botar	deitar/semear/instalar/dispor/plantar/arranjar/pôr/perder/colocar/carregar
bote	balsa
botão	campainha
bovinos	vaca
brigar	pugnar/lutar
brinde	galardão/prémio/prêmio/ajuda/presente
brinquedo	baloiço/escorregador/escorrego/pandorga/pipa/pião/boneca/boneco/balanço/balão/papagaio/bola
bruma	névoa/neblina
cabelo	sobrancelha/sobrolho/supercílio/anel/cacho
cabeça	administrador/executivo/gerente
cabra	cabrita/cabrito
cabrito	cabrita
cache	troco
cadeira	banqueta/banquinho/cadeirão/canapé/tamborete/poltrona/sofá/assento/banco
cadáver	enchido/defunto/corpo
caixa	ataúde/caixão/esquife/féretro
calculadora	site/website/sítio
calçado	alpercata/sandália/chinelo
camada	pigmento/tinta/pintura/cor
caminhar	engatinhar/gatinhar/rastejar/rastejar-se/retroceder/serpear/vadiar/vagabundear/vaguear/boiar/pisar/retirar-se/devolver/pisotear/regressar/ascender/escorregar/nadar/recuar/errar/marchar/passear/perambular/vagar/deslizar/voar/apressar/retornar/acompanhar/atravessar/pular/saltar/dirigir/correr/seguir/ir/andar/subir/passar/cair
caminho	órbita/trilha/entrada
caminho-de-ferro	metrô/metropolitano/metro
caminhão	van
camisa	camiseta/t-shirt
camião	van
camiões	van
campo	prados/cercado/clareira/engenharia/roça/tecnologia/arquitetura/grama/gramado/pátio/relva/teologia/ciência/jardim/quintal/arquitectura/interior/prado
campos	canteiro
capa	pigmento/tinta/pintura/cor
capital	orçamento/depósito
capturar	apreender/apanhar/furtar/agarrar/roubar/prender/segurar
caracter	inicial
característica	faceta/qualidade
caractér	inicial
carburante	benzina/gasolina
caricatura	quadrinhos
carne	enchidos/lingüiça/bife/salsicha
carregar	deitar/semear/instalar/dispor/plantar/arranjar/transportar/pôr/perder/trazer/levar/colocar/tirar
carro	ambulancia/taxi/ambulância/compacto/táxi
carta	invitação/convite
cartoon	quadrinhos
cartão	cartão-postal
carácter	inicial
carência	deficit/penúria/ausência/escassez/fome/deficiência/falta
casa	bangalô/casinha/casinhola/morada/vivenda/apartamento/aposento/cabana/chalé/choça/moradia/domicílio/residência/abrigo/habitação/lar
casaco	paleto/jaqueta
castigar	executar
castigo	punição
categoria	elemento/excedente/restante/resíduo/sobra/resto/substância/componente
cativo	refém
caule	bolbo/galho/ramo/cebola
causa	alguém/indivíduo/natureza/alma/processo/pessoa/poder/força
causador	alguém/indivíduo/natureza/alma/pessoa/poder/força
cavalo	pônei
celebração	festival
centro	coração
cerca	sebe/sebes
cereal	arroz/milho
cerimónia	boda/funeral/boda/enterro/funeral/casamento
cerimônia	boda/funeral/boda/enterro/funeral/casamento
cerque	habitat/cenário
cerrar	vedar/selar/bater
certame	competição/torneio/corrida/combate/partida/jogo/luta
certificar	credenciar/reconhecer
chapa	oposição
chatear	assediar/aborrecer/molestar/importunar/irritar/provocar/incomodar
chave	botão
chefe	empregador/líder/administrador/executivo/gerente/herói/político/treinador/cabeça/guia/liderança/exemplo/técnico/responsável/modelo
chegada	demolição/placar/destruição/desolação/vitória/resultado
chofer	automobilista/condutor/motorista
chuva	garoa/chuvisco
chácara	lacticínios/leitaria/leiteria/mercearia/rancho/granja/herdade/roça/terras/fazenda
chão	florestas/arvoredo/selva/bosque/ilha/mata/floresta
cidadã	eleitor/votante/civil
cidadão	eleitor/votante/civil
cientista	pesquisador/psicólogo/investigador
cilindro	rolo
circunscrição	empreendimento
circunstância	justificativa/justificação
circunstâncias	falhanço/falha
ciência	matematica/matemática/psicologia
clamar	indiciar/denunciar/acusar
classe	gradação/nacionalidade/proletariado/hierarquia/nível/posto/grau/segundo/posição
cliente	assinante/subscritor/leitor
clima	vento/tempo
cobre	cache/numerário/divisa/moeda/dinheiro
cobrir	embrulhar/embalar
cogitar	centrar/ruminar/concentrar/associar/conectar/relacionar/ponderar/especular/focar/questionar/contemplar/perguntar/planejar/refletir
cognição	psique/atitude/mente/cabeça
colecção	biota/exposições/galáxia/suma/transito/tránsito/trânsito/embalagem/embrulho/flora/guarda-roupa/nebulosa/tráfego/trânsito/vegetação/biologia/circulação/cúmulo/jurisprudência/mão/monte/tesouro/acúmulo/lei/montão/pacote/combinação/exposição/pilha/jogo/grupo
coleção	biota/exposições/galáxia/suma/transito/tránsito/trânsito/embalagem/embrulho/flora/guarda-roupa/nebulosa/tráfego/trânsito/vegetação/biologia/circulação/cúmulo/jurisprudência/mão/monte/tesouro/acúmulo/lei/montão/pacote/combinação/exposição/pilha/jogo/grupo
colocar	deitar/semear/instalar/dispor/plantar/arranjar/pôr/perder/carregar
comandar	proscrever/vetar/vedar/proibir
comarca	empreendimento
combate	batalha/luta
combinar	assemelhar-se/assemelhar/parecer
combustível	benzina/gasolina
comentário	chacota/xiste/gracejo/piada
comercialismo	industria/marketing/mercadologia/tráfico/marketing/tráfego/trânsito/pagamento/empresa/negócio/comércio
comerciante	barao/retalhista/varejista/magnata/mercador/dono/fornecedor/vendedor/negociante/proprietário
começar	inaugurar/introduzir
comida	bebida
comissão	junta/comité/comitê/conselho/júri
comité	junta/comitê/conselho/júri
comitê	junta/comité/conselho/júri
comoção	zanga/consternação/espírito/ira/cólera/temor/raiva/terror/humor/medo/alegria
companheiro	cônjuge/esposa/esposo/marido/varão/mulher/homem
compartimento	bagageira/porta-bagagem/porta-malas/camarote/mala
competir	jogar
competição	contenda/contestação/torneio/corrida/combate/partida/jogo/luta
completar	alagar/estofar/encharcar/estufar/inundar/encher
complô	conjuração/conspiração
componente	elemento/hardware/destaque/excedente/ingrediente/realçe/restante/adição/módulo/resíduo/sobra/melhoria/resto/substância
comportamento	desfeita/ofensa/injúria
comportar-se	troçar/caçoar
comprador	assinante/subscritor/leitor
comprar	beneficiar-se/re-adquirir/beneficiar/herdar/reconquistar/reganhar/auferir/colecionar/lucrar/recolher/apanhar/recuperar/coletar/ganhar/capturar/obter/adquirir/encontrar/reunir/atingir/pegar
compreender	solucionar/resolver
compreensão	psique/atitude/mente/cabeça
comprender	solucionar/resolver
comprimir	asfixiar/estrangular
computador	site/website/sítio
compêndio	introdução
comunicação	demissão/agouro/indício/mensagem/presságio/indicação/linguagem/discurso/idioma/língua/sinal
comércio	industria/marketing/mercadologia/transportação/tráfico/turismo/aventura/indústria/manufatura/marketing/tráfego/trânsito/pagamento/transporte/empresa/negócio/expedição
conceito	projecto/regulamento/atributo/noção/categoria/concepção/norma/possibilidade/programação/soma/característica/idéia/suposição/tema/teoria/lei/motivo/projeto/quantidade/regra/hipótese/preocupação/propriedade/qualidade/família/ideia/intenção/programa/plano/número/classe
concepção	regulamento/atributo/noção/categoria/norma/possibilidade/soma/característica/idéia/suposição/teoria/lei/quantidade/regra/hipótese/propriedade/qualidade/família/ideia/número/classe
concitar	magoar/ofender/provocar
conclusão	demolição/placar/destruição/desolação/vitória/resultado
concordar	assemelhar-se/assemelhar/parecer
concorrer	jogar
concorrência	contenda/contestação
concurso	competição/torneio/corrida/combate/partida/jogo/luta
condição	ascendencia/nacionalidade/repto/ambiência/delinquência/dominancia/melhora/preservação/superioridade/hierarquia/motivação/saúde/complicação/conforto/melhoria/necessidade/ar/atmosfera/bagunça/culpa/desafio/equilíbrio/perigo/posto/segurança/carência/tensão/controle/domínio/ordem/classe/posição
conductor	automobilista/chofer/condutor/motorista
conduta	desfeita/ofensa/injúria/caminho
condutor	automobilista/cobre/chofer/cobre/motorista/prata
confinar	emprisonar/encarcerar/engaiolar/incarcerar/aprisionar/prender
confirmar	validar/demonstrar
confirmação	crisma/verificação
conflito	desacordo/discordo/rixa/atrito/fricção/discordância
confortar	tranqüilizar/aquietar/silenciar/tranquilizar/acalmar
conforto	alívio
confromar-se	condizer/obedecer/igualar/corresponder/combinar
confronto	desacordo/discordo/rixa/atrito/fricção/discordância
conhecida	conexão
conhecido	conexão
conhecimento	psique/atitude/mente/cabeça
conselho	repreensão/indicação
consenso	laissez-passer/passe/acordo
consentimento	laissez-passer/passe
consentir	aturar/tolerar/aguentar/suportar/admitir/aceitar
consequência	efeitos/impacto/influência/efeito/produto
conseqüência	efeitos/impacto/influência/efeito/produto
consideração	justificativa/justificação
consolar	tranqüilizar/aquietar/silenciar/tranquilizar/acalmar
consorte	cônjuge/esposa/esposo/marido/varão/mulher/homem
conspiração	conjuração
consternação	estupefação/pânico/terror/medo
construir	reproduzir/gerar/criar/trazer/fazer
consumidor	assinante/subscritor/freguês/cliente/comprador/leitor
contar	remarcar/enunciar/reparar/retrucar/notar/articular/somar/comentar/mencionar/replicar/vocalizar/responder/adicionar/dizer
contemplar	ponderar/questionar/perguntar
conter	abranger/constrangir/incluir/restringir/compreender/ter
continuidade	reinado
contradição	paradoxo
contrair	asfixiar/estrangular
contrato	apólice/aluguel/parceria/sociedade
controle	supremacia/monopólio/domínio
controvérsia	disputa/discussão
convento	abadia
conversa	conversação/diálogo/troca/debate/discussão
conversação	diálogo/troca/debate/conversa/discussão
convicção	doutrina/expetativa/religião/filosofia/expectativa/certeza/fé
corda	cabo
corpo	enchido/defunto/anatomia/cadáver/carne
corrente	rio/caminho
correr	entornar/verter/derramar
corresponder	assemelhar-se/assemelhar/parecer
correspondência	cartão
correção	compensação
corrigir	sintonizar/afinar/regular/ajustar
corroborar	validar/demonstrar
cosmo	natureza
costa	declividade/ribeira/barranco/descida/declínio/margem
costume	cooperação/costumes/tradição/hábito
costumes	tradição/costume/hábito
coxa	regaço/colo/joelho
cozinhar	preservar/conservar
crença	doutrina/expetativa/convicção/religião/filosofia/expectativa/certeza/fé
crescimento	acréscimo/acumulação/cultura
criado	manequim/secretário/secretária/modelo
criança	bebé/criancinha/nenê/recém-nascido/bebê
criar	reproduzir/gerar/desenvolver/trazer/fazer
criatura	cria/embriões/predadores/embrião/prole/filhote/presa
criação	natureza/arte
crime	infracção/infração
crise	depressão/recessão
criticismo	fogo/ataque
critério	normas/escala/padrões/norma/padrão
cronograma	horário
crédito	comemoração
crítica	fogo/ataque
crónica	biografia
crônica	biografia
curativo	esparadrapo/penso/atadura/ligadura
curso	seminário/caminho
curva	arco
custo	portagem/pedágio/comissão/entrada
cálculo	estimativa/aproximação/ideia
cédula	dólar
código	software/programa
cólera	fúria/ira/raiva
cónjuge	cônjuge/esposa/esposo/marido/varão/mulher/homem
cópia	replicação/réplica/reprodução
córrego	rio
cônjuge	esposa/esposo/marido/varão/mulher/homem
dano	picada/ferida/fractura/fratura/ferimento/lesão/queimadura
dar	legar/doar/distribuir/deixar/entregar/passar
decair	degenerar/degradar/deteriorar/piorar
decepção	frustação/derrota/frustração
deceção	frustação/derrota/frustração
decidir	seleccionar/adjudicar/selecionar/julgar/escolher
declarar	indiciar/denunciar/acusar
declaração	asserção
declive	declividade/ribeira/barranco/descida/declínio/margem
declives	declividade/ribeira/barranco/descida/declínio/margem
decoração	laço/ornamento
decrescer	encolher
decreto	interdição/proibição
dedo	polegar/índex/indicador
defender	salvaguardar/assegurar/salvar/guardar/segurar
defensor	porta-voz/representante
deficiência	deficit/penúria/escassez/fome/falta/carência
defunto	enchido/cadáver/corpo
deixar	aturar/tolerar/aguentar/suportar/admitir/aceitar
delapidar	indulgir
demanda	consumo
demandar	exigir/requerer
demitir-se	aposentar-se
depressão	baixada/vale
derramar	gotejar/pingar
derrotar	sobrepujar/sacanear/trapacear/ultrapassar/exceder/superar/roubar
desabar	encolher
desaparecer	caldear
desapontamento	frustação/derrota/frustração
descendente	criança/filho/menino
descendência	criança/filho/menino
descenso	queda
descida	queda
desejar	ansiar/suspirar
desejo	capricho/comichão/impertinência/ambição/caprichoso/pretensão/aspiração/fantasia
desempenhar	actuar/atuar/representar/tocar/fazer
desempenho	magia/ilusão/truque
desenhar	plotar/diagramar
desenho	diagrama/planta/esquema/plano
desespero	resignação
desgostar	detestar/odiar/ressentir
desinformar	mentir/exagerar/enganar/trair/aumentar
desistência	imunidade
deslizar	resvalar/derrapar/escorregar/patinar
deslocar	contorcer/enroscar/espernear/torcer-se/manar/virar-se/arremessar/dançar/estalar/fluir/flexionar/pulsar/tornar-se/tropeçar/alongar/impulsionar/esticar/mexer/dobrar/girar/pular/sacudir/saltar/tremer/sair/correr/partir/agitar/deixar/virar/separar/bater
despender	delapidar/dilapidar/esbanjar/desperdiçar
desperdiçar	indulgir
desportista	corredor
destino	falhanço/falha
desvantagem	limitação
deter	emprisonar/encarcerar/engaiolar/incarcerar/aprisionar/prender
detestar	desprezar/desdenhar/menosprezar
dever	incumbência/serviço
dia	data
didáctica	aula/curso
dilapidar	indulgir
dimensão	anchura/largura
diminuir	encurtar/encolher/resumir/condensar/abreviar/reduzir
diminuição	disconto/desconto/abatimento/corte
dinheiro	cache/numerário/troco/divisa/moeda
direção	indicação
disciplina	engenharia/tecnologia/arquitetura/teologia/ciência/arquitectura
discordância	controvérsia/disputa/discussão
discurso	pregação/preleção/prédica/palestra/sermão/linguagem/idioma/língua
discussão	controvérsia/disputa
discutir	deliberar/debater/considerar
dispensar	poupar
dispor	agavelar/coordenar/empilhar/acumular/organizar
disposição	otimismo/ambição/aspiração
disputa	controvérsia/discussão
disputar	pugnar/lutar
districto	empreendimento
distrito	empreendimento
disturbar	transtornar/preocupar/perturbar
ditado	lemas/mote/cambial/lema
divertir	hospedar/receber
divisa	cache/cêntimo/numerário/centavo/moeda/dinheiro
dizer	remarcar/enunciar/reparar/retrucar/notar/articular/comentar/mencionar/replicar/vocalizar/responder
diálogo	conversação/conversa
doação	galardão/prémio/prêmio/ajuda/presente
doce	pudim
docente	instructor/preceptor/tutor
documentação	atestado/certidão/copyright/escritura/foro/fretamento/certificado/cédula/formulário/patente/reporte/relato/relatório/estudo/instrumento/renúncia
documento	atestado/certidão/copyright/escritura/foro/fretamento/certificado/cédula/formulário/patente/reporte/relato/relatório/estudo/instrumento/renúncia
doença	doenças/tumores
doer	ferrar/picar/queimar
dom	galardão/prémio/prêmio/ajuda/presente
domicílio	vivenda/habitação/casa
dominancia	supremacia/monopólio/domínio
domínio	empreendimento/supremacia/engenharia/monopólio/tecnologia/arquitetura/teologia/ciência/arquitectura
dopar	envenenar
dor	tormento/tortura/martírio/agonia
dose	comprimido/pílula
doutor	cirurgião
doutrina	credo
dr.	cirurgião
droga	medicamento/remédio
drogar	envenenar
dupla	casal
duração	prolongamento/reinado/continuação
dádiva	galardão/prémio/prêmio/ajuda/presente
débito	empréstimo/crédito
dívida	empréstimo/crédito
dívidas	empréstimo/crédito
dúvida	receio/desconfiança
edifício	escolas/estádio/plantel/sacada/torres/varanda/vivenda/alojamento/altar/estufa/hall/hotel/letreiro/pavimento/piso/placar/ponte/prédio/restaurante/roque/torre/varanda/arena/balcão/cruz/dormitório/monumento/monumentos/viveiro/painel/abrigo/biblioteca/colégio/departamento/habitação/ruína/salão/centro/escola/placa/casa/andar
edição	referência/livro
educação	aula/conferência/lição/experiência/curso
efeito	efeitos/impacto/influência/produto
elaborar	exemplificar/ilustrar
eleição	cabimento/default/possibilidade/padrão
elemento	destaque/realçe
elevar	bombear
elicitar	magoar/ofender/provocar
eliminar	excetuar/omitir/preterir/excluir
elite	poucos
elocubrar	exemplificar/ilustrar
elogio	recomendações/recomendação
embarcação	batel/iate/bote/escaler/barco
embarcações	batel/iate/bote/escaler/barco
emblema	numeral/vareta/símbolo/selo/número
emissão	telejornais/episódio/notícias
emitir	carpir/lamentar-se/latir/urrar/bramir/gemir/ladrar/rugir/gemer/uivar/berrar/gritar
emocionar	transtornar/preocupar/perturbar
emoção	zanga/consternação/espírito/ira/cólera/temor/raiva/terror/humor/medo/alegria
empregado	balconista/caixeiro
emprego	biscate/chácara/estudio/laboratorio/laboratórios/estúdio/granja/quinta/cargo/laboratório/oficina/ofício/vocação/sítio/arte/profissão/ocupação/fazenda/trabalho/posição
empresa	transportação/turismo/aventura/indústria/manufatura/transporte/expedição
empresas	editora
empresário	barao/magnata/dono/proprietário
empurrar	derrubar
empório	supermarket/supermercados/supermercado
encargo	portagem/pedágio/comissão/entrada
encendedor	fósforo
encher	alagar/estofar/encharcar/estufar/inundar
enchidos	cachorro-quente/salsicha
encobrir	disfarçar/mascarar/esconder
encontro	sessão/visita
encosta	declividade/ribeira/barranco/descida/declínio/margem
encosto	degrau/pedestal/prateleira/estante/suporte/barra/pé/base
endereço	domicílio/residência/casa
enfermaria	manicomio/asilo
enfermidade	doenças/tumores/doença
enganar	mentir/exagerar/trair/aumentar
engano	distorção/omissão/confusão
engenharia	informática
engrenagem	transmissão
enredo	ação
ensaio	relatório
ensaios	relatório/ensaio
ensinamento	aula/curso
ensinar	reforçar/educar/instruir/preparar/treinar
ensino	aula/conferência/lição/curso
entender	enxergar/ouvir/saborear/solucionar/doer/escutar/cheirar/resolver/sentir/saber/olhar/ver
enterro	inumação/sepultamento/funeral/sepultura
entornar	gotejar/pingar
entorno	habitat/cenário
entorpecente	medicamento/remédio
entrada	arco
entrar	traspassar/perfurar/embarcar/penetrar
entregar	legar/doar/distribuir/deixar/passar/dar
entreter	hospedar/receber
enumerar	somar/adicionar
envolvente	habitat/cenário
enxugar	escovar/varrer
epifania	descoberta/achado
equilibrar	compensar
equipamento	reactor/reactores/satélites/aparato/satélites/aparelho/satélite
equívoco	distorção/omissão/confusão
era	reinado/idade/época/reino/período
erguer	bombear
erro	distorção/omissão/confusão
erudito	alumnus/dr./filósofo/historiador/historiografo/ph.d./cronista/dr./graduado/doutor
esbanjar	indulgir
escada	escadas
escadaria	escadas
escaler	balsa
escassez	penúria/fome/falta/carência
esclarecer	explicar
escol	poucos
escolha	cabimento/default/possibilidade/padrão
escolher	eleger/peneirar/analisar/selecionar/votar/decidir
esconder	disfarçar/mascarar/encobrir
escopo	espectro
escorregar	resvalar/derrapar/deslizar/patinar
escrever	subscrever/visar/assinar
escritor	ghost-writer/ghostwriter
escritório	matriz/sede/base
escultura	estatua/estátua/bronze
escutar	grampear/interceptar
esfregar	roçar/escovar/varrer/enxugar/limpar
espalhar	borrifar
esparadrapo	gesso
espaçamento	equilíbrio/proporção/formação
espaço	vacância/ângulo/ângulos/vaga/vácuo/vazio
especialista	alumnus/dr./expert/experto/filósofo/historiador/historiografo/louvado/ph.d./terapeuta/cronista/decorador/desenhador/dr./graduado/investigador/doutor/experiente/perito/curandeiro/autoridade
espectador	espetador/telespectador/observador
espectáculo	película/cinema/filme/emissão/atração/produção/programa
especular	ponderar/questionar/perguntar
espirar	bocejar/soluçar/suspirar
espião	espiã
esposa	dona-de-casa/cônjuge/esposo/marido/varão/mulher/homem
esposo	cônjuge/esposa/marido/varão/mulher/homem
espírito	embevecimento/enlevo/êxtase
esquema	plano
estabelecimento	caridade
estacada	sebe/sebes
estado	ascendencia/nacionalidade/ambiência/delinquência/dominancia/melhora/preservação/superioridade/hierarquia/motivação/saúde/conforto/melhoria/necessidade/ar/atmosfera/bagunça/culpa/perigo/posto/segurança/carência/tensão/controle/domínio/ordem/classe/posição
estandarte	bandeira
estação	estio/inverno/outono/primavera/verão/colheita
estimular	magoar/ofender/provocar
estipêndio	portagem/pedágio/comissão/entrada
estorvar	obstaculizar/tolher/obstruir/atrapalhar/bloquear
estourar	explodir
estrada	órbita/trilha/entrada/caminho
estrato	proletariado
estrutura	estádio/sacada/torres/varanda/alojamento/altar/letreiro/pavimento/piso/placar/ponte/prédio/roque/torre/varanda/arena/balcão/cruz/monumento/monumentos/edifício/painel/abrigo/placa/casa/andar
estudante	ouvinte
estudar	memorizar/decorar
estudioso	alumnus/dr./filósofo/historiador/historiografo/ph.d./cronista/dr./graduado/doutor
estória	boletim
etapa	centúria/decênio/década/fim-de-semana/sazão/século/séculos/manhã/mês/noitada/século/estágio/semana/continuidade/trimestre/fase/tarde/duração/era/estação/idade/época/ano/noite/tempo/período
eudemonismo	bem-estar/saúde
evento	contágio/spillover/infecção
evidência	sintoma/confirmação/trilha/pista/prova
evitar	obstaculizar/tolher/obstruir/atrapalhar/bloquear
exagerar	fanfarrear/vangloriar/vangloriar-se/ostentar
excerto	recorte/frase/citação
excitamento	sensação
excitação	sensação
exemplo	mostra/apoteose/precedente/excepção/exceção/amostra/molde/padrão/modelo
exercício	revisão/ensaio
exigir	proscrever/vetar/vedar/proibir/requerer
expandir	exemplificar/ilustrar
expedição	frete
experimentar	arrepender/arrepender-se/lamentar
expert	decorador/desenhador
experto	decorador/desenhador
expirar	afogar-se/afogar
explanação	definição/porquê/razão
explicar	elocubrar/elaborar/expandir/expor
explicação	definição/porquê/razão
explodir	estourar
expor	exemplificar/ilustrar
expressão	lemas/mote/cambial/lema
expulsar	extraditar/deportar/escorraçar/exilar/ostracizar/banir/entregar
extensão	anchura/largura
extinguir	excetuar/omitir/preterir/excluir
extrato	recorte/frase/citação/contabilidade/conta
face	superior/topo/fundo
faceta	sector/setor
fala	tom
falar	remarcar/enunciar/reparar/retrucar/notar/articular/comentar/mencionar/replicar/vocalizar/responder/dizer
falecer	afogar-se/afogar
falha	distorção/omissão/confusão
falhar	perder
fallout	queda
falsidade	mentirinha/conto/mentira/história
falta	penúria/escassez/fome/carência
fardo	pacote
farinhas	arroz/cereal/milho
fator	parâmetros/parâmetro
fazenda	lacticínios/lanígero/leitaria/leiteria/mercearia/rancho/veludo/granja/herdade/lona/roça/seda/terras/algodão/lã/renda
fazer	actuar/reproduzir/gerar/atuar/criar/trazer/representar/tocar
fechar	vedar/selar/bater
feira	supermarket/supermercados/supermercado
feito	critica/parto/juízo/rejeição/recuperação/julgamento/partida/produção
feixe	fardo/pacote
feição	disposição/atividade
fenómeno	ensejo/consequência/fortuna/conseqüência/azar/efeito/sorte/resultado/fim
fenômeno	ensejo/consequência/fortuna/conseqüência/azar/efeito/sorte/resultado/fim
ferida	corte
ferimento	corte
ferir	aferroar/apunhalar/esfaquear/lesar/danificar/machucar
ferramenta	chibata/furadeira/satélites/aparato/açoite/chicote/satélites/aparelho/armamento/satélite/equipamento/arma
ferrovia	metrô/metropolitano/metro
festa	boda/cerimónia/funeral/boda/enterro/festival/funeral/cerimônia/recepção/casamento
festividade	festival
ficcionismo	romance
ficção	romance
figura	diagrama/planta/esquema/plano
fila	filaúnica/umapósooutro/bicha
filho	bebé/criancinha/nenê/recém-nascido/criança/bebê/menino
filosofia	etica/credo/ética
fim	demolição/efeitos/placar/destruição/impacto/influência/desolação/vitória/efeito/produto/resultado
final	demolição/placar/destruição/desolação/vitória/resultado
fissura	fenda
fixar	enganchar/trancar/pendurar
flora	vegetação/jardim
fluido	líquido
fluir	entornar/verter/derramar
fofoca	boato/diz-que-diz-que/rumor/fama/renome
folhagem	folha
formar	atar
formação	aula/curso
formulário	questionário
fornecer	apetrechar/aparelhar/equipar/suprir/carregar
força	impulso/protesto/tumulto/vigor/impulso/energia/compreensão
forçar	empurrar/derrubar
foto	plano
fotografia	plano
fracassar	perder
frade	irmão
fragmento	apara
frango	galinha
freguês	assinante/subscritor/leitor
frei	irmão
frente	fachada/frontispício
fresta	fenda
fruta	noz/morango/semente
fruto	morango/semente/fruta
funcionário	diplomata/magistrado/embaixador/jurista/juiz/servidor
fundo	orçamento/depósito/base
funeral	inumação/sepultamento/enterro/sepultura
função	biscate/cargo/ofício/vocação/arte/profissão/ocupação/emprego/trabalho/posição
furto	roubalheira/roubo/assalto
futebol	râguebi/rúgbi
fábrica	casademoinho/cervejaria/manufatura/usina
fé	doutrina/expetativa/convicção/religião/filosofia/expectativa/certeza
física	electrónica/eletronica/eletrónica/eletrônica
gado	vaca
galo	galinha
ganhar	rentabilizar/lucrar
gastar	delapidar/dilapidar/esbanjar/desperdiçar
gema	diamante
genitor	progenitora/papai/papá/painho/pai/mãe
gente	galera/vulgo/nação/estrato/geração/inimigo/mundo/população/pessoal/povo/classe
gerente	gestor/director/dirigente/administrador/diretor
gestão	finança/tratamento
glória	recomendações/recomendação
golpe	murro/soco
golpear	esmurrar/chutar/bater
governar	gerir/reinar/reger
governo	corte
gradiente	ladeira/inclinação
grafema	asterisco/caracter/caractér/carácter/maiúscula/letra/espaço
grandeza	amplidão/tamanho/dimensão/medida/proporção/magnitude/grau/extensão
granja	lacticínios/leitaria/leiteria/mercearia/rancho/herdade/roça/terras/fazenda
grau	calibre/extremo/qualidade
gravação	video/vídeo/vídeos/vídeo/fita
greta	fenda
gritar	bradar/berrar
grupo	classe
gráfico	esquema
guarda	detective/detetive/policial/tira
guardar	armazenar/acumular/negar
guerreiro	guerrilha/guerrilheiro
habilidade	alfabetismo/alfabetização/competência/arte/capacidade
habitante	aldeã/aldeão/ocupante/morador/residente
habitação	bangalô/casinha/casinhola/vivenda/cabana/chalé/choça/casa
hardware	memória
hierarquia	gradação/nível/posto/grau/segundo/classe
hipótese	teoria
história	mentirinha/conto/mentira
hoje	momento
homem	cavalheiro/senhor
homemdenegócios	barao/magnata/dono/proprietário
homicídio	massacre
honra	celebridade/fama/glória/renome
hora	alvorada/meia-noite/anoitecer/aurora/madrugada/amanhecer/crepúsculo
hortaliça	aboboreira/jerimum/pepineiro/pepino/abóbora
hortifruti	verdura/hortaliça/legume/vegetal
hortifruto	verdura/hortaliça/legume/vegetal
hospital	manicomio/asilo
hostilidade	violência/tensão/força
hotel	albergaria/resort/albergue/hospedaria/pousada
humor	embevecimento/enlevo/êxtase
hábito	cooperação/costumes/tradição/costume
idade	reinado/era/época/reino/período
ideia	regulamento/atributo/noção/categoria/consideração/norma/possibilidade/soma/característica/idéia/suposição/teoria/lei/quantidade/regra/hipótese/reflexão/propriedade/qualidade/família/número/classe
idioma	lemas/mote/cambial/lema/linguagem/língua
idéia	projecto/conceito/regulamento/atributo/noção/categoria/concepção/norma/possibilidade/programação/soma/característica/suposição/tema/teoria/lei/motivo/projeto/quantidade/regra/hipótese/preocupação/propriedade/qualidade/família/ideia/intenção/programa/plano/número/classe
igreja	catedral
igrejas	catedral
igual	contemporâneo
ilustração	diagrama/planta/esquema/plano
imagem	diagrama/planta/esquema/plano
imaginação	visão/sonho
impedir	obstaculizar/tolher/obstruir/atrapalhar/bloquear
implemento	furadeira
importunar	assediar/aborrecer/molestar/irritar/provocar/incomodar
impossibilitar	obstaculizar/tolher/obstruir/atrapalhar/bloquear
incerteza	receio/desconfiança/dúvida/questão
incidente	contágio/spillover/infecção
incitar	magoar/ofender/provocar
inclinação	ladeira
incluir	abranger/compreender/conter/ter
incomodar	assediar/aborrecer/molestar/importunar/irritar/provocar
incremento	acréscimo/acumulação
indivíduo	aficionado/amadora/antagonista/cobaia/conhecida/engenheiro/habitante/homem-bomba/matador/proponente/pário/solicitante/utente/utilizador/adversário/amador/líder/morador/pretendente/sósia/usuário/adulto/candidato/cientista/escrava/especialista/espectador/igual/observador/opositor/parente/pupilo/sobrevivente/sócio/conhecido/defensor/parceiro/suspeito/advogado/amizade/assassino/autoridade/escravo/guerreiro/inimigo/radical/vizinho/aluno/caso/chefe/par/testemunha/trabalhador/amigo/estudante/representante
industria	transportação/turismo/aventura/indústria/manufatura/transporte/expedição
indício	signo
influência	compreensão
informação	curricula/divulgação/ementa/formatação/propaganda/currículo/notícia/formato/notícias/propaganda/fato/matriz/matéria/segredo/programa/artigo
iniciar	inaugurar/introduzir
inimizade	tensão
inscrever	registar/registrar
insight	descoberta/achado
instituição	caridade
instituto	caridade
instruir	reforçar/educar/preparar/treinar
instrumento	chibata/furadeira/açoite/chicote/armamento/arma
instrutor	instructor/preceptor/tutor
instrução	aula/experiência/curso
instância	mostra/precedente/excepção/exceção/amostra
inteligência	genealidade/brilho/talento
intenção	finalidade/acepção/intento/propósito/significação/matiz/objectivo/sentido/objetivo/significado/fim
interação	contato/ligação
intercorrência	cabimento/default/possibilidade/padrão
interpretação	magia/ilusão/truque
interromper	espirar/respirar
interruptor	botão
interrupção	descanso/repouso/pausa
intervalo	parada
intimidar	terrificar/horripilar/aterrorizar
intuição	coração
intérprete	actor/ator/artista
investigador	examinador/inspector/inspetor
ir	engatinhar/gatinhar/rastejar/rastejar-se/retroceder/serpear/vadiar/vagabundear/vaguear/boiar/pisar/retirar-se/devolver/pisotear/regressar/ascender/escorregar/nadar/recuar/errar/marchar/passear/perambular/vagar/deslizar/voar/apressar/retornar/acompanhar/atravessar/pular/saltar/caminhar/dirigir/correr/seguir/andar/subir/passar/cair
ira	fúria/cólera/raiva
irritar	assediar/aborrecer/molestar/importunar/provocar/incomodar
isentar	poupar
isqueiro	fósforo
itinerário	órbita/trilha
itinerários	órbita/trilha
jogar	arremessar/arremeter/brincar/atirar/lançar
jogo	competição/torneio/corrida/combate/partida/luta/classe
joia	diamante
julgamento	fogo/ataque
junta	comité/comitê/conselho/júri
junção	encruzilhada/cruzamento
justeza	corretude/justiça/direito
justiça	corretude/direito
jóia	diamante
laboratório	chácara/estudio/laboratorio/laboratórios/estúdio/granja/quinta/oficina/sítio/fazenda/trabalho
ladeira	declividade/ribeira/barranco/descida/declínio/margem
lado	superior/topo/fundo
lago	albufeira/reservatório
laje	ladrilho
lampejo	descoberta/achado
lançar	arremessar/arremeter/atirar/jogar/quebrar
lar	vivenda/habitação/casa
lealdade	patriotismo/nacionalismo
leccionar	reforçar/educar/instruir/preparar/treinar
lecionar	reforçar/educar/instruir/preparar/treinar
legenda	oposição
legislatura	parlamento/congresso/assembléia
legume	aboboreira/jerimum/pepineiro/pepino/abóbora
lei	indicações/guia/restrição/limitação
lembrar	reconhecer
lembrar-se	reconhecer
lesar	aferroar/apunhalar/esfaquear/ferir/danificar/machucar
lesionar	aferroar/apunhalar/esfaquear/lesar/ferir/danificar/machucar
lesão	picada/ferida/fractura/fratura/ferimento/queimadura/corte
letra	asterisco/caracter/caractér/carácter/maiúscula/inicial/espaço
levantar	bombear
levar	devolver/voltar/retornar/transportar/trazer/carregar/tirar
liberar	poupar
licenciar	credenciar/reconhecer
lidar	gerenciar/aguentar
liderança	administrador/executivo/gerente/frente
ligadura	gesso
limitar	constrangir/restringir/conter
limitação	restrição
limpar	escovar/varrer
linguagem	idioma/língua
lingüiça	cachorro-quente/salsicha
linha	filaúnica/umapósooutro/fila/órbita/trilha/bicha
lista	cronograma/menu/índice/agenda/pauta/horário/chave/programa
listagem	cronograma/lista/menu/índice/agenda/pauta/horário/chave/programa
literatura	romance
livro	album/apostila/folheto/livreto/opúsculo/sebenta/álbuns/brochura/caderno/catálogo/panfleto/álbum/compêndio/texto
livros	album/álbuns/caderno/álbum
lixo	detrito/negar-sea/resíduos/resíduo
loa	recomendações/recomendação
localização	regiões/ocidente/selva/floresta/espaço/região
locação	cemitérios/necrópole/regiões/campismo/cemitério/escavação/ocidente/selva/floresta/acampamento/espaço/região
locução	lemas/mote/cambial/lema
louvado	decorador/desenhador
louvor	recomendações/recomendação
lugar	biscate/cemitérios/necrópole/regiões/campismo/cemitério/escavação/ocidente/selva/cargo/ofício/vocação/arte/floresta/profissão/ocupação/acampamento/emprego/espaço/região/trabalho/posição
lutar	pugnar
luz	archote/facho/tocha/lanterna
líder	empregador/administrador/executivo/gerente/herói/político/treinador/cabeça/guia/chefe/liderança/exemplo/técnico/responsável/modelo
língua	linguagem/idioma
líquido	água
líqüido	líquido
machucado	picada/ferida/fractura/fratura/ferimento/lesão/queimadura
machucar	aferroar/apunhalar/esfaquear/lesar/ferir/danificar
madeira	tora/prancha/tábua/tronco
magnitude	amplidão/anchura/largura/tamanho/dimensão/medida/proporção/grau/extensão
mal	picada/ferida/fractura/fratura/ferimento/lesão/queimadura
malograr	perder
manar	entornar/verter/derramar
mandado	anistia/perdão
manobra	ofensiva/campanha/ataque
manter	armazenar/acumular/negar/guardar
manutenção	revisão
mapa	gráfico
maquinaria	moinhos/calculadora/maquinário/moinho/computador/imprensa/máquina
maquinário	moinhos/moinho
marcha	transmissão
marido	cônjuge/esposa/esposo/varão/mulher/homem
marrar	memorizar/decorar
martírio	agonia
massa	amontoado/monte
matar	decapitar/degolar/executar
materiais	minérios/química/thread/mineral/fibras/lixo/resíduo/condutor/fibra/substância/papel
mato	rosa/rosas/rosa
matéria	barro/geleca/gosma/lodo/líqüido/sedimento/fluido/lama/substância/depósito
mecanismo	autômato/robô/andróide/eixo/engrenagem/marcha
medicamento	terapia/dose/remédio
medo	estupefação/pânico/consternação/terror
meio	habitat/cenário
melhora	restauração/renovação
melhorar	aprimorar/reparar/emendar/lustrar/consertar/polir/refinar/reformar
melhoria	restauração/renovação/anexo/asa
melodia	tema
membro	coxa/braço/anca
menino	bebé/criancinha/nenê/recém-nascido/bebê
mensagem	agouro/indício/presságio/correio/indicação/linguagem/transmissão/discurso/idioma/língua/sinal
mensurar	cronometrar/pesar
mentira	mentirinha/conto/história
mercado	supermarket/supermercados/supermercado
mercado/mercadinho	supermarket/supermercados/supermercado
mercador	retalhista/varejista/fornecedor/vendedor/negociante/comerciante
mercadoria	estoque/inventário
mercantilismo	industria/marketing/mercadologia/tráfico/marketing/tráfego/trânsito/pagamento/empresa/negócio/comércio
mestre	instructor/preceptor/tutor
meta	alfabetismo/alfabetização/finalidade/intento/propósito/arte/objectivo/objetivo/fim/habilidade/intenção
metais	aluminio/alumínio/cobre/estanho/sodio/sódio/chumbo/cobre/ferro
metal	aluminio/alumínio/cobre/estanho/sodio/sódio/chumbo/cobre/ferro
metodo	metodologia/metodólogia/metodologia/metodologias
mexer	contorcer/enroscar/espernear/torcer-se/manar/virar-se/arremessar/dançar/estalar/fluir/flexionar/pulsar/tornar-se/tropeçar/alongar/impulsionar/esticar/dobrar/girar/pular/sacudir/saltar/tremer/sair/correr/partir/agitar/deixar/virar/separar/bater
migração	imigração
minguar	encolher
missiva	invitação/convite
mobiliário	aparelhador/cómoda/gaveteiro/candeeiro/cômoda/luminária/assento/estante/mesa/armário/cadeira
mobília	aparelhador/cómoda/gaveteiro/candeeiro/cômoda/luminária/assento/estante/mesa/armário/cadeira
modelar	atar
modelo	apoteose/molde/padrão
modificar	alargar/ativar/comercializar/desvirar/impactar/aperfeiçoar/endireitar/inverter/acertar/completar/afetar/modelar/investir/causar/formar/manchar/substituir/ajustar/corrigir/melhorar/encher/estender/trocar/reduzir/diminuir
modificação	decréscimo/falecimento/mutação/dano/estrago/flutuação/avaria/mutação/variação/prejuízo/surpresa/queda/diminuição/abatimento/morte/mudança
moeda	cache/cêntimo/numerário/centavo/divisa/dinheiro
moita	rosa/rosas/rosa
molestar	assediar/aborrecer/importunar/irritar/provocar/incomodar
molho	fardo/pacote
monarca	rei
monarquia	império/reino
monastério	abadia
monge	irmão
montanha	vulcão
montanhas	vulcão
monte	vulcão
morada	vivenda/habitação/casa
moradia	vivenda/habitação/casa
morador	aldeã/aldeão/ocupante/residente
morrer	afogar-se/afogar
morto	enchido/defunto/cadáver/corpo
mosteiro	abadia
motorista	automobilista/chofer/condutor
mover	contorcer/enroscar/espernear/torcer-se/manar/virar-se/arremessar/dançar/estalar/fluir/flexionar/pulsar/tornar-se/tropeçar/alongar/impulsionar/esticar/mexer/dobrar/girar/pular/sacudir/saltar/tremer/sair/correr/partir/agitar/deixar/virar/separar/bater
movéis	aparelhador/cómoda/gaveteiro/candeeiro/cômoda/luminária/assento/estante/mesa/armário/cadeira
mudança	decréscimo/falecimento/mutação/dano/estrago/flutuação/rotação/avaria/mutação/variação/gesto/prejuízo/surpresa/queda/diminuição/sinal/abatimento/morte
mudar	alargar/ativar/transformar-se/comercializar/desvirar/impactar/aperfeiçoar/endireitar/inverter/acertar/completar/tornar-se/afetar/modelar/investir/causar/formar/manchar/substituir/ajustar/corrigir/transformar/acontecer/melhorar/encher/estender/trocar/reduzir/virar/diminuir
mulher	dona-de-casa/namorada/viúva/dona/esposa/viuvez/menina/senhora/dama/amante/garota/rapariga
mundo	natureza
musico	maestro/compositor
máquina	moinhos/calculadora/maquinaria/maquinário/moinho/computador/imprensa
mãe	progenitora/papai/papá/painho/pai
mão	punho
médico	cirurgião
método	metodologia/metodólogia/metodologia/metodologias
métodos	metodologia/metodólogia/metodologia/metodologias
míssil	projétil/bala/flecha/seta
móvel	aparelhador/cómoda/gaveteiro/candeeiro/cômoda/luminária/assento/estante/mesa/armário/cadeira
música	aria/toada/melodia/harmonia
músico	maestro/compositor
narcotizar	envenenar
navio	batel/iate/bote/escaler/barco
navios	batel/iate/bote/escaler/barco
nação	superpoder/superpotência/aliado
neblina	bruma/névoa
necessidade	ausência/escassez/deficiência/falta/carência
negociante	barao/retalhista/varejista/magnata/mercador/dono/fornecedor/vendedor/comerciante/proprietário
negócio	transportação/turismo/aventura/indústria/manufatura/transporte/expedição
nevoeiro	bruma/névoa/neblina
nome	assinatura/visto
norma	indicações/guia/restrição/limitação
nota	acorde/acordes/menção/demissão/dólar/citação/referência
notificação	demissão
notícia	reportagem/estória/relato/artigo
notícias	reportagem/estória/relato/artigo
noção	psique/atitude/mente/cabeça
numerário	troco
nutriente	bebida
névoa	bruma/neblina
número	amplidão/menoridade/minorias/preponderância/produtos/minoria/prevalência/tamanho/dimensão/medida/proporção/magnitude/grau/produto/variável/extensão
obedecer	acatar/conformar/seguir
objectivo	finalidade/intento/propósito/objetivo/fim/intenção
objeto	amuleto/talismã/chão/filme/locação/relevo/localização/solo/terra/ponto/lugar
obreiro	mineiro/carregador/operário
obrigação	incumbência/serviço
observador	espetador/telespectador/espectador
observação	chacota/xiste/gracejo/piada
obstar	obstaculizar/tolher/obstruir/atrapalhar/bloquear
obter	beneficiar-se/re-adquirir/beneficiar/herdar/reconquistar/reganhar/auferir/colecionar/lucrar/recolher/apanhar/comprar/recuperar/coletar/ganhar/capturar/adquirir/encontrar/reunir/atingir/pegar
ocorrer	coincidir
ocultar	disfarçar/mascarar/encobrir/esconder
ocupação	biscate/cargo/ofício/vocação/arte/profissão/emprego/trabalho/posição
odiar	desprezar/desdenhar/menosprezar
ofensa	infracção/infração
oferecer	legar/doar/distribuir/deixar/entregar/passar/dar
oficina	chácara/estudio/laboratorio/laboratórios/estúdio/granja/quinta/laboratório/sítio/fazenda/trabalho
ofício	biscate/cargo/vocação/arte/profissão/ocupação/emprego/trabalho/posição
omitir	disfarçar/mascarar/encobrir/esconder
ontogenia	cultura
ontogénese	cultura
operação	ofensiva/campanha/ataque
operário	balconista/caixeiro/mineiro/carregador
opinião	doutrina/expetativa/projecto/conceito/conjectura/convicção/religião/filosofia/concepção/expectativa/programação/certeza/especulação/idéia/suposição/tema/teoria/motivo/projeto/lado/fé/hipótese/preocupação/ideia/intenção/programa/plano/posição
opositor	inimigo
opção	cabimento/default/possibilidade/padrão
ordem	guilda/clube/sociedade
ordenar	proscrever/vetar/vedar/proibir
organização	guilda/sindicalismo/sindicatos/clube/elenco/sindicato/hierarquia/associação/chapa/comissão/comité/comitê/estabelecimento/instituição/legenda/partido/delegação/economia/embaixada/missão/sociedade/instituto/pessoal/união/companhia/rede/ordem
orientador	capataz/supervisor/chefe
ornamento	laço/motivo
ornato	laço/ornamento
osso	caveira/crâneo/crânio/dentes/costela/crânio/mandíbula/dente
ouvir	grampear/interceptar
pacote	fardo
padrões	normas/escala/norma/padrão
pagar	reintegrar/remunerar/retribuir/debitar/despender/restituir/recompensar/repagar/gastar/compensar
pai	progenitora/papai/papá/painho/mãe
painho	papai/papá/pai
paixão	fervor/zelo
palanque	convés/ringue/convés/palco/teatro
palavra	nomenclatura/terminologia/vocábulo/termo
paliçada	sebe/sebes
pano	lanígero/veludo/lona/seda/algodão/lã/renda
panorama	vislumbre/fundo
papai	papá/painho/pai
papel	folhas/cartão/carta/folha
papel-moeda	dólar
papá	papai/painho/pai
par	casal/dupla/contemporâneo
parafuso	cavilha/perno
parar	espirar/respirar
parecer	troçar/reluzir/caçoar/cintilar
parente	antecessor/cónjuge/prima/consorte/cônjuge/esposa/esposo/marido/ancestral/antepassado/descendência/primo/companheiro/descendente/filho
parentesco	descendência/linhagem
parte	elemento/hardware/excedente/ingrediente/restante/adição/módulo/resíduo/sobra/melhoria/resto/substância/componente
participante	noiva
partida	despedida/competição/torneio/corrida/combate/jogo/luta
partido	oposição
passado	histórico/história
passagem	excerto/recorte/extrato/trecho/frase/citação
passar	coincidir
passeio	boleia/carona
pata	punho
pau	clava/porrete
pausa	descanso/repouso/parada
pausar	espirar/respirar
pavilhão	bandeira/estandarte
pavimento	cave/mansarda/porão/trapeira/sótão/ático
país	superpoder/superpotência/aliado
peculiaridade	disposição/atividade
pedagogia	aula/conferência/lição/curso
pedaço	viga/trave
pedido	consumo
pedir	mendigar/reservar/demandar/exigir/convidar/segurar
pegar	apreender/apanhar/furtar/agarrar/roubar/prender/segurar
penalidade	punição
penalizar	executar
penalização	punição
penca	fardo/pacote
pendão	bandeira/estandarte
pensamento	projecto/conceito/concepção/programação/idéia/tema/motivo/projeto/preocupação/ideia/intenção/programa/plano
pensar	centrar/ruminar/concentrar/associar/cogitar/conectar/relacionar/ponderar/especular/focar/contemplar/planejar/refletir
penso	gesso
perceber	enxergar/ouvir/saborear/doer/escutar/cheirar/sentir/saber/olhar/ver
percepção	tato/sensação/toque
percurso	órbita/trilha
perda	sacrifício
perecer	afogar-se/afogar
performance	magia/ilusão/truque
perito	decorador/desenhador
permitir	aturar/tolerar/aguentar/suportar/admitir/aceitar
perna	coxa/braço/anca
personalidade	identidade
persuadir	convencer
perturbar	transtornar/assediar/aborrecer/molestar/preocupar/importunar/irritar/provocar/incomodar
período	centúria/decênio/década/estio/fim-de-semana/inverno/outono/primavera/sazão/século/séculos/verão/manhã/mês/noitada/século/colheita/estágio/semana/continuidade/reinado/trimestre/fase/tarde/duração/era/estação/idade/época/reino/ano/noite/tempo
pessoa	aficionado/amadora/antagonista/cobaia/conhecida/engenheiro/habitante/homem-bomba/matador/proponente/pário/solicitante/utente/utilizador/adversário/amador/líder/morador/pretendente/sósia/usuário/adulto/candidato/cientista/escrava/especialista/espectador/igual/indivíduo/observador/opositor/parente/pupilo/sobrevivente/sócio/conhecido/defensor/identidade/parceiro/suspeito/advogado/amizade/assassino/autoridade/escravo/guerreiro/inimigo/radical/vizinho/aluno/caso/chefe/par/personalidade/testemunha/trabalhador/amigo/estudante/representante
pessoal	galera/vulgo/nação/estrato/geração/inimigo/mundo/população/gente/povo/classe
petição	aplicacao/cobrança/apelação/arrecadação/candidatura/demanda/solicitação/apelo/recurso
peça	cêntimo/viga/centavo/trave/pedaço
pia	lavabo
piorar	degenerar/degradar/deteriorar
piso	cave/mansarda/porão/trapeira/sótão/ático
pista	signo
placa	ladrilho
planejar	engenhar/maquinar/orquestrar/organizar
planta	casademoinho/cervejaria/fábrica/manufatura/usina
policial	detective/detetive/tira
polícia	detective/detetive/policial/tira
político	candidato/comunista
ponderar	questionar/perguntar
ponto	regiões/ocidente/selva/floresta/espaço/região
população	galera/vulgo/nação/estrato/geração/inimigo/mundo/gente/pessoal/povo/classe
porrada	murro/soco
porção	elemento/excedente/restante/resíduo/sobra/resto/substância/componente
posição	gradação/nacionalidade/hierarquia/nível/equilíbrio/proporção/posto/formação/grau/segundo/classe
possessão	património/patrimônio/fazenda/herança/propriedade/bem
possibilidade	teoria
posto	gradação/nível/grau/segundo/classe
postulação	aplicacao/cobrança/apelação/arrecadação/candidatura/demanda/solicitação/apelo/recurso
pote	chaleira/bule/caldeiras/chaleira
povo	galera/vulgo/nação/estrato/geração/inimigo/mundo/população/gente/pessoal/classe
prata	cêntimo/centavo
prato	salada/sopa
precariedade	dúvida/questão
preconceito	racismo
predizer	apostar
premissa	pré-condição/estipulação/roteiro/cenário/condição
premonição	coração
prender	emprisonar/encarcerar/engaiolar/incarcerar/enganchar/aprisionar/trancar/pendurar
prenome	assinatura/visto
prensar	esmagar/espremer/apertar
preparar	preservar/conservar
preparação	prática/exercício/marcha
presente	galardão/prémio/prêmio/ajuda/momento
preso	refém
pressentir	apostar
pressionar	esmagar/espremer/apertar
pressuposto	pré-condição/estipulação/roteiro/cenário/condição
pretender	pressentir/prognosticar/adivinhar/predizer/prever
pretensão	capricho/comichão/impertinência/ambição/caprichoso/aspiração/fantasia/desejo
prever	apostar
prezar	admirar/estimar
princípio	lógica
prisioneiro	refém
problema	escândalo
procedimento	ramerrão/rotina/fórmula/regra
processo	ramerrão/rotina/fórmula/regra
procurar	arriscar
produto	estoque/inventário
produzir	reproduzir/gerar/criar/trazer/fazer
professor	instructor/preceptor/tutor
profissional	jurista/advogado/crítico
profissão	biscate/cargo/ofício/vocação/arte/ocupação/emprego/trabalho/posição
progenitor	progenitora/papai/papá/painho/pai/mãe
prognosticar	apostar
programa	telejornais/episódio/notícias/horário
proibir	obstaculizar/tolher/obstruir/atrapalhar/bloquear
projeto	aventura/tarefa
projéctil	projétil/bala/flecha/seta
projétil	bala/flecha/seta
promessa	noivado/palavra/casamento
promover	favorecer/preferir
promoção	reclame/reclamo/propaganda/publicidade/anúncio
propaganda	filipeta/reclame/panfleto/reclamo/publicidade/anúncio
proponente	porta-voz/representante
proporção	percentagem/percento/porcentagem
propriedade	património/especialidade/patrimônio/característica/fazenda/herança/qualidade/recurso/bem
prosperidade	boom
proteger	salvaguardar/assegurar/salvar/defender/guardar/segurar
protesto	manifestação
proteção	seguros/seguro
prova	crisma/confirmação/verificação
provar	validar/demonstrar
prover	apetrechar/aparelhar/equipar/suprir/carregar
provocar	magoar/ofender
provérbio	lemas/mote/cambial/lema
prática	revisão/ensaio
pré-conceito	racismo
prédio	escolas/plantel/vivenda/estufa/hall/hotel/restaurante/dormitório/viveiro/biblioteca/colégio/departamento/habitação/ruína/salão/centro/escola/casa
psiquê	assombração/aparição/espectro/fantasma
publicação	referência/livro
publicidade	filipeta/reclame/panfleto/reclamo/propaganda/anúncio
punir	executar
pupilo	ouvinte
puxar	arrastar/atrair
pário	contemporâneo
pão	toste/pãozinho/torrada
pôr	deitar/semear/instalar/dispor/plantar/arranjar/perder/colocar/carregar
qualidade	faceta/característica
quantidade	produtos/produto/variável
quantificar	cronometrar/pesar
quarto	antecâmara/antessala/compartimento/estudio/calabouço/hall/masmorra/saguão/vestíbulo/átrio/dormitório/bar/cela/escritório/cozinha/galeria/banheiro/sala/classe
queimar	incendiar/acender
querela	controvérsia/disputa/discussão
querer	ansiar/suspirar/desejar
quinta	lacticínios/leitaria/leiteria/mercearia/rancho/granja/herdade/roça/terras/fazenda
quitanda	supermarket/supermercados/supermercado
quitar	aposentar-se
racha	fenda
raciocinar	centrar/ruminar/concentrar/associar/cogitar/conectar/relacionar/ponderar/especular/focar/contemplar/planejar/refletir
radical	terrorista
raiva	fúria/ira/cólera
raiz	cenoura
raíz	cenoura
rebaixamento	queda
receber	beneficiar-se/re-adquirir/beneficiar/herdar/reconquistar/reganhar/auferir/colecionar/lucrar/recolher/apanhar/comprar/recuperar/coletar/ganhar/capturar/obter/adquirir/encontrar/reunir/atingir/pegar
recepção	hospitalidade
reclame	filipeta/panfleto
reclamo	filipeta/panfleto
recomendação	repreensão
reconfortar	tranqüilizar/aquietar/silenciar/tranquilizar/acalmar
reconhecimento	comemoração
recontro	desacordo/discordo/rixa/atrito/fricção/discordância
recordar	reconhecer
recordar-se	reconhecer
recrutar	inscrever/registar/registrar
recurso	especialidade
rede	armadilha
redigir	subscrever/visar/assinar
reduzir	encurtar/resumir/condensar/abreviar/diminuir
redução	disconto/desconto/abatimento/corte
refeição	almoço/buffet/ceia/comerembanquete/desjejum/lanche/pequeno-almoço/merenda/ágape/banquete/jantar
referência	alvo
refletir	centrar/ruminar/concentrar/associar/cogitar/conectar/relacionar/ponderar/especular/focar/questionar/contemplar/perguntar/planejar
regalar	legar/doar/distribuir/deixar/entregar/passar/dar
reger	gerir/governar/reinar
regime	corte
registar	inscrever/registrar
registrar	inscrever/registar
região	cima/circunscrição/comarca/districto/tumba/túmulo/cume/distrito/sepultura/território/pico/junção/topo/zona/domínio
regiões	circunscrição/comarca/districto/distrito/território/domínio
regra	indicações/guia/restrição/limitação
regulamento	indicações/guia/restrição/limitação
relato	boletim
relação	descendência/linhagem
relevo	florestas/arvoredo/selva/bosque/ilha/mata/floresta
relógio	despertador
relógios	despertador
remuneração	portagem/pedágio/comissão/entrada
remédio	terapia/dose/medicamento
renunciar	aposentar-se
renúncia	imunidade
repasto	almoço/buffet/ceia/comerembanquete/desjejum/lanche/pequeno-almoço/merenda/ágape/banquete/jantar
repetição	ciclo
representante	delegada/intermediária/mostra/delegado/precedente/excepção/exceção/porta-voz/amostra/agente
reproduzir	fotocopiar/xerocar/replicar/simular/copiar/imitar/repetir
reprodução	replicação/réplica
república	superpoder/superpotência/aliado
requerer	mendigar/reservar/demandar/exigir/convidar/pedir/segurar
requerimento	aplicacao/cobrança/apelação/arrecadação/candidatura/demanda/solicitação/apelo/recurso
requisitar	mendigar/reservar/demandar/exigir/convidar/pedir/segurar
requisição	aplicacao/cobrança/apelação/arrecadação/candidatura/demanda/solicitação/apelo/recurso
residência	vivenda/habitação/casa
resignar	aposentar-se
resolver	seleccionar/adjudicar/selecionar/decidir/julgar/escolher
respeitar	admirar/estimar
respirar	bocejar/soluçar/suspirar
responsável	administrador/executivo/gerente
resposta	auto-alimentação/retorno/parecer
restaurante	cafés/cafeteria/lanchonete/café
restringir	constrangir/conter
resultado	auto-alimentação/demolição/efeitos/placar/destruição/impacto/influência/desolação/retorno/vitória/efeito/produto/parecer
resumo	sinopse/sumário
resíduo	detrito/negar-sea/resíduos/lixo
reter	armazenar/acumular/negar/guardar
retificação	compensação
retrato	plano
reunião	sessão/encontro/visita
revalidar	validar/demonstrar
rito	nupcias/casamento
ritual	nupcias/casamento
rodovia	entrada/caminho
romper	quebrar
rota	órbita/trilha
roubar	extorquir
roubo	roubalheira/assalto
ruminar	ponderar/questionar/perguntar
ruído	baterpalmas/explosão
saber	dominar
sacolão	supermarket/supermercados/supermercado
sacudir	abanar/flabelar/ventilar/estremecer/tremular/tiritar/tremer
sala	antecâmara/antessala/compartimento/estudio/calabouço/hall/masmorra/saguão/vestíbulo/átrio/dormitório/bar/cela/escritório/cozinha/galeria/quarto/banheiro/classe
salpicar	borrifar
salsicha	cachorro-quente
sanção	laissez-passer/passe
sapato	alpercata/sandália/chinelo
sargeta	tremonha
satisfação	ufania/soberba/orgulho
saudação	bem-vindo/recebimento/recepção
sazão	estio/inverno/outono/primavera/verão/colheita
saúde	bem-estar
sebenta	introdução
secreção	perspiração/sudorese/suor/transpiração
segmento	curva
segurança	salvação
segurar	apreender/armazenar/apanhar/acumular/furtar/negar/agarrar/guardar/roubar/prender
seleccionar	eleger/peneirar/analisar/selecionar/votar/decidir/escolher
selecionar	eleger/peneirar/analisar/votar/decidir/escolher
selo	selodocorreio/selos
semblante	aspecto/efeito/cor/rosto/aparência/impressão
semelhança	análogo
semente	noz/fruta
sentar	acocorar/acocorar-se/baixar-se/agachar
sentar-se	acocorar/acocorar-se/baixar-se/agachar
sentimento	zanga/consternação/espírito/ira/cólera/temor/raiva/terror/humor/medo/alegria
sentir	arrepender/arrepender-se/lamentar
separação	divorcio/divórcio
sequência	gene/genes/guen
seqüência	gene/genes/guen
ser	cria/embriões/predadores/embrião/prole/filhote/presa
serventuário	diplomata/magistrado/embaixador/jurista/juiz/servidor
servidor	manequim/secretário/secretária/modelo
serviço	biscate/cargo/ofício/vocação/arte/profissão/ocupação/emprego/trabalho/posição
seção	curva
shopping	boutique/loja/venda
show	película/cinema/filme/emissão/atração/produção/programa
significado	acepção/significação/matiz/sentido/intenção
significação	acepção/matiz/sentido/significado/intenção
significância	acepção/significação/matiz/sentido/significado/intenção
simbolo	numeral/vareta/símbolo/selo/número
similardidade	análogo
sina	falhanço/falha
sinal	numeral/simbolo/símbolos/vareta/aceno/emblema/telefone/símbolo/selo/número
sintoma	fèbre/náuseas/síndroma/síndrome/náusea/febre
sistema	economia/rede
situação	ascendencia/repto/ambiência/delinquência/dominancia/melhora/preservação/superioridade/motivação/saúde/complicação/conforto/melhoria/necessidade/ar/atmosfera/bagunça/culpa/desafio/equilíbrio/perigo/segurança/carência/tensão/controle/domínio/ordem
soberano	rei
sobremesa	pudim
sobretudo	paleto/jaqueta
sobreviver	gerenciar/aguentar
sociedade	guilda/clube/civilização/cultura/ordem
socorrer	assistir/ajudar/servir
socorro	apoio/mão/ajuda/suporte/serviço
software	programa
solicitar	mendigar/reservar/demandar/exigir/convidar/pedir/segurar
solicitação	aplicacao/cobrança/apelação/arrecadação/candidatura/demanda/apelo/recurso
solo	areia/argila/florestas/greda/arvoredo/lama/selva/bosque/ilha/mata/floresta/lama
soltar	carpir/lamentar-se/latir/urrar/bramir/gemir/ladrar/rugir/gemer/uivar/berrar/gritar
soma	produtos/produto/variável
sonho	pesadelo/íncubo
sorte	falhanço/falha
status	nacionalidade/hierarquia/posto/classe/posição
subida	declividade/ribeira/barranco/descida/declínio/margem
subir	galgar/trepar/ascender/montar
substanciar	validar/demonstrar
substância	barro/geleca/gosma/lodo/líqüido/materiais/sedimento/átomo/fluido/lama/depósito
suceder	coincidir
sugestão	signo
sumir	caldear/desaparecer
sumário	sinopse/resumo
superar	sobrepujar/sacanear/trapacear/ultrapassar/exceder/derrotar/roubar
superfície	exterior/face/lado
superioridade	supremacia/monopólio/domínio
supermercado	supermarket/supermercados
supervisor	capataz/chefe
supor	pressentir/prognosticar/adivinhar/predizer/prever
suportar	validar/demonstrar/engolir/aceitar
suporte	aprovaçã0/degrau/pedestal/prateleira/estante/barra/aprovação/pé/base
suposição	teoria
suprir	apetrechar/aparelhar/equipar/carregar
suserano	rei
suspensão	descanso/repouso/pausa
sustentar	validar/demonstrar
século	era/idade/época/período
símbolo	numeral/selodocorreio/selos/vareta/selo/número
símbolos	numeral/vareta/símbolo/selo/número
sítio	cemitérios/lacticínios/leitaria/leiteria/mercearia/necrópole/rancho/campismo/cemitério/escavação/granja/herdade/roça/terras/acampamento/fazenda
tablado	convés/ringue/convés/palco/teatro
talento	alfabetismo/alfabetização/arte/habilidade
tampar	disfarçar/mascarar/embrulhar/embalar/encobrir/esconder/cobrir
tapar	disfarçar/mascarar/encobrir/esconder
tarefa	aventura
tarraxa	cavilha/perno/parafuso
taxa	portagem/pedágio/comissão/entrada
tecido	estádio/lanígero/sacada/torres/varanda/veludo/alojamento/altar/letreiro/lona/pavimento/piso/placar/ponte/prédio/roque/seda/torre/varanda/arena/balcão/cruz/monumento/monumentos/algodão/edifício/lã/painel/abrigo/renda/placa/casa/andar
tecnologia	informática
telefone	ramal
telhado	domo/cúpula
temor	estupefação/pânico/consternação/terror/medo
temperamento	otimismo/identidade/personalidade
temperatura	frio
templo	catedral
tempo	centúria/decênio/década/estio/fim-de-semana/inverno/outono/primavera/sazão/século/séculos/verão/manhã/mês/noitada/século/vento/colheita/estágio/semana/clima/continuidade/trimestre/fase/tarde/duração/era/estação/idade/época/ano/noite/período
tendência	simpatia/direção/compreensão
tentar	arriscar
ter	reter/guardar/segurar/manter
termo	nomenclatura/terminologia/vocábulo/palavra
terra	areia/argila/florestas/greda/arvoredo/lama/selva/bosque/ilha/mata/floresta/lama
terreno	prados/cercado/clareira/grama/gramado/pátio/relva/jardim/quintal/prado
território	empreendimento
terror	estupefação/pânico/consternação/medo
teto	domo/cúpula
texto	missiva/rascunho/melodia/carta/introdução/linha
tirar	devolver/voltar/arrastar/retornar/atrair
toa	cabo
toada	tema
tocar	oscular/prensar/beijocar/golpear/beijar/afagar/colidir/pressionar/apertar/atingir/bater
tolerar	engolir/aceitar
tom	acorde/acordes
tomar	bebericar/sorver
tormento	agonia
tornar-se	rolar/girar/virar
torneio	competição/corrida/combate/partida/jogo/luta
tortura	agonia
trabalhador	criado/fura-greve/mineiro/assalariado/ajudante/carregador/assistente/empregado/voluntário/servidor/operário
trabalho	biscate/chácara/estudio/laboratorio/laboratórios/estúdio/granja/quinta/cargo/laboratório/oficina/ofício/vocação/sítio/arte/profissão/ocupação/emprego/fazenda/posição
tradição	costumes/costume/hábito
tradições	costumes/tradição/costume/hábito
transação	comercialismo/transacção/mercantilismo/negócio/comércio
transferência	baldeação/correspondência/conexão
transformar	transformar-se/tornar-se/acontecer/virar
transmutar	transformar-se/tornar-se/transformar/acontecer/virar
transportar	devolver/voltar/retornar/trazer/levar/carregar/tirar
transportação	frete
transporte	baldeação/frete/correspondência/conexão
tratar	amimar/destratar/mimar/abusar/mimosear/maltratar/afagar
traumatismo	picada/ferida/fractura/fratura/ferimento/lesão/queimadura
trazer	devolver/voltar/retornar
traço	bochecha/chinchilla/mento/testa/têmpora/queixo
trecho	recorte/frase/citação
treinamento	prática/exercício/marcha
treino	prática/exercício/marcha
tremer	abanar/flabelar/ventilar/estremecer/tremular/tiritar
trevas	escuridão
tribuna	convés/ringue/convés/palco/teatro
tronco	bolbo/galho/ramo/cebola
trâmite	caminho
tumores	neoplasia/tumor
técnica	alfabetismo/alfabetização/metodologia/metodólogia/metodologia/metodologias/arte/habilidade
têxteis	lanígero/veludo/lona/seda/algodão/lã/renda
título	subtítulo/legenda/lenda/direito
ultrapassar	sobrepujar/sacanear/trapacear/exceder/derrotar/superar/roubar
universo	natureza
união	guilda/clube/sociedade/ordem
usina	casademoinho/cervejaria/fábrica/manufatura
usuário	consumidor
utente	consumidor
utilizador	consumidor
vacas	vaca
vantagem	especialidade/recurso
vara	clava/porrete
variação	decréscimo/falecimento/mutação/dano/estrago/flutuação/avaria/mutação/prejuízo/surpresa/queda/diminuição/abatimento/morte/mudança
variável	vectores/vector/vetor
vasilha	caçamba/cuba/cubeta/garrafa/tina/balde/barril/biberão/botelha/frasco/tonel/banheira/barril/pote/garrafa/tigela
vasilhame	caçamba/cuba/cubeta/garrafa/tina/balde/barril/biberão/botelha/frasco/tonel/banheira/barril/pote/vasilha/garrafa/tigela
vaso	caçamba/cuba/cubeta/garrafa/tina/balde/barril/biberão/botelha/frasco/tonel/banheira/barril/pote/vasilha/garrafa/tigela
vegetal	aboboreira/jerimum/pepineiro/pepino/abóbora
vegetação	jardim
vencer	sobrepujar/sacanear/trapacear/ultrapassar/exceder/derrotar/superar/roubar
venda	almoeda/arrematação/hasta/leilão
venerar	admirar/estimar
vento	aragem/maresia/zefir/zéfiro/brisa
verbo	nomenclatura/terminologia/vocábulo/termo/palavra
verdura	aboboreira/jerimum/pepineiro/pepino/abóbora
verter	gotejar/pingar
vexar	assediar/aborrecer/molestar/importunar/irritar/provocar/incomodar
veículo	ambulancia/foguetes/rojão/taxi/ambulância/compacto/táxi/foguete
via	entrada/caminho
viajar	engatinhar/gatinhar/rastejar/rastejar-se/retroceder/serpear/vadiar/vagabundear/vaguear/boiar/pisar/retirar-se/devolver/regressar/ascender/escorregar/nadar/recuar/errar/perambular/vagar/deslizar/voar/apressar/retornar/visitar/acompanhar/atravessar/pular/saltar/caminhar/dirigir/correr/seguir/ir/andar/subir/passar/cair
vianda	enchidos/lingüiça/bife/salsicha/carne
viatura	ambulancia/foguetes/rojão/taxi/ambulância/compacto/táxi/foguete
violência	impulso/protesto/tumulto/vigor/impulso/energia
virar	rolar/girar
virar-se	gerenciar/aguentar/rolar/girar/virar
virtude	virtudes/especialidade/recurso
visita	convidado/hóspede/visitante
visitante	convidado/hóspede
vista	vislumbre/fundo
vivenda	bangalô/casinha/casinhola/cabana/chalé/choça
viés	racismo
voar	disparar
vocábulo	nomenclatura/terminologia/termo/palavra
volume	teor/conteúdo/capacidade
vítima	baixa
zanga	fúria/ira/cólera/raiva
álcoois	vinho
álcool	vinho
área	cima/tumba/túmulo/cume/sepultura/espectro/pico/junção/topo/zona
árvore	carvalho-vermelho/carvalho/palma/palmeira
égua	pônei
época	reinado/era/idade/reino/período
órbita	espectro
órgão	ala/asa/língua
