abandonar	desamparar/aposentar-se/demitir-se/quitar/desertar/resignar/renunciar/deixar
abarcar	abranger/incluir/compreender/conter/ter
abastecer	apetrechar/aparelhar/equipar/suprir/alimentar/servir/carregar/dar
abordar	endereçar/lidar/tratar/falar/cobrir
aborrecer	assediar/molestar/importunar/irritar/provocar/incomodar
abster	jejuar
abster-se	jejuar
acabar	pifar/quebrar/cair
acalmar	tranqüilizar/aquietar/silenciar/tranquilizar
aceitar	resignar-se/submeter-se/adoptar/reconciliar/resignar/consentir/adotar/submeter/permitir/concordar/deixar
acelerar	correr
acertar	estapear/sintonizar/chibatar/açoitar/chicotear/afinar/regular/ajustar/bater
achar	prezar/constatar/respeitar/venerar/averiguar/enumerar/situar/localizar/contar/descobrir/encontrar
acobertar	disfarçar/mascarar/encobrir/esconder
aconselhar	dissuadir/exortar/impelir/urgir
acontecer	coincidir
acordar	firmar/conciliar/reconciliar/concordar
acorrer	assistir/ajudar/servir
acreditar	crer/engulir
acumular	arrecadar
acusar	culpabilizar/culpar
adaptar	domar/domesticar/naturalizar/cultivar
adaptar-se	condizer/obedecer/igualar/corresponder/combinar
adequar	domar/domesticar/naturalizar/cultivar
adequar-se	condizer/obedecer/igualar/corresponder/combinar
adiar	delongar/pospor/postergar/protelar/prorrogar/procrastinar/atrasar
adivinhar	pressentir/prognosticar/apostar/predizer/prever
administrar	chefiar/supervisar/supervisionar/conduzir
adquirir	beneficiar-se/re-adquirir/beneficiar/herdar/marrar/reconquistar/reganhar/auferir/colecionar/estudar/lucrar/recolher/apanhar/comprar/recuperar/coletar/ganhar/capturar/obter/encontrar/reunir/atingir/pegar
advertir	ameaçar/direcionar
afagar	lamber
afectar	estressar/tensionar
aferrar	aconchegar/acomodar
afetar	estressar/comover/disturbar/tensionar/emocionar/impressionar/perturbar
afirmar	clamar/declarar
aflorar	vazar
afrontar	resistir
afundar	relaxar
agarrar	abocanhar/apreender/beliscar/mordiscar/espremer/morder/apanhar/apertar/furtar/capturar/roubar/prender/segurar/pegar
agastar	assediar/aborrecer/molestar/importunar/irritar/provocar/incomodar
agenciar	pechinchar/regatear
agir	troçar/atrever/atrever-se/ousar/participar/premiar/virar-se/voluntariar/caçoar/recompensar/repagar/compartilhar/aguentar/lidar/sobreviver/tentar/brincar/procurar/oferecer/jogar
agitar	abanar/flabelar/ventilar/estremecer/tremular/tiritar/tremer/bater
agradar	aprazer/comprazer/embevecer/gostar/encantar/satisfazer
agradecer	apreciar
agredir	estuprar/violentar/injuriar/assaltar/desonrar/insultar/atacar
aguardar	adiar
aguentar	gerenciar/engolir/resistir/aceitar
ajudar	acorrer/respaldar/sanar/endossar/sarar/secundar/socorrer/curar/apoiar/assistir/auxiliar/aprovar/servir
ajuntar	catar/colher/apanhar
ajustar	condizer/sintonizar/obedecer/domar/domesticar/afinar/naturalizar/cultivar/igualar/corresponder/regular/combinar
alegrar	recrear/divertir
aleijar	lesionar/lesar/ferir/machucar
alentar	conclamar/exortar/recrear/inspirar/divertir/incentivar/alimentar
alertar	ameaçar
alimentar	pastar
aliviar	tranqüilizar/aquietar/silenciar/tranquilizar/acalmar
alterar	alargar/ativar/confromar-se/ruir/transmutar/adaptar-se/adequar-se/comercializar/desvirar/impactar/modernizar/aperfeiçoar/colapsar/desabar/endireitar/inverter/acertar/completar/converter/afetar/modelar/ferver/investir/causar/formar/manchar/desmoronar/substituir/ajustar/corrigir/transformar/melhorar/encher/estender/trocar/reduzir/mudar/quebrar/diminuir
alçar	bombear
amanhar	produzir/fazer
amedrontar	terrificar/horripilar/aterrorizar
amolar	assediar/aborrecer/molestar/importunar/irritar/provocar/incomodar
ampliar	intensificar/estender/aumentar
analizar	comparar/examinar/experimentar
andar	engatinhar/gatinhar/rastejar/rastejar-se/retroceder/serpear/vadiar/vagabundear/vaguear/boiar/pisar/retirar-se/devolver/pisotear/regressar/ascender/escorregar/nadar/recuar/errar/marchar/passear/perambular/vagar/deslizar/voar/apressar/retornar/acompanhar/atravessar/pular/saltar/caminhar/dirigir/correr/seguir/ir/subir/passar/cair
anexar	fixar/amarrar/atar/prender
animar	recrear/divertir
ansiar	suspirar/desejar
antecipar	conjecturar/hipotetizar/teorizar/pressupor/presumir/especular/supor/assumir
antipatizar	detestar/odiar/ressentir
anular	cassar/rescindir/reverter/revogar/cancelar
anunciar	postar
apagar	retirar/cortar
aparecer	vazar
aperceber	enxergar/ouvir/saborear/doer/escutar/cheirar/sentir/saber/olhar/ver
aperceber-se	enxergar/ouvir/saborear/doer/escutar/cheirar/sentir/saber/olhar/ver
aperfeiçoar	aprimorar/reparar/emendar/lustrar/consertar/polir/refinar/reformar/melhorar
apertar	atarrachar/rosquear/comprimir/esmagar/espremer/contrair
apiedar	preocupar-se
apiedar-se	preocupar-se
apinhar	pulular
apoiar	acorrer/respaldar/endossar/secundar/justificar/perdoar/socorrer/racionalizar/assistir/auxiliar/aprovar/explicar/ajudar
aporrinhar	assediar/aborrecer/molestar/importunar/irritar/provocar/incomodar
apostar	jogar
aprender	marrar/estudar
apresentar	actuar/desvirar/distorcer/manifestar/demonstrar/expor/atuar/exibir/revelar/descobrir/enrolar/mostrar/trazer/representar/tocar/fazer
apressar	correr
apressar-se	correr
aprovar	consentir/permitir/concordar/deixar
aprumar	acamar/deitar-se/curvar-se/estender-se/levantar-se/inclinar
arguir	altercar/indispor-se/opor-se/querelar/porfiar/opor/disputar
argüir	altercar/indispor-se/opor-se/querelar/porfiar/opor/disputar
arranjar	agavelar/coordenar/empilhar/acumular/organizar
arrebentar	britar/estilhaçar/destroçar/estourar/explodir
arredar	arrastar/atrair
arremessar	quebrar
arremeter	arremessar/jogar
arrogar	apropriar-se/conquistar/capturar
arrombar	britar/estilhaçar/destroçar
arrostar	resistir
ascender	galgar/trepar/montar/subir
assaltar	bombardear/estuprar/violentar/desonrar/bombear/atacar
assear	lavar
assessorar	dissuadir/exortar/impelir/urgir
assistir	ajudar/servir
assombrar	estarrecer/pasmar/surpreender
assoprar	ofegar/bufar
assustar	terrificar/horripilar/aterrorizar
atacar	bombardear/estuprar/violentar/injuriar/assaltar/desonrar/bombear/insultar
atemorizar	terrificar/horripilar/aterrorizar
aterrorizar	terrificar/horripilar
atingir	efectuar/conseguir/efetuar/negociar/suceder/alcançar/obter/realizar/passar
atirar	balear/arremessar/arremeter/disparar/jogar/lançar/quebrar
atrair	cativar/deliciar/deleitar/fascinar/encantar
atuar	troçar/atrever/atrever-se/ousar/participar/premiar/virar-se/voluntariar/caçoar/recompensar/repagar/compartilhar/aguentar/lidar/sobreviver/tentar/procurar/oferecer
aturar	engolir/aceitar
auferir	rentabilizar/lucrar
aumentar	fanfarrear/vangloriar/vangloriar-se/ampliar/ostentar/prolongar/florescer/intensificar/expandir/estender/subir
autorizar	credenciar/deferir/sancionar/licenciar/certificar/aprovar/reconhecer
auxiliar	assistir/ajudar/servir
avaliar	hierarquizar/ranquiar/antecipar/medir/classificar/estimar/pensar/escolher/achar
avançar	favorecer/preferir
avariar	deteriorar/estragar
aventurar	pressentir/prognosticar/adivinhar/predizer/prever
avisar	dissuadir/exortar/impelir/urgir/ameaçar
bafejar	bocejar/soluçar/suspirar
bagunçar	misturar
baixar	naufragar/descer/afundar/derrubar/pôr/cair
balancear	compensar
balizar	hierarquizar/ranquiar/antecipar/medir/classificar/estimar/avaliar/pensar/escolher/achar
bastar	qualificar-se/qualificar
bater	esmurrar/estapear/oscular/prensar/beijocar/chibatar/sobrepujar/açoitar/chicotear/golpear/beijar/sacanear/trapacear/afagar/colidir/pressionar/ultrapassar/exceder/apertar/chutar/derrotar/superar/roubar/atingir
beber	bebericar/sorver
berrar	bradar/gritar
bloquear	obstaculizar/tolher/obstruir/atrapalhar
bolear	embobinar/enrolar
botar	deitar/semear/instalar/dispor/plantar/arranjar/pôr/perder/colocar/carregar
brigar	pugnar/lutar/resistir
cair	naufragar/descer/afundar/derrubar/pôr
calcular	multiplicar/cobrar
calotear	roubar
caminhar	engatinhar/gatinhar/rastejar/rastejar-se/retroceder/serpear/vadiar/vagabundear/vaguear/boiar/pisar/retirar-se/devolver/pisotear/regressar/ascender/escorregar/nadar/recuar/errar/marchar/passear/perambular/vagar/deslizar/voar/apressar/retornar/acompanhar/atravessar/pular/saltar/dirigir/correr/seguir/ir/andar/subir/passar/cair
canalizar	estacionar
cancelar	cassar/rescindir/reverter/revogar/anular
capotar	dormitar/cochilar
capturar	abduzir/apreender/raptar/seqüestrar/sequestrar/apanhar/furtar/agarrar/roubar/prender/segurar
carregar	deitar/semear/instalar/dispor/plantar/arranjar/transportar/pôr/perder/trazer/levar/colocar/tirar
castigar	executar
causar	contagiar/incutir/concitar/elicitar/engendrar/filmar/infetar/infundir/infectar/procriar/recriar/copiar/gerar/compor/formar/escrever/estimular/incitar/organizar/dirigir/provocar/fazer
caçoar	brincar
cerrar	vedar/selar/bater
certificar	credenciar/reconhecer
chatear	assediar/aborrecer/molestar/importunar/irritar/provocar/incomodar
chegar	aterrar/aterrissar/pousar
clamar	indiciar/denunciar/acusar
classificar	estereotipar/denominar/chamar/nomear
cobrir	embrulhar/pintar/embalar
cochilar	dormitar
cogitar	centrar/ruminar/concentrar/associar/conectar/relacionar/ponderar/especular/focar/questionar/contemplar/perguntar/planejar/refletir
coletar	arrecadar/catar/colher/apanhar
coligir	catar/colher/apanhar
colocar	deitar/semear/instalar/dispor/plantar/arranjar/pôr/perder/carregar
colorir	enrubescer/rosar/ruborizar/corar/avermelhar
comandar	proscrever/vetar/vedar/proibir
combinar	assemelhar-se/assemelhar/balancear/equilibrar/compensar/parecer
comer	papar/jantar/devorar
comerciar	exportar/importar
começar	inaugurar/introduzir
comover	atemorizar/amedrontar/assustar/disturbar/aterrorizar/emocionar/intimidar/impressionar/perturbar
compadecer	preocupar-se
compadecer-se	preocupar-se
compelir	coagir/obrigar/forçar
competir	jogar
completar	alagar/estofar/encharcar/estufar/inundar/encher
comportar-se	troçar/caçoar
comprar	beneficiar-se/re-adquirir/beneficiar/herdar/reconquistar/reganhar/auferir/colecionar/lucrar/recolher/apanhar/recuperar/coletar/ganhar/capturar/obter/adquirir/encontrar/reunir/atingir/pegar
compreender	solucionar/ler/resolver
comprender	solucionar/resolver
comprimir	asfixiar/estrangular
computar	multiplicar/cobrar
comungar	rezar/orar
comunicar	indagar/anuir/assentir/redigir/solicitar/requisitar/perguntar/requerer/saudar/escrever/pedir/falar/dizer
conceber	descobrir/achar
conceitualizar	descobrir/achar
concitar	desencaminhar/engodar/magoar/ofender/seduzir/incitar/atrair/provocar
concluir	encerrar/finalizar/acabar/terminar
concordar	assemelhar-se/pactuar/assemelhar/firmar/compactuar/conciliar/reconciliar/comprometer/consentir/permitir/parecer/deixar
concorrer	jogar
conduzir	encabeçar/liderar/comandar
confeccionar	tricotar/urdir/assar/cozinhar/fiar/tecer/moldar/forjar/modelar/formar/preparar
confinar	emprisonar/encarcerar/engaiolar/incarcerar/aprisionar/prender
confirmar	validar/demonstrar
confortar	tranqüilizar/aquietar/silenciar/tranquilizar/acalmar
confromar-se	condizer/obedecer/igualar/corresponder/combinar
confrontar	encarar
confundir	enganar-se/tropeçar
conhecer	realizar/compreender/entender
conseguir	efectuar/efetuar/negociar/suceder/alcançar/obter/realizar/atingir/passar
consentir	aturar/tolerar/aguentar/permitir/suportar/concordar/admitir/aceitar/deixar
considerar	prezar/respeitar/venerar
consignar	empenhar
consolar	tranqüilizar/aquietar/silenciar/tranquilizar/acalmar
constituir	nomear
construir	erigir/tricotar/urdir/assar/cozinhar/fiar/tecer/moldar/reproduzir/forjar/gerar/modelar/formar/estabelecer/preparar/criar/trazer/fazer
consumir	deglutir/ingurgitar/luxuriar/papar/fumar/beber/engolir/comer/experimentar/provar/tomar
contabilizar	cobrar
contar	divagar/remarcar/descerrar/enunciar/reparar/retrucar/divulgar/notar/articular/somar/cobrar/comentar/mencionar/replicar/vocalizar/responder/adicionar/revelar/dizer
contemplar	ponderar/questionar/perguntar
conter	denegar/abranger/constrangir/privar/incluir/proibir/negar/recusar/restringir/rejeitar/compreender/ter
contestar	apelar/desafiar/disputar
continuar	persistir/abranger/perseverar/prolongar/alongar/sustentar/atravessar
contradizer	negar
contrair	asfixiar/estrangular
contrariar	decepcionar/desapontar/desiludir
controlar	instigar/conquistar/sufocar/reprimir/suprimir/limitar/restringir/conter/provocar
conversar	cochichar/balbuciar/rosnar/sussurrar/resmungar/discutir/murmurar/berrar/cantar/gritar
correr	concorrer/disputar/entornar/verter/derramar/esfregar
corresponder	assemelhar-se/assemelhar/parecer
corrigir	sintonizar/afinar/regular/ajustar
corroborar	validar/demonstrar
cortar	rascar/coçar/decepar/raspar/picar
cozinhar	preservar/conservar
crer	engulir
crescer	germinar/prolongar/florescer/expandir/subir/aumentar
criar	concitar/elicitar/engendrar/filmar/pincelar/pintar/procriar/recriar/reproduzir/copiar/gerar/compor/formar/escrever/estimular/incitar/desenvolver/organizar/dirigir/trazer/provocar/fazer
criticar	delatar/culpar/denunciar/acusar/censurar/repreender
cuidar-se	barbear-se/barbear/raspar
cultivar	produzir/fazer
curvar	acovardar/acovardar-se/debruçar/agachar/inclinar/dobrar
cuspir	tossir
danificar	deteriorar/estragar
dar	contagiar/legar/arrendar/emprestar/infetar/prestar/doar/infectar/alugar/prover/abastecer/dispensar/distribuir/fornecer/suprir/submeter/pagar/deixar/entregar/passar
debater	altercar/indispor-se/opor-se/querelar/porfiar/opor/disputar
decair	degenerar/degradar/deteriorar/piorar/destruir/quebrar
decidir	seleccionar/adjudicar/selecionar/julgar/escolher
declarar	depor/pleitear/veicular/aconselhar/indiciar/advogar/exclamar/proclamar/promulgar/denunciar/acusar/confessar/sugerir/propor/reconhecer/admitir
declivar	cair
decrescer	encolher
decretar	legislar
defender	salvaguardar/justificar/assegurar/perdoar/proteger/racionalizar/salvar/explicar/guardar/resistir/segurar
deformar	flexionar/torcer
defraudar	roubar
defrontar	encarar
deixar	desamparar/aturar/demitir-se/quitar/desertar/resignar/tolerar/aguentar/renunciar/suportar/admitir/aceitar/abandonar
delapidar	indulgir
delegar	avançar/promover/escolher
deletar	retirar/cortar
demandar	exigir/requerer
demitir	desempregar/destituir/despedir
demitir-se	aposentar-se
demover	decepcionar/desapontar/desiludir
denotar	identificar/nomear
derramar	gotejar/salpicar/pingar/espalhar
derrotar	sobrepujar/sacanear/trapacear/ultrapassar/exceder/vencer/superar/roubar/bater
desabar	encolher
desacatar	sabotar/solapar/enfraquecer/resistir
desacelerar	atrasar
desacreditar	duvidar
desafiar	desencaminhar/engodar/seduzir/incitar/atrair/resistir
desagradar	agastar/aporrinhar/vexar/chatear/aborrecer/amolar/molestar/importunar/perturbar/irritar/incomodar
desaguar	salpicar/espalhar
desaparecer	caldear
desaprovar	objectar/desanimar/desencorajar
desavantajar	dificultar
descansar	ajoelhar-se/levantar
descer	naufragar/afundar/derrubar/pôr/cair
descobrir	constatar/averiguar
descolorir	enrubescer/rosar/ruborizar/corar/avermelhar
desconcertar	decepcionar/desapontar/desiludir
descrer	duvidar
desculpar	escusar/perdoar
desdizer	contradizer/negar
desejar	ansiar/suspirar
desempenhar	actuar/atuar/representar/tocar/fazer
desenhar	plotar/diagramar
desenvolver	amadurecer/envelhecer/estabelecer
desfavorecer	dificultar
desgostar	agastar/aporrinhar/vexar/detestar/odiar/chatear/ressentir/aborrecer/amolar/molestar/importunar/perturbar/irritar/incomodar
designar	nominar/propor/apresentar
desimpedir	aliviar
desinformar	mentir/exagerar/enganar/trair/aumentar
desintegrar	arrebentar
desistir	renunciar/abandonar/deixar
deslizar	resvalar/derrapar/escorregar/patinar
deslocar	arredar/contorcer/enroscar/espernear/torcer-se/alçar/botar/manar/virar-se/arremessar/dançar/estalar/fluir/largar/flexionar/entornar/pulsar/tornar-se/tropeçar/verter/alongar/balançar/derramar/elevar/impulsionar/expulsar/puxar/embalar/erguer/esticar/mexer/transportar/dobrar/empurrar/forçar/girar/pular/pôr/sacudir/saltar/soltar/tremer/sair/transmitir/correr/levantar/levar/partir/agitar/colocar/deixar/virar/carregar/tirar/separar/bater
desmentir	pretextar/aparentar/distorcer/simular/fingir
desmoronar	arrombar/estourar/arrebentar/deteriorar/explodir/destruir/quebrar
desobedecer	sabotar/solapar/enfraquecer/resistir
desordenar	misturar
despachar-se	correr
despender	delapidar/dilapidar/esbanjar/desperdiçar
desperdiçar	indulgir
destruir	demolir/arrasar/pulverizar/eliminar/extinguir
desviar	digressar
deter	emprisonar/encarcerar/engaiolar/incarcerar/aprisionar/prender
determinar	definir/enumerar/situar/localizar/decidir/contar/achar
detestar	desprezar/desdenhar/menosprezar
diferenciar	discriminar
dilapidar	indulgir
dilatar-se	inflar/inchar/encher
diminuir	encurtar/encolher/resumir/condensar/abreviar/reduzir
dirigir	encabeçar/estacionar/liderar/comandar
discutir	altercar/indispor-se/opor-se/querelar/deliberar/porfiar/debater/opor/disputar/considerar
dispensar	poupar
dispor	agavelar/coordenar/empilhar/acumular/organizar
disputar	pugnar/defrontar/confrontar/encarar/lutar
distinguir	discriminar
disturbar	transtornar/preocupar/perturbar
divertir	hospedar/receber
dividir	romper/arrombar/decepar/estourar/arrebentar/picar/explodir/quebrar/cortar
dizer	cochichar/remarcar/balbuciar/enunciar/reparar/retrucar/rosnar/sussurrar/notar/resmungar/articular/comentar/mencionar/murmurar/replicar/vocalizar/berrar/cantar/responder/gritar
dobrar	acovardar/acovardar-se/debruçar/agachar/curvar/inclinar
doer	lesionar/ferrar/lesar/ferir/asfixiar/picar/sufocar/machucar/queimar
dopar	envenenar
dormir	dormitar/cochilar
dormitar	cochilar
drogar	injetar/envenenar
edificar	erigir/construir
ejetar	sangrar
elaborar	exemplificar/ilustrar
elevar	bombear
elicitar	magoar/ofender/provocar
eliminar	excetuar/omitir/preterir/excluir/retirar/cortar
elocubrar	exemplificar/ilustrar
elogiar	preconizar/publicitar/recomendar/divulgar/promover/anunciar
embelezar	lustrar/polir
embonecar	lustrar/polir
emergir	vazar
emitir	carpir/lamentar-se/latir/urrar/bramir/gemir/ladrar/rugir/gemer/luzir/uivar/berrar/refletir/gritar
emocionar	transtornar/atemorizar/amedrontar/assustar/aterrorizar/preocupar/intimidar/perturbar
empetecar	lustrar/polir
empregar	devotar/reaproveitar/reprocessar/compartir/reciclar/reusar/reutilizar/dedicar/partilhar/recrutar/aproveitar/compartilhar/consagrar/comprometer/explorar/usar/dividir
empurrar	derrubar
enaltecer	preconizar/publicitar/recomendar/divulgar/promover/anunciar
encerrar	finalizar/acabar/terminar
encetar	endereçar/lidar/tratar/falar/cobrir
encher	alagar/estofar/encharcar/estufar/inundar
encobrir	disfarçar/mascarar/esconder
encolerizar	injuriar/ofender/insultar/irritar
encontrar	descobrir/achar
encorajar	conclamar/exortar/inspirar/incentivar/alimentar
encostar	rodear/contornar
endireitar	empinar
enfraquecer	diluir
enfrentar	encarar
engajar	recrutar
enganar	atraiçoar/mentir/exagerar/emboscar/trair/aumentar
enganchar	aconchegar/acomodar
enlistar	recrutar
enraivecer	injuriar/ofender/insultar/irritar
enrolar	embobinar
ensinar	reforçar/educar/instruir/preparar/treinar
entender	enxergar/ouvir/saborear/solucionar/doer/escutar/cheirar/ler/resolver/sentir/saber/olhar/realizar/compreender/ver
entornar	gotejar/pingar
entrar	traspassar/perfurar/embarcar/penetrar
entregar	legar/arrendar/emprestar/prestar/doar/alugar/prover/abastecer/dispensar/distribuir/fornecer/suprir/submeter/pagar/deixar/passar/dar
entreter	hospedar/receber
enumerar	somar/adicionar
enxugar	escovar/varrer
equilibrar	compensar
equiparar	empatar
equivaler	corresponder/combinar/concordar/representar
equivocar	enganar-se/tropeçar
erguer	bombear
errar	enganar-se/tropeçar
esbanjar	indulgir
esbulhar	apropriar-se/conquistar/capturar
escapar	foragir/desertar/escapulir/fugir/pular/abandonar
esclarecer	explicar
escolher	eleger/peneirar/analisar/selecionar/votar/decidir
esconder	disfarçar/mascarar/encobrir
escorregar	resvalar/derrapar/deslizar/patinar
escrever	subscrever/visar/assinar/imprimir
escutar	grampear/interceptar
esfacelar	deteriorar/destruir/quebrar
esfregar	roçar/escovar/varrer/enxugar/limpar
esgotar	desperdiçar
espalhar	borrifar
especificar	definir
especular	aventurar/ponderar/adivinhar/questionar/supor/perguntar/pretender
esperar	adiar
espirar	bocejar/soluçar/suspirar
estabelecer	nomear
estar	merecer/estender-se/perplexar/importar/necessitar/rondar/valer/agradar/perambular/precisar/caber/depender/encostar/requerer/alcançar/pertencer/permanecer/ocupar/confundir/contar/superar/enrolar/parecer/encher/pesar/ficar/servir
estender	abranger/atravessar
esticar	ceder
estimular	atemorizar/desencaminhar/engodar/amedrontar/assustar/aterrorizar/magoar/ofender/intimidar/seduzir/incitar/atrair/provocar
estorvar	obstaculizar/tolher/obstruir/atrapalhar/bloquear
estourar	explodir
estreitar	atarrachar/rosquear/comprimir/contrair
estudar	memorizar/decorar
esvaziar	drenar/limpar
evadir-se	foragir/desertar/escapulir/fugir/escapar/abandonar
evaziar	drenar/esvaziar/limpar
evitar	obstaculizar/tolher/obstruir/atrapalhar/bloquear
exagerar	fanfarrear/vangloriar/vangloriar-se/ostentar
examinar	revistar/comparar/procurar
exceder	transcender/avançar/superar
excitar	atemorizar/amedrontar/assustar/aterrorizar/intimidar
excluir	retirar/cortar
exercer	representar
exigir	proscrever/vetar/vedar/proibir/requerer
expandir	entumescer/exemplificar/inflar/ilustrar/inchar
expandir-se	inflar/inchar/encher
expectorar	tossir/cuspir
expelir	sangrar
experimentar	arrepender/arrepender-se/lamentar
expirar	afogar-se/afogar
explicar	elocubrar/descrever/elaborar/expandir/expor
explodir	estourar
expor	exemplificar/ilustrar
expressar	evocar/xingar/acentuar/blasfemar/pontuar/enfatizar/articular/insultar/sugerir/formular/contar/falar/dizer
exprimir	evocar/xingar/acentuar/blasfemar/mensurar/pontuar/quantificar/enfatizar/articular/insultar/sugerir/formular/expressar/contar/falar/dizer
expulsar	extraditar/deportar/escorraçar/exilar/ostracizar/sangrar/banir/entregar
extinguir	excetuar/omitir/preterir/excluir
fabricar	manufacturar/tricotar/urdir/assar/cozinhar/fiar/tecer/moldar/forjar/modelar/formar/preparar/construir
falar	cochichar/remarcar/balbuciar/enunciar/reparar/retrucar/rosnar/sussurrar/notar/resmungar/articular/discutir/comentar/mencionar/murmurar/replicar/vocalizar/berrar/cantar/pregar/responder/gritar/dizer
falecer	afogar-se/afogar
falhar	pifar/faltar/perder/quebrar/cair
fazer	ticar/actuar/atrever/atrever-se/concitar/elicitar/engendrar/filmar/ousar/participar/pincelar/premiar/virar-se/voluntariar/estalar/recompensar/repagar/compartilhar/pintar/procriar/recriar/reproduzir/clicar/aguentar/copiar/gerar/lidar/sobreviver/tentar/atuar/compor/formar/escrever/estimular/incitar/soar/organizar/criar/procurar/dirigir/oferecer/trazer/provocar/representar/tocar
fechar	vedar/selar/bater
ferir	aferroar/lesionar/apunhalar/esfaquear/lesar/danificar/machucar
figurar	desenhar
finalizar	encerrar/acabar/terminar
financiar	suportar
fixar	enganchar/trancar/pendurar
fluir	entornar/verter/derramar
formar	atar
fornecer	apetrechar/aparelhar/equipar/suprir/alimentar/servir/carregar/dar
forçar	coagir/compelir/obrigar/empurrar/derrubar
fracassar	perder
fragmentar	triturar/moer
frustrar	decepcionar/desapontar/desiludir
fugir	foragir/desertar/escapulir/escapar/abandonar
fundar	nomear
fundir-se	consolidar-se/consolidar
furar	morder/perfurar/picar/atravessar
furtar	plagiar/pilhar/roubar
ganhar	rentabilizar/lucrar
gastar	delapidar/luxuriar/dilapidar/esbanjar/desperdiçar
gerenciar	chefiar/supervisar/supervisionar/conduzir
gerir	chefiar/supervisar/supervisionar/conduzir
gesticular	ovacionar/acenar/aclamar/aplaudir
golpear	esmurrar/estapear/chibatar/açoitar/chicotear/chutar/bater
gostar	adorar/encantar
governar	gerir/reinar/reger
gracejar	brincar
gritar	bradar/berrar
grudar	aderir/colar
guardar	armazenar/acumular/negar
guiar	estacionar
habitar	alojar/morar
homenagear	tolerar
honrar	tolerar
igualar	empatar/corresponder/combinar/concordar/representar
iludir	atraiçoar/emboscar/trair
iluminar	brilhar
iluminar-se	iluminar/brilhar
imaginar	conjeturar/conjecturar/esboçar/desenhar/projectar/projetar/planejar/pensar
impedir	obstaculizar/tolher/obstruir/atrapalhar/bloquear
impetrar	comandar/convocar/exigir/chamar/ordenar
importunar	assediar/aborrecer/molestar/irritar/provocar/incomodar
impossibilitar	obstaculizar/tolher/obstruir/atrapalhar/bloquear
impressionar	comover/disturbar/emocionar/perturbar
impugnar	desafiar/disputar
impulsionar	atirar/jogar/lançar
incitar	desencaminhar/engodar/magoar/ofender/seduzir/atrair/provocar
inclinar	cair
incluir	abranger/compreender/conter/ter
incomodar	assediar/aborrecer/molestar/importunar/irritar/provocar
incriminar	culpabilizar/culpar
indignar	escandalizar/ultrajar/horrorizar/chocar/ofender
induzir	persuadir/encorajar
influenciar	dominar/decidir
influir	dominar
informar	desinformar/divagar/leccionar/lecionar/testificar/alertar/atualizar/descerrar/ensinar/atestar/divulgar/evidenciar/narrar/recontar/esclarecer/testemunhar/minimizar/avisar/enganar/soprar/advertir/instruir/apontar/introduzir/explicar/provar/revelar/lembrar/apresentar/contar/indicar/mostrar
informar-se	constatar/averiguar/descobrir
ingerir	deglutir/ingurgitar/papar/fumar/beber/engolir/comer/experimentar/provar/tomar
iniciar	inaugurar/endereçar/lidar/tratar/introduzir/falar/cobrir
inscrever	registar/registrar
inspecionar	revistar/procurar
instruir	reforçar/educar/preparar/treinar
inteirar	constatar/averiguar/descobrir
interagir	tratar/encontrar/reunir
intercalar	consolidar-se/consolidar
interessar	intrigar/atrair
interromper	pausar/espirar/respirar/parar
intimar	comandar/convocar/exigir/chamar/ordenar
intimidar	terrificar/horripilar/aterrorizar
intrometer	disturbar/interromper
intrometer-se	disturbar/interromper
inventar	manufaturar/fabricar
investir	especular
ir	engatinhar/gatinhar/rastejar/rastejar-se/retroceder/serpear/vadiar/vagabundear/vaguear/boiar/departir/pisar/retirar-se/devolver/escapulir/pisotear/regressar/ascender/escorregar/nadar/recuar/errar/marchar/passear/perambular/vagar/deslizar/voar/apressar/fugir/retornar/acompanhar/atravessar/pular/saltar/sair/caminhar/dirigir/escapar/correr/partir/seguir/andar/subir/passar/cair
irar	injuriar/ofender/insultar/irritar
ironizar	escarnear/tantalizar/sacanear
irradiar	alumiar/piscar/cintilar/brilhar
irritar	assediar/coçar/aborrecer/molestar/importunar/esfregar/provocar/incomodar
isentar	poupar
jogar	arremessar/arremeter/defrontar/confrontar/encarar/apostar/brincar/atirar/lançar
julgar	hierarquizar/inocentar/ranquiar/antecipar/absolver/medir/condenar/confessar/classificar/estimar/avaliar/pensar/reconhecer/admitir/escolher/achar
juntar	catar/aderir/fixar/colher/apanhar/grudar/amarrar/atar/colar/prender
lançar	arremessar/arremeter/atirar/jogar/quebrar
largar	demitir-se/quitar/resignar/renunciar/abandonar
lastimar	preocupar-se
lavar	lavar-se/limpar
leccionar	reforçar/educar/instruir/preparar/treinar
lecionar	reforçar/educar/instruir/preparar/treinar
lembrar	relembrar/recordar/rever/reter/reconhecer
lembrar-se	reconhecer
lesar	aferroar/apunhalar/esfaquear/ferir/danificar/machucar
lesionar	aferroar/apunhalar/esfaquear/lesar/ferir/danificar/machucar
levantar	bombear
levar	confiscar/apreender/adoptar/devolver/voltar/adotar/retornar/transportar/trazer/carregar/tirar
liberar	sangrar/poupar
licenciar	credenciar/reconhecer
lidar	gerenciar/aguentar
limitar	constrangir/conquistar/sufocar/classificar/reprimir/suprimir/restringir/conter/controlar
limpar	lavar-se/escovar/varrer/lavar
liquefazer	degelar/derreter/descongelar/amolecer
liquidificar	degelar/derreter/descongelar/amolecer
livrar	aliviar
lograr	atraiçoar/emboscar/trair
louvar	preconizar/publicitar/recomendar/divulgar/promover/anunciar
lutar	pugnar/resistir
machucar	aferroar/lesionar/apunhalar/esfaquear/lesar/ferir/danificar
malograr	perder
manar	entornar/verter/derramar
mandar	comandar/convocar/exigir/chamar/ordenar
manejar	baralhar/operar/embaralhar/amassar/trabalhar/controlar/misturar
mangar	paquerar/desacreditar/ridicularizar/sacanear/expor/provocar
manipular	baralhar/instigar/operar/embaralhar/amassar/trabalhar/controlar/misturar/provocar
manobrar	estacionar
manter	persistir/perseverar/armazenar/prolongar/financiar/alongar/acumular/negar/sustentar/suportar/guardar
manusear	baralhar/operar/embaralhar/amassar/trabalhar/controlar/misturar
marcar	grifar/sublinhar
marrar	memorizar/decorar
matar	decapitar/degolar/executar
medicar	narcotizar/dopar/drogar
medir	durar/pesar
melhorar	aprimorar/convalescer/reparar/emendar/lustrar/consertar/polir/recuperar/refinar/reformar/estabelecer
mencionar	aludir/citar
menosprezar	escarnear/tantalizar/sacanear
mensurar	cronometrar/pesar
mexer	contorcer/enroscar/espernear/torcer-se/manar/virar-se/arremessar/dançar/estalar/fluir/flexionar/pulsar/tornar-se/tropeçar/alongar/impulsionar/esticar/dobrar/girar/pular/sacudir/saltar/tremer/sair/correr/partir/agitar/deixar/virar/separar/bater
minguar	encolher
mirar	fitar/vislumbrar/espiar/encarar/contemplar/olhar/ver
modelar	atar
modificar	alargar/ativar/comercializar/desvirar/impactar/aperfeiçoar/endireitar/inverter/acertar/completar/afetar/modelar/investir/causar/formar/manchar/substituir/ajustar/corrigir/melhorar/encher/estender/trocar/reduzir/diminuir
moldar	decidir
molestar	assediar/aborrecer/importunar/irritar/provocar/incomodar
morar	alojar
morrer	afogar-se/pifar/afogar/quebrar/cair
mostrar	evocar/acentuar/pontuar/postar/enfatizar/articular/manifestar/demonstrar/expor/sugerir/formular/expressar/exibir/revelar/apresentar/descobrir/trazer/dizer
mover	arredar/contorcer/enroscar/espernear/torcer-se/alçar/botar/manar/virar-se/arremessar/dançar/estalar/fluir/largar/flexionar/entornar/pulsar/tornar-se/tropeçar/verter/alongar/balançar/derramar/elevar/impulsionar/expulsar/puxar/embalar/erguer/esticar/mexer/transportar/dobrar/empurrar/forçar/girar/pular/pôr/sacudir/saltar/soltar/tremer/sair/transmitir/correr/levantar/levar/partir/agitar/colocar/deixar/virar/carregar/tirar/separar/bater
mudar	alargar/amarfanhar/amarrotar/ativar/confromar-se/descontrair/esboroar/esfarelar/fraccionar/fracionar/perecer/prosperar/repartir/ruir/transformar-se/transmutar/adaptar-se/adequar-se/agasalhar/aparelhar/comercializar/despedaçar/desvirar/engravidar/falecer/fender/fracassar/impactar/levantar-se/modernizar/aperfeiçoar/colapsar/desabar/despertar/endireitar/expirar/inverter/conceber/relaxar/acertar/completar/converter/decair/tornar-se/afetar/fundir/modelar/ferver/investir/piorar/causar/formar/manchar/acordar/desmoronar/morrer/substituir/vestir/ajustar/congelar/corrigir/transformar/combinar/acontecer/melhorar/encher/estender/misturar/trocar/reduzir/virar/dividir/quebrar/diminuir/separar
multiplicar	duplicar
narcotizar	envenenar
nausear	escandalizar/ultrajar/horrorizar/chocar/ofender
negligenciar	faltar/perder
negociar	pechinchar/regatear
nomear	nominar/autorizar/propor/apresentar
obedecer	acatar/conformar/seguir
obrigar	coagir/compelir/forçar
observar	fitar/vislumbrar/espiar/encarar/contemplar/olhar/ver
obstar	obstaculizar/tolher/obstruir/atrapalhar/bloquear
obter	beneficiar-se/re-adquirir/beneficiar/herdar/reconquistar/reganhar/auferir/colecionar/lucrar/recolher/apanhar/comprar/recuperar/coletar/ganhar/capturar/adquirir/encontrar/reunir/atingir/pegar
ocorrer	coincidir
ocultar	disfarçar/mascarar/encobrir/esconder
odiar	desprezar/desdenhar/menosprezar
oferecer	legar/doar/distribuir/deixar/entregar/passar/dar
olhar	fitar/fulminar/vislumbrar/espiar/encarar/contemplar/ver
omitir	disfarçar/mascarar/encobrir/pular/esconder
operar	funcionar
opinar	dissuadir/exortar/impelir/urgir
ordenar	legislar/proscrever/vetar/vedar/comandar/convocar/exigir/proibir/chamar
organizar	arrumar/ordenar
oscilar	gingar/requebrar/balançar/sacudir
ouvir	grampear/interceptar
padecer	congelar
pagar	reintegrar/remunerar/retribuir/debitar/despender/restituir/recompensar/repagar/gastar/compensar
pagodear	paquerar/desacreditar/ridicularizar/sacanear/expor/provocar
palestrar	pregar
parar	pausar/espirar/respirar/interromper
parecer	troçar/recender/reluzir/caçoar/comover/disturbar/doer/emocionar/cheirar/impressionar/cintilar/perturbar
partir	divorciar/demitir-se/departir/descasar/quitar/escapulir/resignar/fugir/renunciar/sair/escapar/abandonar
passar	estrear/agradecer/coincidir/esfregar/apreciar/correr
pausar	espirar/respirar
pedir	mendigar/reservar/demandar/exigir/convidar/segurar
pegar	abduzir/apreender/raptar/seqüestrar/remeter/sequestrar/apanhar/furtar/agarrar/capturar/roubar/prender/segurar/entregar
penalizar	executar
penetrar	cravar/espetar
pensar	centrar/ruminar/concentrar/manufaturar/associar/cogitar/conectar/fabricar/relacionar/inventar/ponderar/especular/focar/contemplar/planejar/refletir/reter/lembrar
perceber	enxergar/ouvir/saborear/doer/escutar/cheirar/sentir/saber/olhar/ver
perder	negligenciar/pular
perdoar	desculpar/escusar
perecer	afogar-se/afogar
perfurar	morder/picar/furar/atravessar
perguntar	interrogar/questionar
permitir	deferir/sancionar/aturar/licenciar/autorizar/tolerar/aguentar/certificar/aprovar/suportar/admitir/aceitar
perseguir	caçar/seguir
persuadir	convencer
perturbar	transtornar/assediar/aborrecer/molestar/preocupar/importunar/irritar/provocar/incomodar/bater
pesquisar	experimentar
piorar	degenerar/degradar/deteriorar
planejar	engenhar/maquinar/orquestrar/organizar
plantar	produzir/fazer
ponderar	questionar/perguntar
possuir	exibir
povoar	alojar/morar
preceder	desbravar/liderar
predizer	apostar
prejudicar	dificultar
prender	emprisonar/encarcerar/engaiolar/incarcerar/enganchar/aprisionar/trancar/pendurar
prensar	esmagar/espremer/apertar
preparar	preservar/conservar
preservar	persistir/perseverar/prolongar/alongar/sustentar
pressentir	apostar
pressionar	esmagar/espremer/apertar
prestigiar	tolerar
pretender	pressentir/prognosticar/adivinhar/predizer/prever
preterir	pular
prever	apostar
prezar	admirar/estimar
privar	jejuar
privar-se	jejuar
proceder	aventurar/embarcar
proclamar	ditar
procurar	arriscar
produzir	reproduzir/gerar/criar/trazer/fazer
proferir	cochichar/xingar/balbuciar/blasfemar/rosnar/sussurrar/resmungar/murmurar/insultar/berrar/cantar/contar/falar/gritar/dizer
prognosticar	apostar
progredir	ampliar/amadurecer/envelhecer/intensificar/estender/aumentar
proibir	obstaculizar/tolher/obstruir/atrapalhar/bloquear
prometer	penhorar
promover	favorecer/preferir
promulgar	legislar
pronunciar	inocentar/absolver/condenar
propor	nominar/apresentar
propulsar	atirar/jogar/lançar
propulsionar	atirar/jogar/lançar
proteger	salvaguardar/assegurar/salvar/defender/guardar/segurar
protestar	manifestar-se/paralizar/parar
protocolar	recrutar/inscrever/listar/registar/registrar
provar	validar/demonstrar
prover	apetrechar/aparelhar/equipar/suprir/alimentar/servir/carregar/dar
provisionar	alimentar/servir/dar
provocar	contagiar/concitar/desencaminhar/elicitar/engendrar/engodar/filmar/infetar/infectar/magoar/procriar/recriar/ofender/copiar/gerar/seduzir/compor/formar/escrever/estimular/incitar/atrair/organizar/dirigir/fazer
punir	executar
purgar	lavar
putrefazer	estragar
puxar	arrastar/atrair
pôr	deitar/semear/instalar/enterrar/dispor/plantar/arranjar/perder/colocar/carregar
quantificar	cronometrar/pesar
queimar	incendiar/acender
querer	ansiar/suspirar/desejar
questionar	interrogar/perguntar
quitar	aposentar-se
raciocinar	centrar/ruminar/concentrar/associar/cogitar/conectar/relacionar/ponderar/especular/focar/contemplar/planejar/refletir
radiar	alumiar/piscar/cintilar/brilhar
ranger	mastigar/mascar
reagir	recusar/explodir/rejeitar
reapresentar	traduzir/citar
receber	bacharelar/beneficiar-se/formar-se/re-adquirir/beneficiar/herdar/reconquistar/reganhar/auferir/colecionar/graduar/lucrar/recolher/apanhar/comprar/recuperar/coletar/formar/ganhar/capturar/obter/adquirir/encontrar/reunir/atingir/pegar
recolher	arrecadar/catar/colher/apanhar
reconfortar	tranqüilizar/aquietar/silenciar/tranquilizar/acalmar
reconhecer	apreciar
recordar	relembrar/rever/reconhecer
recordar-se	reconhecer
recriar	contrafazer/desempenhar/falsificar/simular/modelar/apresentar/fazer
recrutar	inscrever/registar/registrar
redigir	subscrever/visar/assinar
redizer	traduzir/citar
reduzir	encurtar/resumir/condensar/abreviar/atrasar/diminuir
reescrever	rever
referir	aludir/mencionar/citar
refletir	centrar/ruminar/concentrar/associar/cogitar/conectar/relacionar/ponderar/especular/focar/questionar/contemplar/perguntar/planejar
refrear	conquistar/sufocar/reprimir/suprimir/limitar/restringir/conter/controlar
regalar	legar/doar/distribuir/deixar/entregar/passar/dar
reganhar	descobrir/encontrar/achar
reger	gerir/governar/reinar
registar	documentar/filmar/recrutar/inscrever/listar/gravar/registrar/manter
registrar	documentar/filmar/recrutar/inscrever/listar/gravar/registar/manter
reiterar	traduzir/citar
rejeitar	objectar/desconsiderar/descartar/esnobar/ignorar/menosprezar/desanimar/desencorajar
relembrar	recordar/rever
relutar	resistir
remover	amputar/desempregar/destituir/demitir/deletar/despedir/resgatar/cavar/escavar/extrair/retirar/apagar/aliviar/sacar/tirar
render-se	desistir
renovar	substituir
renunciar	aposentar-se
repetir	traduzir/citar
repousar	ajoelhar-se/levantar
representar	desvirar/distorcer/desenhar/enrolar
reproduzir	fotocopiar/xerocar/replicar/simular/copiar/imitar/repetir
repugnar	escandalizar/ultrajar/horrorizar/chocar/ofender
repulsar	escandalizar/ultrajar/horrorizar/chocar/ofender
requerer	mendigar/reservar/demandar/exigir/convidar/pedir/segurar
requisitar	mendigar/reservar/demandar/exigir/convidar/pedir/segurar
resignar	aposentar-se
resistir	salvar
resolver	seleccionar/adjudicar/selecionar/decidir/julgar/escolher
respeitar	tolerar/admirar/estimar
respirar	bocejar/soluçar/suspirar
responder	recusar/explodir/rejeitar
responsabilizar	culpabilizar/autorizar/culpar
ressoar	ticar/estalar/clicar/soar/tocar
restringir	constrangir/classificar/conter
reter	denegar/armazenar/privar/adiar/proibir/acumular/negar/recusar/guardar/rejeitar
retirar	amputar/resgatar/cavar/escavar/extrair/sacar/tirar
reunir	arrecadar/catar/colher/apanhar
revalidar	validar/demonstrar
revestir	pintar
revogar	cassar/rescindir/reverter/anular/cancelar
revoltar	escandalizar/ultrajar/horrorizar/chocar/ofender
ridicularizar	paquerar/desacreditar/sacanear/expor/provocar
rir	paquerar/desacreditar/ridicularizar/sacanear/expor/provocar
rodar	girar
rogar	implorar/suplicar
romper	quebrar
rotular	inocentar/denominar/absolver/condenar/chamar/nomear
roubar	plagiar/extorquir/pilhar/furtar
ruminar	ponderar/questionar/perguntar
saber	dominar/realizar/compreender/entender
sacanear	paquerar/desacreditar/ridicularizar/expor/provocar
sacar	despojar/desnudar/despir
sacudir	abanar/flabelar/ventilar/estremecer/tremular/tiritar/tremer
sair	demitir-se/departir/quitar/escapulir/resignar/vazar/fugir/renunciar/escapar/partir/abandonar
salpicar	borrifar
satisfazer	aprazer/comprazer/embevecer/agradar/gostar/encantar
sedar	hipnotizar/mesmerizar
segurar	abocanhar/apreender/armazenar/beliscar/mordiscar/espremer/morder/apanhar/acumular/apertar/furtar/negar/agarrar/guardar/roubar/prender
seleccionar	eleger/peneirar/analisar/selecionar/votar/decidir/escolher
selecionar	eleger/peneirar/analisar/votar/decidir/escolher
sentar	acocorar/acocorar-se/baixar-se/agachar
sentar-se	acocorar/acocorar-se/baixar-se/agachar
sentir	arrepender/arrepender-se/lamentar
separar	divorciar/descasar/romper/arrombar/discriminar/estourar/arrebentar/explodir/quebrar
ser	merecer/perplexar/importar/necessitar/rondar/valer/agradar/perambular/precisar/caber/depender/requerer/pertencer/permanecer/confundir/contar/superar/enrolar/parecer/pesar/ficar/servir
servir	qualificar-se/qualificar/alimentar/representar/dar
significar	identificar/nomear
situar	enterrar
soar	ticar/estalar/clicar/tocar
sobressair	transcender/avançar/exceder/superar
sobressaltar	estarrecer/pasmar/surpreender
sobreviver	gerenciar/aguentar
socializar	divertir/entreter
socorrer	sanar/sarar/curar/assistir/ajudar/servir
sofrer	asfixiar/sufocar/morrer/congelar
solicitar	mendigar/reservar/demandar/exigir/convidar/pedir/segurar
soltar	carpir/lamentar-se/latir/urrar/bramir/gemir/ladrar/rugir/gemer/uivar/berrar/gritar
sonecar	dormitar/cochilar
soprar	ofegar/bufar
subir	galgar/trepar/ascender/montar
submergir	mergulhar
substanciar	validar/demonstrar
suceder	efectuar/coincidir/conseguir/efetuar/negociar/alcançar/obter/realizar/atingir/passar
sumir	caldear/desaparecer
superar	sobrepujar/sacanear/trapacear/ultrapassar/exceder/derrotar/vencer/roubar/bater
suplicar	implorar/rogar
supor	pressentir/prognosticar/adivinhar/predizer/prever
suportar	acorrer/respaldar/endossar/secundar/justificar/perdoar/socorrer/validar/demonstrar/engolir/racionalizar/apoiar/assistir/auxiliar/aprovar/explicar/ajudar/aceitar
suprir	apetrechar/aparelhar/equipar/carregar
surpreender	estarrecer/pasmar
sustentar	validar/demonstrar
tampar	disfarçar/mascarar/embrulhar/embalar/encobrir/esconder/cobrir
tapar	disfarçar/mascarar/encobrir/esconder
tapear	deturpar/falsear/falsificar
telecomunicar	telefonar/chamar
tentar	arriscar
ter	exibir/reter/guardar/segurar/manter
terminar	encerrar/finalizar/acabar
tirar	amputar/despojar/deletar/desnudar/despir/devolver/voltar/arrastar/resgatar/cavar/escavar/extrair/retornar/retirar/atrair/apagar/sacar
tocar	oscular/prensar/beijocar/rodear/contornar/golpear/beijar/afagar/colidir/pressionar/apertar/atirar/jogar/atingir/lançar/bater
tolerar	engolir/aceitar
tomar	bebericar/confiscar/deglutir/ingurgitar/papar/abduzir/apreender/fumar/raptar/seqüestrar/adoptar/sorver/sequestrar/beber/adotar/engolir/comer/agarrar/capturar/experimentar/provar/segurar/pegar
topar	adoptar/adotar
torcer	acovardar/acovardar-se/debruçar/agachar/curvar/inclinar/dobrar
tornar	descontrair/perecer/prosperar/agasalhar/aparelhar/engravidar/falecer/levantar-se/despertar/expirar/conceber/relaxar/decair/piorar/acordar/morrer/vestir/congelar
tornar-se	rolar/girar/virar
trabalhar	colaborar/cooperar
tranquilizar	hipnotizar/mesmerizar
transferir	mandar/ceder/enviar/entregar/passar/dar
transformar	transformar-se/tornar-se/acontecer/virar
transmitir	indagar/anuir/assentir/mensurar/quantificar/redigir/agradecer/mandar/solicitar/remeter/requisitar/perguntar/requerer/saudar/escrever/apreciar/pedir/enviar/falar/dizer/entregar
transmutar	transformar-se/tornar-se/transformar/acontecer/virar
transportar	devolver/voltar/retornar/trazer/levar/carregar/tirar
trapacear	deturpar/falsear/falsificar/roubar
tratar	amimar/destratar/mimar/abusar/mimosear/maltratar/afagar
trazer	devolver/mandar/remeter/ressuscitar/voltar/reviver/retornar/enviar/entregar
tremer	abanar/flabelar/ventilar/estremecer/tremular/tiritar
trespassar	invadir
trocar	remir/permutar/resgatar/vender
ultrapassar	sobrepujar/sacanear/trapacear/exceder/derrotar/superar/roubar
unificar	consolidar-se/consolidar
unir	consolidar-se/fixar/consolidar/amarrar/atar/prender
usar	devotar/reaproveitar/reprocessar/compartir/reciclar/reusar/reutilizar/dedicar/partilhar/aproveitar/compartilhar/consagrar/comprometer/explorar/dividir
usurpar	apropriar-se/conquistar/capturar
utilizar	devotar/reaproveitar/reprocessar/compartir/reciclar/reusar/reutilizar/dedicar/partilhar/aproveitar/compartilhar/consagrar/comprometer/explorar/usar/dividir
vencer	sobrepujar/sacanear/trapacear/ultrapassar/exceder/derrotar/superar/roubar/bater
venerar	admirar/estimar
ver	fitar/prezar/respeitar/revistar/venerar/vislumbrar/espiar/encarar/contemplar/olhar/procurar
verbalizar	cochichar/xingar/balbuciar/blasfemar/rosnar/sussurrar/publicar/resmungar/murmurar/insultar/berrar/cantar/escrever/contar/falar/gritar/dizer
vergar	acovardar/acovardar-se/debruçar/agachar/curvar/inclinar/dobrar
verificar	checar/conferir
verter	gotejar/pingar
vexar	assediar/aborrecer/molestar/importunar/irritar/provocar/incomodar
viajar	engatinhar/gatinhar/rastejar/rastejar-se/retroceder/serpear/vadiar/vagabundear/vaguear/boiar/pisar/retirar-se/devolver/regressar/ascender/escorregar/nadar/recuar/errar/perambular/vagar/deslizar/voar/apressar/retornar/visitar/acompanhar/atravessar/pular/saltar/caminhar/dirigir/correr/seguir/ir/andar/subir/passar/cair
vir	acercar/avizinhar/aterrar/aterrissar/pousar/chegar
virar	descontrair/perecer/prosperar/agasalhar/aparelhar/engravidar/falecer/levantar-se/despertar/expirar/conceber/relaxar/decair/piorar/rolar/acordar/morrer/vestir/congelar/girar
virar-se	gerenciar/aguentar/rolar/girar/virar
viver	alojar/morar
voar	disparar
zangar	injuriar/ofender/insultar/irritar
zoar	paquerar/desacreditar/ridicularizar/sacanear/expor/provocar
zombar	escarnear/tantalizar/paquerar/desacreditar/ridicularizar/sacanear/expor/provocar
