acordo	art./handshake/cláusula/brecha/contrato/artigo
aeronave	piloto
aeroplano	desvio/assento/passageiro/piloto/cadeira/lugar/circum-navegação/circumnavegação/titanio/titânio
agricultura	cultivo
animal	arapuca/sacrificio/armadilha/sacrifício/corpo/rede/microorganismo/microrganismo/rastreamento/rastreio/verruga/humanidade/nariz/olfato/lado
apólogo	isolda/midas/sísifo/tristão
armada	marina
arquitectura	coluna/pilar/coluna/arco/fenestração/mísula/pináculo/arquitetura/pilar/arco
arquitetura	coluna/pilar/coluna/arco/fenestração/mísula/pináculo/pilar/arquitectura/arco
arte	chinês/exposições/cine/cinema/teórico/exposição/estética/belas-artes/estética/avaliador/linguagem/discurso/língua/estilo
auto	tracção/túnel/tração/passageiro/alternador/aluguel/aluguel/arrendamento
autocarro	passageiro
automóvel	tracção/túnel/tração/passageiro/alternador/aluguel/aluguel/arrendamento
avião	desvio/assento/passageiro/piloto/cadeira/lugar/circum-navegação/circumnavegação/titanio/titânio
balé	pas
barco	passageiro/amarra
basebol	apanhador/beisebolistas/fumble/interbases/primeira-base/putout/rebatida/segunda-base/strikeout/terceira-base/arremesso/coletor/jogada/batedor/receptor/andada/diamante/assistência/batida/turno/erro
basquete	contra-ataque/drible/tabela/assistência
basquetebol	contra-ataque/contra-ataque/drible/drible/tabela/tabela/assistência/assistência
batel	passageiro/amarra
beisebol	apanhador/beisebolistas/fumble/interbases/primeira-base/putout/rebatida/segunda-base/strikeout/terceira-base/arremesso/coletor/jogada/batedor/receptor/andada/diamante/assistência/batida/turno/erro
besta	arapuca/sacrificio/armadilha/sacrifício/corpo/rede/microorganismo/microrganismo/rastreamento/rastreio/verruga/humanidade/nariz/olfato/lado
bicho	arapuca/sacrificio/armadilha/sacrifício/corpo/rede/microorganismo/microrganismo/rastreamento/rastreio/verruga/humanidade/nariz/olfato/lado
bola-ao-cesto	contra-ataque/drible/tabela/assistência
bote	passageiro/amarra
bíblia	exegese/exegese/gabriel/contrato/promessa/pacto
calculadora	formatação/informática/formato/console/lutter/plotter/throughput/módulo
caminhos-de-ferro	passageiro
carro	tracção/túnel/tração/passageiro/alternador/aluguel/aluguel/arrendamento
casademoinho	uptime
cirurgia	operação/enxerto/ostomia
ciência	matematica/matemática/teórico
colectas	recolhedor/cobrador/coletor/encargo/imposto/taxa/renda/rendimento
comboio	passageiro
computador	formatação/informática/formato/console/lutter/plotter/throughput/módulo
comércio	chinês/cine/cinema/cadeia/astucidade/gerenciamento/sagacidade/astúcia/capitalista/gestão/sócio/empresa/estabelecimento/negócio/participante/administração/parte
concerto	ensaio
concertos	ensaio
contrato	art./handshake/cláusula/brecha/artigo
crescimento	isometria
criatura	arapuca/sacrificio/armadilha/sacrifício/corpo/rede/microorganismo/microrganismo/rastreamento/rastreio/verruga/humanidade/nariz/olfato/lado
didáctica	educação/ensino/pedagogia/educação
discurso	sotaque/linguagem/acento/idioma/língua/estilo
dramaturgia	assento/cadeira/lugar/anfiteatro/teatro/casa
droga	anafilaxia
economia	consumo/monopsônio/oligopolio/oligopólio/monopólio/produção
educação	ensino/pedagogia
electricidade	terra
electrónica	demodulação/modulação/pulsação/ripple/tangência/transistor/transístor/rede
eleição	contagem/maioria/pluralidade
eletricidade	terra
eletronica	demodulação/modulação/pulsação/ripple/tangência/transistor/transístor/rede
eletrónica	demodulação/modulação/pulsação/ripple/tangência/transistor/transístor/rede
eletrônica	demodulação/demodulação/modulação/modulação/pulsação/pulsação/ripple/ripple/tangência/tangência/transistor/transistor/transístor/transístor/rede/rede
empresa	chinês/cine/cinema/cadeia/astucidade/gerenciamento/sagacidade/astúcia/capitalista/gestão/sócio/estabelecimento/negócio/participante/administração/parte
engenharia	código-fonte/enchente/fonte
ensinamento	educação/ensino/pedagogia/educação
ensino	educação/pedagogia/educação
entorpecente	anafilaxia
escaler	passageiro/amarra
esporte	juiz/árbitro/lance/olheiro/tacada/posse/treinador/impedimento/agente/falta/técnico/jogo/posição
estatística	média/média/norma/norma/actuário/actuário/amostragem/amostragem/atuário/atuário/co-variância/co-variância/covariância/covariância/desvio-padrão/desvio-padrão/mediana/mediana/multicolinearidade/multicolinearidade/quartil/quartil/regressão/regressão/subpopulação/subpopulação/variância/variância/correlação/correlação/estatístico/estatístico/regressão/regressão/universo/universo/média/média/média/média/moda/moda
estatísticas	média/norma/actuário/amostragem/atuário/co-variância/covariância/desvio-padrão/mediana/multicolinearidade/quartil/regressão/subpopulação/variância/correlação/estatística/estatístico/regressão/universo/média/média/moda
filosofia	filósofo/aristotelismo/aristotelismo/desconstrução/desconstrução/determinismo/estoicismo/existencialismo/existencialismo/idealismo/logicismo/materialismo/mentalismo/nativismo/naturalismo/nominalismo/platonismo/racionalismo/relativismo/semiótica/semiótica/sensacionalismo/sensualismo/solipsismo/teleologia/vitalismo/estética/pragmatismo/empirismo/formalismo/idealismo/realismo
flora	vegetação/fitoterapia/fitoterapia/fotossintese/fotossíntese/fotossíntese/microorganismo/microrganismo/nitrificação/peroxidase/comensalismo/circulação/coca/parasita
folclore	banshee/banshee/banshee/banshee/elfo/elfo/hobgoblin/hobgoblin/licantropia/licantropia/ogre/ogre/silfo/silfo/titania/titania/titânia/titânia/troll/troll/troll/troll/duende/duende/duende/duende/ogro/ogro/vampiro/vampiro/assombração/assombração
formação	educação/ensino/pedagogia/educação
fotografia	subdesenvolvimento/intensificação/contraste/registro
futebol	autogolo/fullback/gol-contra/meio-campo/placekicker/punter/beque/drible/zagueiro/ponteiro/ponteiro/ponta/ponta
fábrica	uptime/gás
fé	submundo/inferno/conformista/consagração/incensário/lúcifer/noviciado/numina/ortodoxia/pudicícia/recato/satanás/satã/turíbulo/castidade/celibato/claustro/vigília/diabo/frade/meditação/perseguição/irmão/tolerância/hábito
física	gravitação/isotropia/molécula/reactor/reactores/átomo/gravidade/absorbância/absortividade/atractor/espalação/magnete/pertubação/quark/supersimetria/transiente/vibração/vibração/vibrações/íman/absorção/coesão/colisão/desaceleração/métrica/quantum/ímã/difusão/dualidade/inércia/oscilação/paridade/aceleração/lápis/onda/potência/fluxo/energia/luz/tensão/tensão/força/físico
golfe	medalhista/passarinho/meleca/par
gramática	quantificador/cláusula/constituinte/objeto/oração/sujeito/artigo
hemípteros	holometabolismo
história	crónica/crónica/crônica/crônica/historiador/historiador/historiografo/historiografo/cronista/cronista/sarraceno/sarraceno/sarraceno/sarraceno
humano	corpo/polidactilia/sindactilia/lado
idioma	sotaque/linguagem/discurso/acento/língua/estilo
imposto	recolhedor/cobrador/coletor/encargo/taxa/renda/rendimento
impostos	recolhedor/cobrador/coletor/encargo/imposto/taxa/renda/rendimento
industria	chinês/cine/cinema/cadeia/astucidade/gerenciamento/sagacidade/astúcia/capitalista/gestão/sócio/empresa/estabelecimento/negócio/participante/administração/parte
informática	hardware/software/calculadora/impressora/iteração/computador/menu/código/trilha/repetição/programa/programa/ascii/ascii/backup/baud/baud/bbs/becape/buffer/cachê/compilador/cpu/crache/cursor/dominio/dongle/e-mail/email/eprom/firewall/firmware/ftp/hard-drive/inicialização/instrução/interoperabilidade/interpretador/janela/parâmetro/pixel/processador/programador/píxel/risc/risc/roteador/roteador/router/sgml/sub-directório/subdirectório/subdiretório/travamento/ucp/utilitário/cache/editor/firewall/fragmentação/ontologia/registrador/simulação/armazenamento/arquitetura/controlador/paridade/partição/periférico/protocolo/vídeo/arquivo/cliente/diretório/disco/ficheiro/parâmetro/ícone/arquitectura/intérprete/janela/bloco/instrução/lógica/servidor/porta/execução/operação/domínio/rede
insecto	holometabolismo
insectos	holometabolismo
inseto	holometabolismo
insetos	holometabolismo
instrução	educação/ensino/pedagogia/educação
jogo	jogada/rodada/vez/repetição/turno/tempo
jurisprudência	acta/adoção/argüido/conúbio/decreto/divorcio/divórcio/licenciamentos/litígio/matrimónio/matrimônio/passaportes/pleito/querelante/sufrágio/testamento/veredicto/veredito/acusado/anistia/bancarrota/coima/curador/falência/fiança/legislação/mandado/réu/adoção/casal/constituição/dono/jurisdição/jurista/juízo/multa/passaporte/sentença/contrato/suspeito/voto/advogado/judiciário/perdão/processo/processo/processo/proprietário/registro/julgamento/julgamento/testemunha/ato/licença/casamento/causa/causa/direito/título/amnistia/carta-patente/chateação/codicilo/common-law/condicional/contratador/debênture/derivativo/derivativos/desacato/desapropriação/dolo/encarceramento/estatuo/fbi/indulto/injunção/intimação/intimação/jurisconsulto/justiça/legalização/legitimação/leis/leis/libelo/litigante/notário/pertubação/premeditação/procurador-geral/quitação/recolheràgaragem/rescisão/sequestros/seqüestro/tabelião/usufruto/uxor/advocacia/alegação/alegação/apelação/bigamia/cidadania/depoimento/ditame/estatuto/honorário/legado/legado/legislador/legislador/legislação/mandado/moléstia/procurador/procuração/revogação/seqüestro/vigência/álibi/anulação/arbitragem/condenação/constituinte/distúrbio/domicílio/interdição/jurista/mandato/mandato/presunção/privilégio/proibição/rapto/sentença/servidão/tribunal/cliente/contrariedade/defensor/evidência/júri/patrimônio/preempção/promotor/promotor/promotor/sequestro/advogado/advogado/advogado/citação/citação/conspiração/cópia/perdão/prescrição/testemunho/testemunho/vigor/declaração/julgamento/lei/lei/prova/testemunha/apelo/ato/incômodo/justiça/direito/execução/execução/herança/herança/opinião/limitação/recurso/corte/parte/casa
lago	orla/costa/litoral/água
lei	acta/adoção/argüido/conúbio/decreto/divorcio/divórcio/licenciamentos/litígio/matrimónio/matrimônio/passaportes/pleito/querelante/sufrágio/testamento/veredicto/veredito/acusado/anistia/bancarrota/coima/curador/falência/fiança/legislação/mandado/réu/adoção/casal/constituição/dono/jurisdição/jurista/juízo/multa/passaporte/sentença/contrato/suspeito/voto/advogado/judiciário/perdão/processo/processo/processo/proprietário/registro/julgamento/julgamento/testemunha/ato/licença/casamento/causa/causa/direito/título/amnistia/carta-patente/chateação/codicilo/common-law/condicional/contratador/debênture/derivativo/derivativos/desacato/desapropriação/dolo/encarceramento/estatuo/fbi/indulto/injunção/intimação/intimação/jurisconsulto/justiça/legalização/legitimação/leis/leis/libelo/litigante/notário/pertubação/premeditação/procurador-geral/quitação/recolheràgaragem/rescisão/sequestros/seqüestro/tabelião/usufruto/uxor/advocacia/alegação/alegação/apelação/bigamia/cidadania/depoimento/ditame/estatuto/honorário/legado/legado/legislador/legislador/legislação/mandado/moléstia/procurador/procuração/revogação/seqüestro/vigência/álibi/anulação/arbitragem/condenação/constituinte/distúrbio/domicílio/interdição/jurista/mandato/mandato/presunção/privilégio/proibição/rapto/sentença/servidão/tribunal/cliente/contrariedade/defensor/evidência/júri/patrimônio/preempção/promotor/promotor/promotor/sequestro/advogado/advogado/advogado/citação/citação/conspiração/cópia/perdão/prescrição/testemunho/testemunho/vigor/declaração/julgamento/prova/testemunha/apelo/ato/incômodo/justiça/direito/execução/execução/herança/herança/opinião/limitação/recurso/corte/parte/casa
lenda	isolda/midas/sísifo/tristão
linguagem	sotaque/discurso/acento/idioma/língua/estilo
literatura	analepse/desconstrução/desconstrução/redacção/redação/corcel
locomotivas	passageiro
língua	sotaque/linguagem/discurso/acento/idioma/estilo
manufatura	uptime/indústria
marinha	marina
matematica	equaçao/equações/matrizes/equação/demonstração/evidência/matriz/fórmula/prova/função/regra/aritmética/aritmética/arredondamento/assimetria/binómio/binômio/calculo/cardinalidade/cáculo/cálculo/expressão/fatoração/fractal/geodésica/geometria/infinitesimal/invariante/invariância/polinómio/polinómios/polinômio/polinômio/reflexiva/topologia/topologia/transitiva/trigonometria/trigonometria/álgebra/álgebra/extrapolação/interpolação/métrica/paralela/simetria/subgrupo/análise/recíproco/transformação/diagonal/fórmula/operador/série/conjunto/cálculo/matemático/raio/imagem/operação/corpo/domínio/plano
matemática	equaçao/equações/matrizes/equação/demonstração/evidência/matriz/fórmula/prova/função/regra/aritmética/aritmética/arredondamento/assimetria/binómio/binômio/calculo/cardinalidade/cáculo/cálculo/expressão/fatoração/fractal/geodésica/geometria/infinitesimal/invariante/invariância/polinómio/polinómios/polinômio/polinômio/reflexiva/topologia/topologia/transitiva/trigonometria/trigonometria/álgebra/álgebra/extrapolação/interpolação/métrica/paralela/simetria/subgrupo/análise/recíproco/transformação/diagonal/fórmula/operador/série/conjunto/cálculo/matemático/raio/imagem/operação/corpo/domínio/plano
medicamento	anafilaxia
música	musico/músico/músico/tema/afinação/arioso/charanga/fanfarra/realejo/sintetizador/sintetizadores/tacto/tonica/transposição/tónica/tônica/uníssono/vibrato/andamento/fermata/ligadura/recapitulação/sanfona/partitura/suíte/timbre/adágio/dominante/gama/linguagem/pauta/seção/discurso/piano/corda/som/órgão/língua/estilo/parte
negócio	chinês/cine/cinema/cadeia/astucidade/gerenciamento/sagacidade/astúcia/capitalista/gestão/sócio/empresa/estabelecimento/participante/administração/parte
oceano	orla/costa/litoral/água
ontogenia	isometria
ontogénese	isometria
pecuária	cultivo
pedagogia	educação/ensino/educação
planta	flora/vegetação/fitoterapia/fitoterapia/fotossintese/fotossíntese/fotossíntese/microorganismo/microrganismo/nitrificação/peroxidase/comensalismo/circulação/coca/parasita/gás
poema	erin/calma/dor
poesia	erin/calma/dor
psicanálise	acatexia/catexia/libido/superego/tânato/catarse/transferência
psicologia	stress/fadiga/inibição/costume/hábito/tensão/abiência/adiência/associacionismo/delusão/extroversão/gestalt/revestimento/nervosismo/introvertido/comportamento/extrovertido/generalização/recompensa/tensão/rosto
quimica	molécula/absorção/átomo/catalisador/electrólise/eletronegatividade/eletrólise/estequiometria/fluorocarbono/fulereno/ph/ph/polimorfismo/dissociação/emulsão/osmose/contraste/indicador/químico/radioactividade/valência/radical/solução/mistura/cadeia
química	molécula/absorção/átomo/catalisador/electrólise/eletronegatividade/eletrólise/estequiometria/fluorocarbono/fulereno/ph/ph/polimorfismo/dissociação/emulsão/osmose/contraste/indicador/químico/radioactividade/valência/radical/solução/mistura/cadeia
religião	submundo/inferno/conformista/consagração/incensário/lúcifer/noviciado/numina/ortodoxia/pudicícia/recato/satanás/satã/turíbulo/castidade/celibato/claustro/vigília/diabo/frade/meditação/perseguição/irmão/tolerância/hábito
remédio	anafilaxia
retorica	exórdio
retórica	exórdio/exórdio
rio	curva/canal/orla/confluência/costa/litoral/água
râguebi	ponteiro/ponta
rúgbi	ponteiro/ponta
ser	arapuca/sacrificio/armadilha/sacrifício/corpo/rede/microorganismo/microrganismo/rastreamento/rastreio/verruga/humanidade/nariz/olfato/lado
show	ensaio
soluto	fluoresceina/fluoresceina/fluoresceína/fluoresceína/salinidade/salinidade/solubilidade/solubilidade
solução	fluoresceina/fluoresceína/salinidade/solubilidade
taxa	recolhedor/cobrador/coletor/encargo/imposto/renda/rendimento
taxação	recolhedor/cobrador/coletor/encargo/imposto/taxa/renda/rendimento
teatro	assento/cadeira/lugar/anfiteatro/casa
tecnologia	código-fonte/enchente/fonte
teologia	predestinação/redenção/purgatório/salvação
trem	passageiro
tributo	recolhedor/cobrador/coletor/encargo/imposto/taxa/renda/rendimento
ténis	forehand/game/serviço
tênis	forehand/game/serviço
usina	uptime/gás
vegetal	flora/vegetação/fitoterapia/fitoterapia/fotossintese/fotossíntese/fotossíntese/microorganismo/microrganismo/nitrificação/peroxidase/comensalismo/circulação/coca/parasita
verso	erin/calma/dor
veículo	tracção/túnel/tração/passageiro/alternador/aluguel/aluguel/arrendamento
viatura	tracção/túnel/tração/passageiro/alternador/aluguel/aluguel/arrendamento
ônibus	passageiro

