abalo	zanga/consternação/espírito/ira/cólera/temor/raiva/terror/humor/medo/alegria/ânsia/ódio/ansiedade/aversão/preocupação/afeição/amor
abandonar	perder
abarcar	abranger/incluir/compreender/conter/ter
abastecer	apetrechar/aparelhar/equipar/suprir/servir/dar/abrigar/amparar/mobiliar/armar/despejar/prover/derramar/fornecer/suprir/ajudar/satisfazer/alimentar/servir/dar
abatimento	declínio/diminuição
abertura	escapatória/saída/porta/capialço/fenestra/furo/colarinho/fresta/janela/vão/buraco/corte/fenda
abominação	enjôo/náusea
abordar	endereçar/lidar/tratar/falar/cobrir
abrigar	sediar/acolher/hospedar
abrigo	morada/apartamento/aposento/moradia/domicílio/residência/habitação/lar/casa/hostelalbergue/quartos/albergue/apartamento/moradia/habitação/acampamento
abstinência	jejum
abstracto	coisa/direito
abstracção	coisa/direito
abstrato	coisa/direito
abstração	mensagem/comunicação/agrupação/atributo/predicado/característica/conjunto/conexão/propriedade/relação/grupo
abundancia	opulência/suntuosidade/sumptuosidade/luxo/riqueza
abuso	perseguição
acabar	cumprir/efetuar/executar/desistir/realizar/parar/abandonar/atingir
acadêmico	catedrático/professor
acariciar	cocegar
acasalar	foder/pinar/copular/meter/transar/trepar/montar/comer
aceitar	consentir/permitir/deixar/crer/involver/acreditar/admitir
acelerar	correr
aceno	numeral/símbolo/selo/número/marcadores/estigma/marca/mancha/selo
acertar	bater
acessar	conectar-se/logar
achar	prezar/respeitar/venerar/enumerar/contar/reputar/valorizar/incluir/gostar/apreciar/julgar/considerar/ver/manter
achatar	rolar
acobertar	disfarçar/mascarar/encobrir/esconder/sepultar/soterrar/enterrar
aconselhar	advocar/recomendar/urgir/promover
acontecer	materializar/re-ocorrer/reincidir/calhar/recorrer/ocorrer/prosseguir/suceder/repetir/ir
acontecimento	cerimónia/revés/alteração/incidente/ocorrência/quebra/acção/cerimônia/feito/instância/modificação/ocasião/variação/coincidência/evento/colapso/acidente/caso/vitória/ato/exemplo/ação/festa/problema/mudança/conjuntura/deflagração/ocorrente/rotulagem/surto/epidemia/eventualidade/incêndio/ocorrência/celebração/convergência/episódio/fado/ocasião/desastre/erupção/evento/interrupção/balada/destino/fogo/início/ruído/toque/coisa/começo/explosão/princípio/som/sorte/experiência/festa/movimento/pausa/ponto
acordar	firmar/conciliar/reconciliar/concordar/providenciar/arranjar/conceder
acordo	consenso
acorrer	facilitar/aliviar
acostar	cumprimentar/saudar
acreditar	crer
acrescentamento	aumento
acrescentar	conglomerar/pontuar/acrescer/aglomerar/amontoar/aprofundar/somar/intensificar/incluir/acumular/adicionar/combinar/crescer/unir/misturar/reunir/aumentar
acrescer	conglomerar/pontuar/aglomerar/amontoar/aprofundar/somar/intensificar/incluir/acumular/acrescentar/adicionar/combinar/crescer/unir/misturar/reunir/aumentar
actividade	jogos/comportamento/jogo
acumulação	estoque/colocação/acúmulo/depósito
acção	critica/trâmite/agressão/interação/conduta/desempenho/feito/juízo/performance/conquista/façanha/rejeição/hostilidade/oposição/recuperação/julgamento/corrente/execução/partida/realização/curso/caminho/comunicado/descobrimento/efetuação/insucesso/jogos/paralização/causalidade/consulta/descoberta/distribuição/escapatória/escape/esgrima/gentileza/implementação/interferência/ociosidade/paralisação/propulsão/uso/atrapalhação/chegada/delicadeza/permanência/selecção/vinda/comunicação/eliminação/fuga/impulsão/amabilidade/bondade/comportamento/contato/disposição/economia/escolha/habitação/impedimento/seleção/atividade/ocupação/toque/ato/coisa/falha/causa/execução/aquisição/ação/parada/realização/jogo/mudança
acúmulo	biota/exposições/galáxia/transito/tránsito/trânsito/embalagem/embrulho/flora/nebulosa/tráfego/trânsito/vegetação/biologia/circulação/cúmulo/jurisprudência/mão/monte/lei/montão/pacote/combinação/exposição/pilha/jogo/grupo/dados/encepamento/miscelanea/mitologia/potpourri/mitologia/universo/aglomeração/categoria/colocação/frota/acumulação/biblioteca/bloco/conjunto/informação/pacote/depósito/mistura/família/grupo/classe
adiar	delongar/pospor/postergar/protelar/prorrogar/procrastinar/atrasar/vacilar
adicionar	pontuar/incluir/combinar/unir/misturar/reunir
adivinhar	estimar
adição	anexo/asa
adjudicator	magistrado/jurista/juiz
administrador	gestor/director/dirigente/diretor/gerente/executivo
administração	tratamento/gerenciamento/gestão/autorização
admiração	estupefação
admitir	involver
adorno	ornamento/decoração
adoçante	açúcar
adquirir	beneficiar-se/re-adquirir/beneficiar/reconquistar/reganhar/auferir/lucrar/comprar/recuperar/ganhar/obter/encontrar/atingir/compartir/fretar/reganhar/topar/partilhar/alugar/ganhar/receber/encontrar/aceitar/atingir/achar/dividir
adulteração	dissimulação/enganação
advertir	alarmar/alertar
aeroporto	aeródromo
aeródromo	aeroporto
afagar	cocegar/acariciar
afectar	estressar/tensionar/energizar/estimular/animar/excitar
afeição	cordialidade/lealdade
afetar	estressar/disturbar/tensionar/emocionar/perturbar/influir/energizar/influenciar/estimular/animar/excitar/atacar/atingir
afiguração	foto/mapa/retrato/cópia/reprodução/fotografia/esquema/imagem/figura/ilustração/modelo/desenho/documento
afirmação	explanação/comentário/asserção/explicação/declaração/resposta/resultado/observação/descrição
afligir-se	prantear/lamentar
aflição	ataque
afrouxar	desaparafusar
agarrar	abocanhar/apreender/beliscar/mordiscar/espremer/morder/apertar/capturar/prender/segurar/pegar/capturar/tomar/segurar/pegar
agente	booker
agir	atrever/atrever-se/ousar/participar/virar-se/voluntariar/compartilhar/aguentar/lidar/sobreviver/tentar/procurar/oferecer/efectivar/interagir/perpetrar/proceder/atrever/atrever-se/cometer/efectuar/efetivar/ousar/reiterar/comportar-se/disturbar/esfriar/performar/reagir/aguardar/efetuar/acelerar/conquistar/lidar/apressar/endurecer/prosseguir/surpreender/repetir/permanecer/interromper/perturbar/reter/adquirir/criar/esperar/resistir/continuar/correr/seguir/conduzir/começar/fazer
agitar	estremecer/tremular/tiritar/tremer
agitação	sacolejo
aglomeração	biota/exposições/galáxia/transito/tránsito/trânsito/embalagem/embrulho/flora/nebulosa/torrão/tráfego/trânsito/vegetação/biologia/circulação/cúmulo/jurisprudência/mão/monte/acúmulo/lei/montão/pacote/combinação/exposição/pilha/pedaço/bola/jogo/grupo/dados/encepamento/miscelanea/mitologia/potpourri/mitologia/universo/categoria/frota/biblioteca/bloco/conjunto/informação/pacote/mistura/família/grupo/classe
agouro	evidência/indicação
agravar	irritar
agregação	reunião
agressão	violência/força
agricultura	horticultura
agrupamento	agregação/coleção/reunião
agrupação	colecção/coleção/linhagem/aglomeração/raça/acúmulo/população/gente/pessoal/sistema/organização/povo/arranjo/humanidade/mundo/população/gente/reino/homem/povo/massa
aguardar	adiar
agência	secretaria/órgão
ajuda	consolação/consolo/apoio/mão/conforto/suporte/socorro/misericórdia/piedade/assistência
ajudante	manequim/secretário/secretária/modelo
ajudar	acorrer/socorrer/assistir/auxiliar/facilitar/encorajar/promover/estimular/aliviar
ajuntar	catar/colher/apanhar/respigar/colher
ajustagem	alinhamento
alcance	extensão/limitação/fronteira/limite
alegrar	animar-se/rejubilar/alegrar-se/exultar/animar
alegrar-se	animar-se/rejubilar/exultar/alegrar/animar
aleijar	lesionar/lesar/ferir/machucar
alertar	alarmar
alfaia	aparelhador/cómoda/gaveteiro/candeeiro/cômoda/luminária/assento/mesa/cadeira/guardarroupas/guarda-roupas/estante/mesa/armário
alguém	conhecida/engenheiro/habitante/proponente/líder/morador/cientista/especialista/parente/conhecido/defensor/advogado/amizade/autoridade/vizinho/aluno/chefe/trabalhador/amigo/estudante/representante/adjudicator/amado/amo/comunicador/creador/desafortunado/desventurado/governante/hebraica/hebreia/infortunado/intelecto/possuidor/amiga/anomalia/autóctone/competidor/contendor/criatura/fêmea/governador/súdito/turista/capitalista/cidadão/criador/dono/hebreu/judia/artista/camarada/conhecido/criativo/hebraico/judeu/juvenil/menor/viajante/amizade/criança/juiz/proprietário/seguidor/amante/esperança/face/jovem/árbitro/amigo/intelectual/pessoa/varão/estudante/macho/rosto/cara/homem/ser/parte/vida
alimentação	repasto/refeição/prato/petisco/guloseima/prato
alimento	repasto/refeição/bebida/prato/alimentos/comestivel/petisco/provisões/suprimentos/guloseima/ração/alimentação/nutriente/nutrição/comida/prato
alinhar	jogar
alisar	lixar
alma	conhecida/engenheiro/habitante/proponente/líder/morador/cientista/especialista/parente/conhecido/defensor/advogado/amizade/autoridade/vizinho/aluno/chefe/trabalhador/amigo/estudante/representante/adjudicator/amado/amo/comunicador/creador/desafortunado/desventurado/governante/hebraica/hebreia/infortunado/intelecto/possuidor/amiga/anomalia/autóctone/competidor/contendor/criatura/fêmea/governador/súdito/turista/capitalista/cidadão/criador/dono/hebreu/judia/artista/camarada/conhecido/criativo/hebraico/judeu/juvenil/menor/viajante/amizade/criança/juiz/proprietário/seguidor/amante/esperança/face/jovem/árbitro/amigo/intelectual/pessoa/varão/estudante/macho/rosto/cara/homem/ser/parte/vida
alocar	presentear/premiar/outorgar/conceder
alojamento	morada/apartamento/aposento/moradia/domicílio/residência/habitação/lar/casa/hostelalbergue/quartos/albergue/apartamento/moradia/habitação/acampamento
alongar	extender/prorrogar/prolongar/esticar
alterar	transmutar/impactar/aperfeiçoar/acertar/completar/afetar/modelar/formar/substituir/ajustar/corrigir/transformar/melhorar/encher/trocar/reduzir/mudar/diminuir/acostumar-se/adequar/amalgamar/aprontar/assear/cevar/depravar/desabilitar/desordenar/desoxidar/estabilizar-se/evaziar/fortalecer/habituar/habituar-se/iluminar-se/indispor/inrijecer/inseminar/perverter/transubstanciar/vestir-se/acostumar/adaptar/afectar/afrouxar/agravar/ampliar/aprumar/arrumar-se/avariar/corromper/desativar/desobstruir/emprestar/engordar/equiparar/exacerbar/fecundar/fertilizar/incapacitar/transmudar/viciar/alumiar/amenizar/descolorir/desvirtuar/encerrar/escurecer/esfriar/estreitar/incorrer/inverter/largar/macular/nivelar/purgar/refrigerar/resfriar/secar/subverter/amanhecer/bagunçar/contaminar/contribuir/enrijecer/fortificar/gelar/iluminar/molhar/progredir/reverter/sujar/amortecer/aviltar/converter/danificar/esquentar/esvaziar/refrescar/traduzir/unificar/afetar/aquecer/colorir/deformar/enxugar/igualar/tornar/apertar/clarear/endurecer/piorar/enfraquecer/manchar/marcar/baixar/finalizar/preparar/vestir/adicionar/ajustar/experimentar/sofrer/transformar/concluir/desenvolver/obter/adquirir/sair/encher/receber/trazer/misturar/terminar/partir/abandonar/deixar/limpar/virar/carregar/conduzir/mudar/dividir/separar/pegar/cair/aumentar/fazer
alteração	decréscimo/falecimento/dano/estrago/flutuação/avaria/variação/prejuízo/surpresa/queda/diminuição/abatimento/morte/mudança/transmutação/nascimento/transformação/crescimento/transição/aumento/mudança
alternativa	cabimento/possibilidade
alvo	objetivo/fim/intenção
amado	amante/amor
amalgamar	mesclar/combinar/misturar
amanhar	produzir/fazer
amante	amor
amarrar	atar
ambiente	quadra/contexto/jazida/quarteirão/âmbito/circunstância/bloco/esfera/domínio/localidade/cena/refúgio
amiga	camarada/companheiro/irmão/amigo/camarada/companheiro/irmão/amigo/colega
amigo	camarada/companheiro/irmão/conexão/camarada/companheiro/irmão/colega
amizade	companherismo/camarada/companheiro/irmão/amigo/conexão/camarada/companheiro/irmão/amigo/colega
amor	lealdade
amparar	sediar/acolher/hospedar
ampliar	alongar/elevar/aumentar
amplidão	altitude/altura
analgésico	aspirina/morfina
analgésicos	aspirina/morfina
analizar	comparar/checar/pesquisar/conferir
anatomia	abdome/abdômen/articulações/bumbum/popô/torso/bunda/estômago/nádegas/ombro/seio/ventre/abdómen/ânus/peito/traço/articulação/tecido/tronco/órgão/barriga/rabo/corpo/traseiro/fundilhos/nalga/nádega/bunda/lombo/anca/costas/banda/canela/região/sistema/traseiro
ancestral	antepassado/progenitor
andar	cave/engatinhar/gatinhar/mansarda/porão/rastejar/rastejar-se/serpear/trapeira/vadiar/vagabundear/vaguear/boiar/pisar/sótão/ático/ascender/escorregar/nadar/errar/passear/perambular/vagar/deslizar/voar/apressar/acompanhar/atravessar/caminhar/dirigir/correr/seguir/ir/subir/passar/apressar-se/coxear/despachar-se/esgueirar/esquiar/mancar/vadear/cavalgar/desfilar/progredir/avançar/marchar/perambular/perseguir/tropeçar/vagar/acelerar/rodar/voar/apressar/descer/montar/prosseguir/baixar/circular/viajar/atravessar/espalhar/vir/caminhar/continuar/seguir/ir/passar/cair
anelo	nostalgia/saudade
anexar	fixar/amarrar/atar/prender/anilhar/etiquetar/inserir/rotular/suplementar/colar/pregar/introduzir/prender/pegar
angustiar	excruciar/torturar/atormentar
animal	cria/predadores/prole/filhote/presa/invertebrados/cordados/fêmea/herbívoro/invertebrado/caça/larva/macho
animar	rejubilar/alentar/exultar/encorajar
animar-se	rejubilar/exultar
anomalia	geek/excêntrico
anseio	ambição/pretensão/aspiração/afã/concupiscência/nostalgia/cio/eros/saudade/anelo/desejo
ansiar	suspirar/desejar/esperançar/aguardar/querer/esperar/desejar
ansiedade	temor/medo/preocupação
antecessor	antepassado/progenitor
antecipar	conjecturar/hipotetizar/teorizar/pressupor/presumir/especular/supor/assumir/supor/pensar/esperar/achar
antenome	título/denominação/cognome/sobrenome/prenome/apelido/nome/título
antepassado	avós/avó/avô/progenitor
anulação	cancelamento
anunciar	divulgar/reportar/relatar
anúncio	cartaz/poster/pôster/letreiro
aparato	acendedor/encosto/maquinaria/tecla/apoio/encendedor/isqueiro/aparelho/chave/mecanismo/máquina/suporte/instrumento/ferramenta/aquecedores/exaustor/leque/magnete/íman/pente/ímã/aquecedor/ventilador/lâmpada/luz/restrição/limitação/guarda
aparecer	mostrar-se
aparelho	acendedor/chibata/encosto/açoite/chicote/maquinaria/tecla/apoio/encendedor/isqueiro/armamento/arma/chave/mecanismo/máquina/suporte/instrumento/ferramenta/aquecedores/exaustor/leque/magnete/íman/pente/ímã/aquecedor/ventilador/lâmpada/metro/luz/restrição/limitação/guarda
aparência	aspecto/rosto/feiura/feiúra/beleza/semblante/expressão/face/rosto
apatia	afastamento
apelo	invitação/convite/reza/súplica/pergunta/oração/petição/inquérito/questão
aperceber	enxergar/ouvir/doer/escutar/cheirar/sentir/olhar/ver/avistar/divisar/sonhar/perceber/ver
aperceber-se	enxergar/ouvir/doer/escutar/cheirar/sentir/olhar/ver/avistar/divisar/sonhar/perceber/ver
aperfeiçoar	reparar/emendar/lustrar/consertar/polir/refinar/embonecar/perfazer/atenuar/empetecar/amenizar/embelezar/polir/acordar/resolver/aliviar/melhorar
apertar	comprimir/contrair
apetite	ambição/pretensão/aspiração/afã/concupiscência/cio/eros/saudade/anelo/anseio/desejo
apetrecho	equipamento/ferramenta/conector/contentor/contêiner/mídia/aparato/dispositivo/implemento/mobília/mobiliário/aparelho/armamento/munição/recipiente/equipamento/móvel/veículo/arma/mecanismo/instrumento/sistema/ferramenta/ligação
apinhar	pulular
aplainar	rolar
apodrecimento	cárie/ruína
apoiar	acorrer/socorrer/assistir/auxiliar/ajudar/encorajar/promover/estimular
apoio	degrau/pedestal/suporte/pé/base/aderência/adesão/endosso/perna/pé
aposento	vivenda/hall/bar/habitação/cozinha/banheiro/sala/casa/biblioteca/banheiro/sala
apostar	jogar
apreciar	reconhecer
apresenta	possuir/portar/ter/carregar
apresentar	manifestar/demonstrar/expor/exibir/revelar/descobrir/mostrar/trazer/tocar/mostrar
apresentação	exibição/exposição
apressar	correr/acelerar/correr
apressar-se	correr
aprofundar	agilizar/acelerar/apressar
aprovar	consentir/permitir/deixar
aproximar	estimar
aprumar	levantar-se
apêndice	taramela/trinco/alça/cabo
aquecer	tostar
aquisição	dádiva/brinde/dom/doação/presente/acolhimento/recebimento
arbusto	rosa/rosas/rosa/pimentão/pimenta/algodão
arco	arco-íris
argumentação	raciocínio/política
arma	revóvel/revólver/bomba/munição
armamento	revóvel/revólver/bomba/arma/munição
aromatizante	erva/adoçante/condimento
arranjar	regularizar/alienar/dispor/arrumar/ordenar
arranjo	array/formação/ordem
array	tabela
arredar	arrastar/tremer
arruinar	destruir
arrumar	organizar
arrumar-se	caber/vestir/pôr/usar/trocar/colocar/mudar
arte	pintura
artefato	adorno/brinquedo/ornato/têxteis/pano/infra-estrutura/edifício/instalação/ornamento/tecido/estrutura/decoração/fazenda/bens/calceteiro/apetrecho/enchimento/via/chapa/cobertura/fio/lousa/mercadoria/superfície/equipamento/banda/bloco/corda/criação/abertura/fazenda/instrumento/placa/produto/capa/linha/artigo/estrada/caminho/bem
articular	enrolar
artigo	importação/mercadoria/produto/carregamento/exportação/frete/louça/mercadoria/carga
artiodáctilos	ruminantes/ruminante
artiodátilo	ruminantes/ruminante
artiodátilos	ruminantes/ruminante
artista	musico/músico/intérprete
artropode	insectos/insetos/hemípteros/insecto/inseto/aracnideos/aracnídeos/crustáceo/crustáceos/aracnídeo
artrópode	insectos/insetos/hemípteros/insecto/inseto/aracnideos/aracnídeos/crustáceo/crustáceos/aracnídeo
artrópodes	insectos/insetos/hemípteros/insecto/inseto/aracnideos/aracnídeos/crustáceo/crustáceos/aracnídeo
arvoreta	rosa/rosas/rosa/pimentão/pimenta/algodão
ascender	galgar/trepar/montar/subir
ascensão	escalada
asco	enjôo/náusea
asilo	tenda/barraca
aspecto	rosto/aparência/feiura/feiúra/beleza/semblante/face/rosto/aparência
assaltar	sitiar/cercar/emboscar/invadir/ocupar
assear	lavar/desinfectar/desinfetar/escovar/varrer
assembleia	juizado/legislatura/tribunal/corte
assembléia	juizado/legislatura/tribunal/encontro/corte/reunião/concentração
assemelhar	copiar/imitar
assemelhar-se	assemelhar/copiar/imitar
assento	cadeira
assinalar	cadastrar/ler/mostrar/registrar
assintência	tratamento
assistente	manequim/secretário/secretária/modelo
assistir	facilitar/aliviar
assistência	consolação/consolo/apoio/mão/ajuda/conforto/suporte/socorro/ajuda/misericórdia/piedade
associado	membro
associar	mencionar/referir
associar-se	unificar/reunir
associação	guilda/clube/sociedade/ordem/consórcio/gangue/sindicato/instituição/quadrilha/instituto
assunto	narrativa/narração/significância/significação/matéria/tópico/tema/informação/significado/história/intenção/proposta/afirmação/aplauso/reconhecimento/declaração/área/aprovação
astro	planeta/estrela
atacar	sitiar/cercar/emboscar/invadir/ocupar
ataque	bombardeio/tiro
atar	amarrar
atingir	efectuar/efetuar/alcançar/obter/realizar/desempenhar/chocar/colidir/cumprir/realizar/bater
atitude	mentalidade/tendência/deferência/intolerância/orientação/respeito
atividade	abastecimento/ingestão/posicionamento/treinamento/treino/trâmite/agressão/interação/protecção/provimento/auxílio/conduta/consumo/desempenho/feito/performance/socorro/colocação/conquista/façanha/fornecimento/ajuda/comportamento/hostilidade/oposição/procedimento/processo/esforço/liderança/manobra/preparação/proteção/assistência/costume/criação/tentativa/corrente/execução/hábito/operação/realização/curso/jogo/caminho/agrupamento/apodrecimento/calibração/controlo/delito/desabafo/fluxos/galhofa/jogos/mensuração/recreaçao/adoração/amparo/consulta/desperdício/esgrima/gentileza/medição/ocultação/putrefação/transa/transgressão/uso/utilização/atuação/cerimônia/chegada/delicadeza/deterioração/difusão/diversão/escrita/selecção/vinda/decomposição/música/amabilidade/animação/bondade/comportamento/divertimento/economia/escolha/medida/reação/representação/seleção/sucessão/vez/preparação/respiração/sexo/suporte/buscar/coisa/resposta/tarefa/interpretação/operação/mercado/organização/controle/jogo/procurar/trabalho/mudança
ato	acta/critica/decreto/trâmite/agressão/interação/conduta/desempenho/feito/juízo/performance/conquista/façanha/rejeição/hostilidade/oposição/recuperação/julgamento/corrente/execução/partida/realização/curso/caminho/comunicado/descobrimento/efetuação/insucesso/paralização/causalidade/consulta/descoberta/distribuição/escapatória/escape/esgrima/gentileza/implementação/interferência/ociosidade/paralisação/propulsão/uso/acção/atrapalhação/chegada/delicadeza/permanência/selecção/vinda/comunicação/eliminação/fuga/impulsão/amabilidade/bondade/contato/disposição/economia/escolha/habitação/impedimento/seleção/atividade/ocupação/toque/coisa/falha/causa/execução/aquisição/ação/parada/realização/mudança
atrapalhar	entravar/estorvar/tolher/impedir/defender/reter/evitar
atrapalhação	obstrução
atravessar	correr
atribuir	alocar
atributo	feição/peculiaridade/temperamento/constituição/fraqueza/grandeza/característica/odor/cheiro/composição/estrutura/idade/personalidade/magnitude/pessoa/grau/qualidade/força/número/formato/forma/situação/condição/estado/maneira/propriedade/qualidade/estilo/tempo
atuar	atrever/atrever-se/ousar/participar/virar-se/voluntariar/compartilhar/aguentar/lidar/sobreviver/tentar/procurar/oferecer/efectivar/interagir/perpetrar/proceder/atrever/atrever-se/cometer/efectuar/efetivar/ousar/reiterar/comportar-se/disturbar/esfriar/performar/retratar/reagir/aguardar/efetuar/personificar/acelerar/conquistar/lidar/apressar/endurecer/prosseguir/surpreender/repetir/permanecer/interromper/perturbar/reter/adquirir/criar/esperar/resistir/continuar/correr/seguir/representar/conduzir/começar/fazer
atuação	concertos/concerto/show/rotina/caracterização/imitação/personificação/ato/número
aula	seminário
aumentar	florescer/expandir/subir/conglomerar/proliferar/acrescer/aglomerar/amontoar/aprofundar/progredir/somar/intensificar/alongar/elevar/expandir/acumular/acrescentar/adicionar/crescer/desenvolver
aumento	enaltecimento/engrandecimento/acumulação/acúmulo/concentração
ausência	escassez
auto	ambulancia/taxi/ambulância/táxi/calhambeque/jipe/sedan/sedã/carro
automóvel	ambulancia/taxi/ambulância/táxi/calhambeque/jipe/sedan/sedã/carro
autor	periodista/poetas/poeta/poetisa/jornalista
autoridade	julgador/avaliador/mestre/professor
autorização	delegação
auxiliar	facilitar/aliviar
auxílio	apoio/mão/ajuda/suporte/socorro/ajuda/assistência
avaliar	hierarquizar/ranquiar/antecipar/medir/classificar/estimar/pensar/achar/enaltecer/imputar/elogiar/ensaiar/louvar/atribuir/testar/tentar/estimar/aprovar/rejeitar/julgar/declarar/aceitar
avariar	deteriorar/estragar/falir/queimar
aversão	nojo/asco/enjôo/inimizade/repugnância/náusea/ressentimento/abominação/hostilidade/repulsa
aviltar	degradar/desvalorizar/rebaixar
avisar	alarmar/alertar
avistar	ver
avó	vovozinha/vovó/vovô/avô
avós	vovozinha/vovó/vovô/avó/avô
avô	vovozinha/vovó/vovô/avó
azar	infortúnio
ação	critica/trâmite/agressão/interação/conduta/desempenho/feito/juízo/performance/conquista/façanha/rejeição/hostilidade/oposição/recuperação/julgamento/corrente/execução/partida/realização/curso/caminho/apodrecimento/comunicado/descobrimento/efetuação/fluxos/insucesso/jogos/paralização/causalidade/consulta/descoberta/distribuição/escapatória/escape/esgrima/gentileza/implementação/interferência/ociosidade/paralisação/propulsão/putrefação/uso/acção/atrapalhação/chegada/delicadeza/deterioração/difusão/permanência/selecção/vinda/comunicação/decomposição/eliminação/fuga/impulsão/amabilidade/bondade/comportamento/contato/disposição/economia/escolha/habitação/impedimento/seleção/sucessão/atividade/ocupação/toque/ato/coisa/falha/causa/execução/aquisição/parada/realização/jogo/mudança
bagunça	doença
bagunçar	abagunçar/desorganizar
baixar	naufragar/afundar/apear/apear-se/desmontar/afundar/cair
bala	caramelo
balada	festa
balizar	hierarquizar/ranquiar/antecipar/medir/classificar/estimar/avaliar/pensar/achar/imputar/ensaiar/atribuir/testar/tentar/aprovar/rejeitar/julgar/declarar/aceitar
banda	faixa
barco	balsa/barca/barcaça/bateira/canoa/vapor
barra	pau
barreira	estacada/paliçada/cerca/guarda-lama
base	alicerce/pé
bastar	qualificar-se/qualificar/servir
bastão	clava/porrete
batalha	combate/luta/guerra/defesa/conflito/proteção/disputa
batel	balsa/barca/barcaça/bateira/barco
bater	chutar/chocar/colidir
beber	bebericar/sorver/sugar/chupar
bebida	leite/chá/café
bem	importação/mercadoria/possessão/dinheiro/produto/propriedade/artigo/exportação
bens	livros/película/importação/cinema/filme/mercadoria/revista/livro/produto/produção/artigo/exportação/obra/fruto/jornal/produto/produção/trabalho
besta	cria/predadores/prole/filhote/presa/invertebrados/cordados/fêmea/herbívoro/invertebrado/caça/larva/macho
bicha	fileira
bicho	cria/predadores/prole/filhote/presa/invertebrados/cordados/fêmea/herbívoro/invertebrado/caça/larva/macho
bloco	laje/placa/bigorna
bobeira	absurdidade
bolsa	algibeira/bolso
booker	divulgador/promoter/empresário
botar	deitar/semear/instalar/dispor/plantar/arranjar/pôr/colocar/estacionar/posicionar/instalar/posar/sentar-se/assentar/sentar/situar/acumular/sinalizar/erguer/pôr/levantar
bote	balsa/barca/barcaça/bateira/barco
boutique	botica/drogaria/drograria/farmacia/farmácia
bovídeos	ovinos/ovelha/carneiro
boxe	combate/luta
brigar	aguerrir/combater/guerrear/digladiar/assaltar/batalhar/lutar/atacar
brincadeira	flerte
brinde	galardão/prémio/prêmio/ajuda
brinquedo	pião/boneca/boneco/ursídeos/bola
buraco	ranhura
buscar	vasculhar/revirar/procurar
caber	ajustar/experimentar
cabeça	administrador/gerente
cadeira	assento
cadáver	enchido/defunto/corpo
cair	naufragar/afundar/apear/apear-se/chover/desmontar/afundar
calcular	cobrar/subtrair/aproximar/adivinhar/deduzir/chutar/estimar/avaliar/julgar/dividir
calibração	ajustagem/reajuste/regulação
calçado	bota/tamanco
calçados	bota/calçado/tamanco
camada	pigmento/tinta/pintura/cor/superfície
camarada	companheiro/irmão/amigo/companheiro/irmão/amigo/colega
camaradagem	afeição/empatia/compaixão/piedade
caminhar	engatinhar/gatinhar/rastejar/rastejar-se/serpear/vadiar/vagabundear/vaguear/boiar/pisar/ascender/escorregar/nadar/errar/passear/perambular/vagar/deslizar/voar/apressar/acompanhar/atravessar/dirigir/correr/seguir/ir/andar/subir/passar/apressar-se/coxear/despachar-se/esgueirar/esquiar/mancar/vadear/cavalgar/desfilar/progredir/avançar/marchar/perambular/perseguir/tropeçar/vagar/acelerar/rodar/apressar/descer/montar/prosseguir/baixar/circular/viajar/atravessar/espalhar/vir/continuar/seguir/ir/andar/passar/cair
caminho	alameda/via/rodovia/entrada/estrada/abordagens/caminhos/rumo/senda/trilhos/direcção/trilho/avenida/direção/trilha/acesso/passagem/curso/estrada
campanha	brejos/planícies/páramo/planície/charneca
campo	engenharia/tecnologia/ciência
campos	horto/jardim
canal	orifício
canalizar	estacionar
cantar	trautear/cantarolar/trinar
capa	envólucro/amparo/máscara/pigmento/protecção/cobertor/telhado/cobertura/tinta/camada/escudo/teto/pintura/proteção/cor/calçados/embalagens/invólucro/cortina/vestimenta/tampa/cobertura/tapete/vestuário/calçado/camuflagem/proteção/traje/roupa/vestido
capacidade	meta/técnica/inteligência/habilidade/talento/criatividade/aptidão/faculdade/liderança/habilidade/talento
capitalista	empresário
capturar	apreender/agarrar/prender/segurar/raptar/seqüestrar/sequestrar/agarrar/segurar/pegar
caracterizar	distinguir/diferenciar/marcar
caracterização	personagem/papel
característica	faceta/feição/peculiaridade/temperamento/personalidade/pessoa/qualidade/incompatibilidade/atributo/formato/forma/situação/condição/estado/propriedade/qualidade/tempo
carapaça	concha
caraterizar	distinguir/diferenciar/marcar
carburante	benzina/gasolina/coque/cozedura/lenha/querosene/fuelóleo/petróleo
carne	corte
carnívoro	canídeo/cão
carregar	deitar/semear/instalar/dispor/plantar/arranjar/pôr/colocar/aerotransportar/estacionar/posicionar/instalar/posar/sentar-se/assentar/sentar/situar/acumular/sinalizar/erguer/pôr/levantar
carro	ambulancia/taxi/ambulância/táxi/calhambeque/jipe/sedan/sedã
carruagem	táxi
carta	invitação/convite
caráter	ânimo
carência	ausência/escassez/deficiência/falta/escassez/necessidade
casa	morada/vivenda/apartamento/aposento/moradia/domicílio/residência/habitação/lar/hostelalbergue/quartos/albergue/apartamento/moradia/habitação/acampamento/lar
casadeoração	igrejas/igreja/templo
caso	vez
castigar	executar
categoria	espécies/raça/espécie/variedade/género/estilo/tipo/classe
catequizar	arma/recurso
caule	galho/ramo
causa	alguém/fator/indivíduo/alma/pessoa/poder/força/aventurança/manipulador/fado/operador/ameaça/destino/perigo/efeito/risco
causador	alguém/indivíduo/alma/pessoa/poder/força/aventurança/manipulador/fado/operador/ameaça/destino/perigo/risco
causalidade	efeito
causar	recriar/copiar/desovar/ocasionar/pioneirar/adjudicar/edificar/empreender/concretizar/confeccionar/imaginar/fabricar/procriar/recriar/reproduzir/substanciar/efetuar/verbalizar/gerar/outorgar/produzir/preparar/construir/realizar/criar/iniciar/provocar/dar/fazer
cavalo	garanhão
ceder	comissionar/desobrigar/incumbir/confidenciar/confiar/livrar/alienar/transferir/renunciar/desistir/transmitir/liberar/abandonar/deixar/entregar/dar
celebrar	curtir
celebração	festival
centrar	focar
cerimónia	boda/funeral/boda/enterro/funeral/casamento
cerimônia	boda/funeral/boda/enterro/funeral/casamento
cerrar	bater/tirar
certame	competição/torneio/corrida/combate/partida/jogo/luta/corrida
certeza	pose/altivez/aprumo/desembaraço/fé
cessar	desistir/parar/abandonar
chamar	baptizar/batizar
chance	oportunidade/potenciabilidade/potencial/audiência/ouvinte/dia
chapa	tábua/lousa/quadro/placa
chapéu	sombreiro
checar	espionar/mirar/observar/guardar/olhar/ver
chefe	empregador/líder/administrador/gerente/cabeça/liderança/exemplo/responsável/modelo/político/presidente/superior
chegada	regresso/vinda/volta/retorno/ingresso/entrada
cheirar	tresandar/recender/feder
cheiro	aroma/fragância
choramingar	lacrimejar/gemer
chorar	lacrimejar/gemer/choramingar
chutar	estimar
chão	florestas/arvoredo/selva/bosque/ilha/mata/floresta/planície/campanha/terra
cidadão	cidadã
circunscrição	jurisdição/bairro/vizinhança
circunstância	justificativa/justificação/evento/caso
ciência	matematica/matemática/psicologia/quimica/física/química/lingüística/linguística/lingüística
clareador	sabonete/sabão
classe	gradação/variante/versão/grau/burguesia/mulherio/irmandade/fraternidade/categoria/espécies/raça/espécie/variedade/primeiro/género/mercado/mulher/estilo/tipo/ordem
classificar	denominar/chamar/nomear
clã	genealogia/família
coalizão	confederação/aliança
cobertor	camuflagem
cobertura	envólucro/máscara/cobertor/camada/capa/calçados/embalagens/invólucro/vestimenta/tampa/tapete/vestuário/calçado/camuflagem/proteção/traje/capa/roupa/vestido
cobrar	arrecadar/coletar
cobre	cache/numerário/divisa/moeda/dinheiro/moeda
cobrir	embrulhar/pintar/embalar/encadernar/revestir/inundar/submergir/aplicar/colocar
cochilar	capotar/sonecar/dormir/dormitar
coerência	continuidade
coesão	continuidade
cogitar	centrar/ruminar/concentrar/associar/conectar/relacionar/ponderar/especular/focar/questionar/contemplar/perguntar/planejar/refletir/balizar/raciocinar/avaliar/julgar
cognição	psique/atitude/mente/cabeça/incapacidade/informação/capacidade/conhecimento/poder/habilidade/talento
colaboração	representação
colecção	biota/exposições/galáxia/transito/tránsito/trânsito/embalagem/embrulho/flora/nebulosa/tráfego/trânsito/vegetação/biologia/circulação/cúmulo/jurisprudência/mão/monte/acúmulo/lei/montão/pacote/combinação/exposição/pilha/jogo/grupo/dados/encepamento/miscelanea/mitologia/potpourri/mitologia/universo/aglomeração/categoria/frota/biblioteca/bloco/conjunto/informação/pacote/mistura/família/grupo/classe
coletar	catar/colher/apanhar/respigar/colher
coleção	biota/exposições/galáxia/transito/tránsito/trânsito/embalagem/embrulho/flora/nebulosa/tráfego/trânsito/vegetação/biologia/circulação/cúmulo/jurisprudência/mão/monte/acúmulo/lei/montão/pacote/combinação/exposição/pilha/jogo/grupo/dados/encepamento/miscelanea/mitologia/potpourri/mitologia/universo/aglomeração/categoria/frota/biblioteca/bloco/conjunto/informação/pacote/mistura/família/reunião/grupo/classe
colidir	chocar/bater
coligação	confederação/aliança
coligir	catar/colher/apanhar/respigar/colher
colo	peito
colocar	deitar/semear/instalar/dispor/plantar/arranjar/pôr/estacionar/posicionar/instalar/posar/sentar-se/assentar/sentar/situar/acumular/sinalizar/erguer/experimentar/pôr/levantar
colocação	armazenamento/depósito
colorante	pigmento/tinta/pintura/cor/pigmentos/corante/pigmento/tintura/cor
colorir	enrubescer/rosar/ruborizar/corar/avermelhar/empalidecer/clarear
comando	mandamento/ordem
comarca	jurisdição/bairro/vizinhança
combate	batalha/luta/guerra/defesa/conflito/proteção/disputa
combinar	assemelhar-se/assemelhar/parecer/convir/adaptar-se/adequar-se/harmonizar/compatibilizar/corresponder/concordar/satisfazer
combinação	unificação/junção
combustível	benzina/gasolina/coque/cozedura/lenha/querosene/fuelóleo/petróleo
comer	papar/mordiscar
comercialismo	industria/pagamento/empresa/negócio/comércio/venda
comerciante	dono/proprietário
começo	gênese/alvorecer/iniciação/manhã/constituição/madrugada/amanhecer/concepção/estabelecimento/início/origem/criação/princípio/causa/organização
comida	repasto/refeição/bebida/prato/alimentos/comestivel/petisco/provisões/suprimentos/guloseima/ração/alimentação/nutriente/nutrição/alimento/prato
comissionar	consignar
comover	atemorizar/amedrontar/assustar/disturbar/aterrorizar/emocionar/intimidar/perturbar/inspirar/intoxicar/exaltar/elevar/convidar/tentar/animar/excitar/provocar
comoção	zanga/consternação/espírito/ira/cólera/temor/raiva/terror/humor/medo/alegria/ânsia/ódio/ansiedade/aversão/preocupação/afeição/amor
compactação	pulverização/trituração
compaixão	afeição/empatia/piedade
companheiro	esposa/mulher
companhia	empresa
compelir	coagir/obrigar/forçar
competidor	atleta/desportista/desafiante/oponente/rival/adversário/contendor/concorrente/opositor
competir	jogar
competição	torneio/corrida/combate/partida/jogo/luta/corrida
completar	carregar
componente	hardware/adição/melhoria/pixel/píxel/fator/metade/turno/jogo/ponto/parte/traseiro
comportamento	desfeita/ofensa/injúria/modo/maneira
comportar-se	reinvindicar/asseverar/esfriar/reagir/conquistar/endurecer/adquirir/fazer
composição	unificação/arquitectura/junção/estrutura
comprar	beneficiar-se/re-adquirir/beneficiar/reconquistar/reganhar/auferir/lucrar/recuperar/ganhar/obter/adquirir/encontrar/atingir/compartir/fretar/reganhar/topar/partilhar/alugar/ganhar/adquirir/receber/encontrar/aceitar/atingir/achar/dividir
compreender	ler/escanear/ler
compreensão	psique/atitude/mente/cabeça/consciência/incapacidade/informação/capacidade/conhecimento/poder/saber/habilidade/talento
compressão	esmagamento/compactação
computar	cobrar/subtrair/aproximar/adivinhar/deduzir/chutar/estimar/avaliar/julgar/dividir
comunicado	correios/dramaturgia/correio/discurso/exame/teatro/discussão/teste/convencimento/persuasão/catequizar/transmissão/expressão
comunicador	autor/escritor/negociador
comunicar	indagar/redigir/perguntar/saudar/escrever/falar/dizer/gesticular/telecomunicar/dialogar/proferir/dirigir-se/compartilhar/exprimir/verbalizar/conversar/informar/transmitir/falar/dizer
comunicação	correios/dramaturgia/agouro/indício/mensagem/presságio/correio/indicação/linguagem/discurso/exame/idioma/teatro/discussão/língua/sinal/teste/convencimento/persuasão/documento/mensagem/catequizar/linguagem/transmissão/tópico/assunto/conteúdo/discurso/expressão/voz/anúncio/língua/estilo
comunidade	assentamento/júri/colônia/aldeia/povoado/júri/vila/vocação/associação/voto/bairro/administração/vizinhança/organização
comércio	industria/transportação/indústria/manufatura/pagamento/transporte/empresa/negócio/expedição/finança/venda
conceber	descobrir/achar
conceder	lotear/desculpar/perdoar/atribuir
conceito	projecto/atributo/categoria/concepção/possibilidade/programação/soma/característica/idéia/suposição/tema/teoria/motivo/projeto/quantidade/hipótese/propriedade/qualidade/família/ideia/intenção/programa/plano/número/classe/abstracção/abstracto/abstrato/totalidade/sentido/lei/componente/significado/intenção
conceitualizar	descobrir/achar
concentrar	focar
concentração	foco
concepção	atributo/categoria/possibilidade/soma/característica/suposição/teoria/quantidade/hipótese/propriedade/qualidade/família/número/classe/abstracção/abstracto/abstrato/totalidade/lei/componente
concluir	encerrar/finalizar/acabar/terminar/abortar/suspender/finalizar/resolver/interromper/decidir/acabar/terminar/aceitar/parar
conclusão	desaparecimento/demissão/assassinato/destruição/homicídio/devastação/morte
concordar	assemelhar-se/assemelhar/firmar/conciliar/reconciliar/consentir/permitir/parecer/deixar/convir/adaptar-se/adequar-se/harmonizar/providenciar/compatibilizar/arranjar/corresponder/conceder/satisfazer
concorrer	jogar
concurso	competição/torneio/corrida/combate/partida/jogo/luta/corrida
concórdia	consenso/acordo
condimento	molho/erva/adoçante
condição	recontro/inimizade/relacionamento/confronto/conflito/hostilidade/liberdade/situação/relação/actividade/desordem/existência/imaturidade/imperfeição/ápice/acção/destruição/existência/perfeição/cena/cenário/iluminação/nível/delegação/fase/ambiente/atividade/bagunça/situação/defeito/estado/prisão/união/grau/ação/movimento/morte/ser/habilidade/relação/ligação
conduta	desfeita/ofensa/injúria/caminho/modo/maneira
condutas	vaso
condutor	cobre
conduzir	encabeçar/liderar/comandar/reinvindicar/asseverar/dar/fazer
conectar	mencionar/referir/amarrar/atar
conexão	parentesco/comparação/fundação/afinidade/possessão/propriedade/relação/coerência/coesão/reciprocidade/relacionamento/parentesco/posse/oposição/propriedade/relação/bem/ligação
confeccionar	cozinhar/moldar/forjar/modelar/formar/preparar
conferir	espionar/mirar/observar/guardar/olhar/ver
confiar	consignar
confidenciar	consignar
confinamento	detenção/custódia
confinar	amarrar/atar
conflito	peleja/pugna/insurreição/revolta/atrito/fricção/rebelião/disputa/combate/batalha/luta
conformidade	consenso/acordo
confronto	atrito/fricção
confundir	angustiar/doer/machucar
conhecer	realizar/compreender/entender
conhecida	conexão
conhecido	camarada/companheiro/irmão/amigo/conexão/camarada/companheiro/irmão/amigo/colega
conhecimento	psique/atitude/circunstância/instância/mente/consideração/disciplina/cabeça/exemplo/representante/campo/domínio/datum/facto/estimulante/estímulo/ciência/dado/incapacidade/informação/capacidade/verdade/poder/habilidade/talento/base
conjecturar	afigurar/envisionar/figurar/visualizar/ver
conjeturar	afigurar/envisionar/figurar/visualizar/ver
conjunto	colecção/coleção/linhagem/aglomeração/raça/acúmulo/população/gente/pessoal/sistema/organização/povo/interseção/arranjo/humanidade/mundo/população/gente/reino/homem/povo/massa
conjuntura	virada/crise
conquista	proeza/feito/obtenção/andada/façanha/realização
conseguir	efectuar/efetuar/alcançar/obter/realizar/atingir
consentir	aturar/tolerar/aguentar/permitir/suportar/admitir/aceitar/deixar/confiar/autorizar/permitir
consequência	efeitos/influência/efeito
conseqüência	efeitos/influência/efeito
consertar	remendar
conservar	distanciar-se/enlatar/distanciar/afastar/registar/registrar
considerar	prezar/respeitar/venerar/valorizar/incluir/gostar/apreciar/julgar/manter
consideração	justificativa/justificação
consignar	empenhar
consorte	esposa/mulher
consternação	pânico/terror/medo/calafrio/tremedeira/tremura/arrepio/tremor
constituição	arquitectura/estrutura
construir	cozinhar/moldar/forjar/modelar/formar/preparar
construção	fabricação
consumir	deglutir/ingurgitar/papar/fumar/beber/engolir/comer/experimentar/provar/tomar/beber/comer/tomar/usar
contabilizar	cobrar
contaminação	poluição
contar	descerrar/retrucar/divulgar/cobrar/replicar/responder/revelar/prefaciar/redizer/denotar/pressagiar/reapresentar/reiterar/evidenciar/preceder/sugerir/sinalizar/prever/repetir/introduzir/anunciar/apresentar/indicar/transmitir/declarar/representar/dar
contas	bisbilhotice/bisbolhetice/fofoca/anedota/historieta/piada
contato	agarrão/beijo/ósculo/pegada/batida/pegar
contemplar	ponderar/questionar/perguntar
contendor	atleta/desportista/desafiante/oponente/rival/adversário/competidor/concorrente/opositor
contentor	envelope/sobrecarta/vasilhame/sobrescrito/cesta/copo/cesto/lata/vasilha/vaso/caixa/sacola/embalagem/lata/molde/recipiente/vasilha/saco/pacote/bolsa
conter	abranger/privar/incluir/compreender/ter/delimitar/marcar
conteúdo	narrativa/narração/significância/significação/matéria/tópico/assunto/tema/informação/significado/história/intenção/cesto/botelha/proposta/afirmação/aplauso/cesto/garrafa/reconhecimento/declaração/aprovação
continuar	esparramar/espalhar
continuidade	trecho/período
contorno	curvatura
controlar	limitar/restringir/conter/avionar/pilotar/voar/limitar/restringir/treinar
controle	possessão/propriedade/orientação
controlo	possessão/propriedade/orientação
contêiner	envelope/sobrecarta/vasilhame/sobrescrito/cesta/copo/cesto/lata/vasilha/vaso/caixa/sacola/embalagem/lata/molde/recipiente/vasilha/saco/pacote/bolsa
contínuo	história
convencimento	arma/recurso
convergência	encontro/reunião
conversar	cochichar/balbuciar/sussurrar/resmungar/discutir/murmurar/berrar/cantar/gritar/boquejar/papear/prosear/balbuciar/gaguejar/ladrar/bradar/fofocar/proclamar/vociferar/discutir/confabular/murmurar/tagarelar/reclamar/falar
convexidade	projeção
convicção	doutrina/religião/filosofia/certeza/fé/espirito/perspicácia/confiança/pensamento/fé/opinião
convidar	desafiar
cooperação	representação
copular	foder/pinar/meter/transar/trepar/montar/comer
cor	pigmento/tinta/pintura/pigmentos/corante/pigmento/tintura/matiz/tom
corante	pigmento/tinta/pintura/cor/pigmentos/pigmento/tintura/cor
corda	fio/lã
cordados	vertebrado
cordialidade	irmandade/fraternidade
corpo	divisão/enchido/partículas/defunto/cadáver/partícula/companhia
corrente	rio/caminho/regato/ribeira
correr	esfregar/arremeter/fluir/acelerar
corresponder	assemelhar-se/assemelhar/parecer/convir/adaptar-se/adequar-se/harmonizar/compatibilizar/concordar/satisfazer
corrida	estafeta
cortar	rascar/coçar/raspar
cortina	reposteiro
costa	beira-mar/litoral
costume	rito/ritual/hábito/maltrato/escravidão/ritual/emprego/hábito
cozinha	culinária
cozinhar	preservar/conservar/frigir/fritar
creador	artista/fazedor
crença	doutrina/convicção/religião/filosofia/certeza/fé/espirito/perspicácia/confiança/pensamento/fé/opinião
crescer	florescer/expandir/subir/aumentar/conglomerar/proliferar/acrescer/aglomerar/amontoar/aprofundar/progredir/somar/intensificar/expandir/acumular/acrescentar/adicionar/desenvolver/aumentar
crescimento	cultura/concentração
criado	manequim/secretário/secretária/modelo
criador	artista/fazedor
criança	bebé/criancinha/nenê/recém-nascido/bebê/filha/rapaz/menino
criar	pincelar/pintar/recriar/copiar/hibridizar/edificar/concretizar/confeccionar/imaginar/fabricar/procriar/recriar/reproduzir/substanciar/cruzar/verbalizar/gerar/causar/produzir/preparar/construir/realizar/provocar/dar/fazer
criatividade	inovação/concepção/invenção/imaginação
criativo	artista/fazedor
criatura	cria/predadores/prole/filhote/presa/invertebrados/cordados/fêmea/herbívoro/invertebrado/caça/larva/macho
criação	arte/afiguração/belas-artes/bens/bordado/arte/representação/composição/imagem/produto/figura/ilustração/produção/desenho
crime	infracção/infração/furto/roubo
critica	avaliação/estimativa/cálculo
crónica	biografia
crônica	biografia
cuidado	tratamento
cuidar	administrar/gerenciar/gerir/lidar/tratar/organizar/dirigir/conduzir
cuidar-se	maquilar/maquiar/lavar/limpar
culinária	cozinha
cultivar	produzir/fazer
cultivo	agricultura/pecuária/horticultura
cumprimentar	despidir/saudar
cumprir	bastar/desempenhar/realizar/servir/cobrir
curiosidade	interesse
curso	seminário/caminho/trilha/norte
curva	arco
curvar	acovardar/acovardar-se/debruçar/inclinar
custear	liquidar
custo	prejuízo/vermelho/perda/ganho/pagamento/taxa/recompensa/preço/lucro
custos	pagamento/taxa/recompensa/preço/custo
cáculo	combinação
cálculo	cáculo/operação
círculo	camarilha
cólera	fúria/ira/raiva
cónica	elipse/oval/parábola
cónjuge	esposa/mulher
córrego	rio/regato/ribeira
cônica	elipse/oval/parábola
cônjuge	esposa/mulher
dado	hora/leitura
danificar	deteriorar/estragar/avariar/falir/queimar
danificação	ferimento
dano	fractura/fratura
dar	legar/emprestar/prestar/doar/prover/abastecer/dispensar/fornecer/suprir/pagar/deixar/entregar/passar/comissionar/desobrigar/incumbir/provisionar/adjudicar/confidenciar/lembrar-se/render-se/submeter-se/confiar/depositar/possibilitar/sucumbir/contribuir/financiar/livrar/providenciar/alienar/ceder/proporcionar/prover/transferir/abastecer/lidar/fornecer/renunciar/outorgar/permitir/conceder/lembrar/desistir/transmitir/liberar/oferecer/servir/abandonar/deixar/entregar/passar/manter
datum	dado/leitura
debate	tramitação/negociação/conversa/discussão
debruçar	declivar/inclinar
decair	degenerar/degradar/deteriorar/piorar/adoecer/adoentar/piorar
decidir	seleccionar/selecionar/escolher/mensurar/regulamentar/regularizar/decretar/medir
decisão	intercorrência/opção/alternativa/eleição/escolha/designação/nomeação/selecção/escolha/passo/movimento
declarar	pronunciar/rotular/julgar
declaração	explanação/comentário/asserção/explicação/resposta/resultado/observação/descrição
declínio	deterioração/perda
decomposição	cárie/ruína
decoração	ornamento/joalharia/joalheria/jóia/ornamento
defender	proteger
defensor	guarda
deficiência	escassez
deformar	vergar/desdobrar/curvar/esticar/dobrar/torcer/estender
defunto	enchido/cadáver/corpo
degradação	desmoralização
deidade	santo
deidades	santo
deixar	aturar/tolerar/aguentar/suportar/admitir/aceitar/lembrar-se/confiar/autorizar/permitir/lembrar/desistir/parar/abandonar
delapidar	dissipar/desperdiçar
delegar	avançar/promover
delinear	escrever
delito	transgressão/adulteração/desonestidade/falsificação
demanda	consumo
demandar	exigir/requerer
demo	manifestação/reflexão
demolição	desolação/ruína
demonstração	manifestação/reflexão
denominar	baptizar/batizar/rotular/classificar
denominação	título
departamento	broto/ramo
depósito	armazenamento
derramar	salpicar/espalhar
derrota	capitulação/rendição
desabilitar	deter/confinar/reter/prender/manter
desacordo	querela/controvérsia/discordância/disputa/discussão
desafortunado	cativo/preso/prisioneiro/refém
desaguar	salpicar/espalhar
desaparecer	esvanecer
desastre	vencimento/derrota/perda
desativar	deter/confinar/reter/prender/manter
descansar	levantar/capotar/sonecar/dormir/dormitar/cochilar
descartar	abandonar
descendente	criança/filho/menino
descendência	criança/filho/menino/família
descensão	paraquedismo/queda
descer	naufragar/afundar/apear/apear-se/desmontar/afundar/cair
descolar	cair/cortar
descolorir	enrubescer/rosar/ruborizar/corar/avermelhar/empalidecer/clarear
desconcertar	angustiar/doer/machucar
desconsideração	esnobada/desprezo
descontinuar	desistir/parar/abandonar
descrição	caraterização/caracterização
desejar	ansiar/suspirar/esperançar/aguardar/querer/esperar
desejo	ambição/pretensão/aspiração/afã/concupiscência/nostalgia/cio/eros/saudade/anelo/anseio
desempenhar	tocar/ensaiar/improvisar/exercitar/praticar
desempenho	mecanica/mecanismo
desenho	foto/mapa/retrato/cópia/reprodução/fotografia/esquema/imagem/figura/ilustração/modelo/documento
desenvolver	amadurecer/evoluir/florir/desabrochar/florescer/progredir/avançar/crescer
desfeita	afronta/desconsideração/insulto/ofensa/injúria
desgosto	amargura/tristeza/dor/pesar
desgrudar	cair/cortar
designar	rotular/classificar
designação	vigia/encargo/missão/guarda
desinformar	mentir
desintegrar	desfazer-se/desmoronar
desistir	parar/abandonar
deslizar	resvalar/derrapar/escorregar/patinar
deslocamento	migração/precipitação/regresso/retorno/caçada/descensão/travessia/ascensão/avanço/locomoção/elevação/perseguição/progressão/aceleração/manobra/viagem
deslocar	arredar/contorcer/enroscar/espernear/torcer-se/alçar/botar/manar/virar-se/dançar/fluir/largar/entornar/pulsar/tornar-se/verter/derramar/elevar/expulsar/puxar/erguer/transportar/empurrar/forçar/girar/pôr/sacudir/soltar/tremer/sair/transmitir/correr/levantar/levar/partir/agitar/colocar/deixar/virar/carregar/tirar/separar/afugentar/arriar/deslocar-se/desvanecer/engatar/vassourar/abalroar/bailar/brandir/expedir/oscilar/propulsar/propulsionar/rechaçar/revolver/dançar/ondular/revirar/transladar/afastar/submergir/engajar/transferir/varrer/deslizar/despachar/encostar/impulsionar/rodar/situar/rebaixar/rolar/afundar/embarcar/baixar/mexer/transportar/empurrar/atravessar/guiar/desaparecer/transmitir/enviar/trazer/partir/agitar/conduzir/lançar/dividir/tocar/separar/bater
desmoronar	estourar/arrebentar/explodir/fragmentar
desolação	ruína
desonestidade	traição
desonra	ignomínia/desgraça/vergonha
desordenar	abagunçar/desorganizar/bagunçar
despachar	aviar/enviar
despachar-se	correr
despender	delapidar/dilapidar/esbanjar/desperdiçar/torrar/gastar/dispor/consumir/investir/poder
desperdiçar	dissipar
destroçar	arruinar/destruir
destruir	arruinar
destruição	desolação/ruína
desventurado	cativo/preso/prisioneiro/refém
deter	amarrar/atar
deterioração	cárie/ferimento/ruína
determinar	enumerar/contar/identificar/reconhecer
deus	santo
deusa	santo
dever	incumbência/serviço/designação/função/tarefa/papel
dia	anoitecer/efeméride/feriado/véspera/data/tarde/noite
dialogar	boquejar/papear/prosear/fofocar/confabular/conversar
diferenciar	caracterizar/caraterizar/discriminar/distinguir
diferença	distinção
dificuldade	problema/obstáculo/fineza/subtileza/sutileza/rigor/problema
dilapidar	dissipar/desperdiçar
dimensão	altitude/altura
diminuir	encurtar/resumir/condensar/abreviar/reduzir/circunscrever/encurtar/encolher/confinar/minimizar/ferver/limitar/restringir/reduzir
diminuição	deterioração/declínio/perda
dinheiro	cache/numerário/divisa/capital/moeda/fundo/cobres/grana/guito/moeda/massa
direcção	curso
direção	curso
dirigir	encabeçar/estacionar/liderar/comandar/dar/fazer
dirigir-se	questionar/perguntar
disciplina	engenharia/tecnologia/ciência
disco	ponto
discordo	querela/controvérsia/discordância/disputa/discussão
discordância	querela/controvérsia/disputa/discussão
discrepância	querela/controvérsia/discordância/disputa/discussão
discurso	preleção/palestra/linguagem/idioma/língua/dispositivo
discussão	tramitação/negociação/debate/conversa
discutir	encetar/abordar/iniciar
discórdia	querela/controvérsia/discordância/disputa/discussão
disfarçar	esconder
dispor	regularizar/arrumar/ordenar
dispositivo	acendedor/encosto/maquinaria/tecla/apoio/encendedor/isqueiro/aparelho/chave/mecanismo/máquina/suporte/instrumento/ferramenta/aquecedores/exaustor/leque/magnete/íman/pente/ímã/aquecedor/ventilador/lâmpada/luz/restrição/limitação/guarda
disposição	ambição/aspiração
disputa	conflito
disputar	aguerrir/combater/guerrear/digladiar/assaltar/batalhar/lutar/atacar
dispõe	possuir/portar/ter/carregar
disseminar	desaguar/derramar
dissolver	derreter/fundir
distinguir	caracterizar/caraterizar/discriminar/diferenciar
distribuir	desaguar/derramar
distribuição	partilha/repartição/partição/divisão
districto	jurisdição/bairro/vizinhança
distrito	jurisdição/bairro/vizinhança
distúrbio	doença
ditado	provérbio
diversão	entretenimento/esporte/hobby/celebração/entreterimento/festividade/passatempo/divertimento/festa/jogo/escapismo/gozação/sacanagem/distracção/exibição/travessura/brincadeira/dança/distração/aposta/baile/divertimento/trote/apresentação
divertimento	distracção/exibição/distração/apresentação
divertir	entreter
dividir	romper/estourar/arrebentar/explodir/quebrar/descolar/desgrudar/fragmentar/cindir/desconectar/rasgar/quebrar/separar
divindade	santo
divinidade	santo
divisa	cache/numerário/capital/moeda/dinheiro/fundo/cobres/grana/guito/dólar/moeda/dinheiro/massa
divisar	ver
divisão	parcela/parte/departamento/broto/ramo/departamento
divisória	muro/parede
dizer	cochichar/balbuciar/retrucar/sussurrar/resmungar/murmurar/replicar/berrar/cantar/responder/gritar/prefaciar/balbuciar/gaguejar/ladrar/bradar/proclamar/vociferar/discutir/murmurar/preceder/tagarelar/conversar/reclamar/introduzir/anunciar/apresentar/enrolar/declarar/falar/representar
doação	galardão/prémio/prêmio/ajuda
dobrar	acovardar/acovardar-se/debruçar/inclinar
doce	bala/caramelo
documentação	reporte/relato/relatório/estudo
documento	missiva/reporte/relato/relatório/carta/registro/estudo
documentos	documentação/documento/inscrição/seção/texto/parte
doença	doenças/tumores/fitopatologia/colapso
doenças	fitopatologia
doer	lesionar/lesar/ferir/machucar/ferroar/excruciar/padecer/torturar/atormentar/picar/furar/machucar/ter
dom	galardão/prémio/prêmio/ajuda
domicílio	vivenda/habitação/casa/lar/casa
domínio	engenharia/tecnologia/ciência/jurisdição/bairro/vizinhança/reino
dor	desgosto/amargura/tristeza/pesar
dormir	capotar/sonecar/dormitar/cochilar
droga	medicamento/remédio/intoxicante/narcótico
duração	trecho/período
dádiva	galardão/prémio/prêmio/ajuda
débito	empréstimo/crédito
dígito	dedo
dívida	empréstimo/crédito
dívidas	empréstimo/crédito
dúvida	descrença
ecoar	recitar
edificação	fabricação/construção
edifício	escolas/estádio/plantel/sacada/torres/varanda/vivenda/alojamento/estufa/hall/hotel/pavimento/piso/ponte/prédio/restaurante/roque/torre/varanda/arena/balcão/cruz/monumento/monumentos/viveiro/abrigo/colégio/departamento/habitação/salão/centro/escola/casa/andar/alpendre/arco/casadeoração/corcova/divisória/clube/paredes/asilo/ministério/obstrução/parede/contrapeso/defesa/estabelecimento/igreja/impedimento/monte/refúgio/templo/equilíbrio/teatro/arco/casa/obstáculo
edição	livro/coletânea/coleção/periódico/revista/compêndio/jornal
educacionista	acadêmico/professor
educador	acadêmico/professor
educação	experiência
efeito	efeitos/influência
efetuar	desempenhar/cumprir/executar/realizar/atingir
efetuação	jeito/modo/maneira/ferramenta/meio/caminho
elegância	fulgor
eleição	cabimento/possibilidade
elevação	montanhas/morro/barranco/colina/montanha/ladeira/monte/escalada
elogiar	adular/louvar/exaltar/glorificar/bajular
embarcar	aviar/despachar/enviar
embarcação	vapor
embelezar	lustrar/polir/cuidar-se
emblema	numeral/símbolo/selo/número/marcadores/estigma/marca/mancha/selo
embonecar	lustrar/polir/cuidar-se
emendar	remendar/consertar
emitir	latir/ladrar/relinchar/ecoar/repetir
emocionar	atemorizar/amedrontar/assustar/aterrorizar/intimidar/inspirar/intoxicar/exaltar/elevar/convidar/tentar/animar/excitar/provocar
emoção	zanga/consternação/espírito/ira/cólera/temor/raiva/terror/humor/medo/alegria/ânsia/ódio/ansiedade/aversão/preocupação/afeição/amor
empenho	batalha/luta
empetecar	lustrar/polir/cuidar-se
empreender	constituir/fundar/estabelecer
empregar	recrutar
emprego	chácara/granja/quinta/rito/oficina/ritual/sítio/costume/fazenda/hábito/central
empresa	agencia/transportação/agência/empresas/indústria/manufatura/transporte/expedição/finança
empresário	homemdenegócios/dono/negociante/comerciante/proprietário/broker/corretor/provedor/fornecedor/intermediário
empurrar	cotovelar/cutucar/propulsionar/acotovelar/bater
enaltecer	adular/louvar/exaltar/glorificar/bajular
encargo	imposto
encerrar	finalizar/acabar/terminar/abortar/cumprir/efetuar/suspender/finalizar/resolver/interromper/decidir/executar/concluir/realizar/acabar/terminar/aceitar/parar/atingir
encetar	endereçar/lidar/tratar/falar/cobrir
encher	carregar
enchimento	almofada
encobrir	disfarçar/mascarar/esconder/sepultar/soterrar/enterrar/esconder
encolerizar	abespinhar/exasperar/irar/enfurecer
encontrar	acessar/celebrar
encontro	sessão
encostar	rodear/contornar/atritar/aderir/arranhar/colar/cobrir
encosto	degrau/pedestal/suporte/pé/base/perna/pé
endereço	domicílio/residência/casa
endosso	auspício/cuidado
energia	electricidade/radiação/radiações/calor/electricidade/eletricidade
enfermidade	doenças/tumores/doença/colapso
enfraquecer	debilitar
engajar	recrutar/ligar
enganar	mentir
engano	mácula/fiasco/bobagem/gafe/descuido/mancha/negligência/erro
engatar	ligar
enlistar	recrutar
enraivecer	abespinhar/encolerizar/exasperar/irar/enfurecer
ensinar	educar/instruir/preparar/treinar/palestrar/falar
entender	enxergar/ouvir/doer/escutar/cheirar/ler/sentir/olhar/realizar/compreender/ver/avistar/divisar/escanear/sonhar/ler/perceber/ver
entidade	abstração/coisa
entorpecente	medicamento/remédio/intoxicante/narcótico
entrada	inscrição/matricula/matrícula/registro
entregar	legar/emprestar/prestar/doar/prover/abastecer/dispensar/fornecer/suprir/pagar/deixar/passar/dar/comissionar/consignar/desobrigar/incumbir/provisionar/confidenciar/lembrar-se/lotear/render-se/submeter-se/confiar/depositar/sucumbir/contribuir/financiar/livrar/alienar/atribuir/ceder/prover/transferir/abastecer/lidar/fornecer/renunciar/outorgar/permitir/conceder/lembrar/desistir/transmitir/liberar/oferecer/servir/abandonar/deixar/dar/manter
entretenimento	distracção/exibição/distração/divertimento/apresentação
entreter	divertir
entreterimento	distracção/exibição/distração/divertimento/apresentação
enunciar	enrolar
enviar	aviar/despachar
envólucro	camuflagem
enxugar	estorricar/ressecar/rolar
equino	égua/cavalo
equinodermo	ouriço-do-mar
equinodermos	ouriço-do-mar
equipamento	acendedor/encosto/aparato/maquinaria/tecla/apoio/encendedor/isqueiro/aparelho/chave/mecanismo/máquina/suporte/instrumento/ferramenta/aquecedores/conector/contentor/contêiner/exaustor/leque/magnete/mídia/parafernália/íman/aparato/dispositivo/implemento/mobília/pente/ímã/aquecedor/material/mobiliário/ventilador/aparelho/armamento/munição/recipiente/lâmpada/móvel/veículo/arma/luz/mecanismo/restrição/instrumento/sistema/limitação/ferramenta/guarda/ligação
equivaler	corresponder/combinar/concordar
equídeo	égua/cavalo
equívoco	mácula/fiasco/bobagem/gafe/descuido/mancha/negligência/erro
era	dia/período
erro	mácula/fiasco/bobagem/derrota/gafe/descuido/mancha/perda/negligência
erva	grama/relva/ervas/gramínea/gramíneas
ervas	grama/relva
esbanjar	dissipar/desperdiçar
escaler	balsa/barca/barcaça/bateira/barco
escapar	foragir/escapulir/fugir/evadir-se/fugir
escapatória	escapada/escape/fuga
escape	escapada/fuga
escapulir	evadir-se/fugir/escapar
escolha	cabimento/votação/eleição/possibilidade/voto/decisão/eleição/resolução
escolher	eleger/votar/decidir/esposar/adoptar/adotar
esconder	disfarçar/mascarar/encobrir/sepultar/soterrar/enterrar
escorregar	resvalar/derrapar/deslizar/patinar
escrever	transcrever/registar/registrar
escrita	caligrafia
escritor	periodista/poetas/poeta/poetisa/jornalista
escritório	secretaria/órgão
esforço	batalha/luta/chute/tacada/tentativa/batalha/luta/teste
esfregar	roçar/enxugar/limpar
esmagamento	pulverização/trituração
espalhar	desaguar/borrifar/derramar
espanto	estupefação
espaçamento	distância/composição
especialista	experiente/perito/autoridade
especular	ponderar/questionar/perguntar
esperar	adiar
espirito	deidade/deidades/divinidade/deus/deusa/divindade/anjo/espírito/deus/alma/fantasma
esporte	remo
esposa	dona-de-casa/mulher
esposo	esposa/mulher
espécie	variante/versão
espécies	espécie/variedade/género/estilo/tipo/classe
espírito	felicidade/alegria
esquentar	tostar
estabelecimento	instituição/universidade
estabilizar-se	enraizar/acomodar
estado	recontro/inimizade/relacionamento/confronto/conflito/hostilidade/liberdade/situação/condição/conexão/relação/ligação/actividade/desordem/existência/imaturidade/imperfeição/coalizão/coligação/ápice/acção/destruição/existência/perfeição/iluminação/nível/delegação/fase/atividade/bagunça/fusão/defeito/união/grau/ação/movimento/morte/ser/habilidade/relação/ligação
estado-maior	mediação
estar	estender-se/importar/necessitar/agradar/precisar/caber/depender/encostar/requerer/alcançar/contar/parecer/pesar/ficar/servir/abrilhantar/considerar-se/espreguiçar-se/esticar-se/fulgir/fulgurar/meandrar/quedar/inter-relacionar/refulgir/subjazer/aparentar/comparar/custar/defrontar/repousar/totalizar/morar/povoar/prometer/relacionar/sentar-se/valer/descansar/doer/encarar/habitar/jazer/medir/resultar/zumbir/comprar/dever/viver/vender/pertencer/permanecer/adicionar/provar/sofrer/brilhar/ser/parecer/estender/chegar/continuar/aceitar/levar/ficar/ir/manter
estação	estio/inverno/outono/primavera/verão
estender	esparramar/espalhar
esterilizar	capar/emascular/castrar
estilo	caimento/feitio/dispositivo/corte
estimar	enaltecer/elogiar/louvar
estimular	atemorizar/amedrontar/assustar/aterrorizar/intimidar/inspirar/intoxicar/exaltar/elevar/convidar/tentar/animar/excitar/provocar
estoque	infraestructura/infraestrutura/infra-estrutura
estrada	alameda/via/rodovia/entrada/caminho/abordagens/caminhos/rumo/senda/trilhos/direcção/trilho/avenida/direção/trilha/acesso/passagem/curso/caminho
estrato	burguesia/mulherio/irmandade/fraternidade/superfície/mercado/mulher/ordem
estraçalhar	arruinar/destruir
estreitar	comprimir/contrair
estrela	planeta
estremecer	tremelicar/tiritar/tremer
estressar	alongar/esticar/estender
estrutura	estádio/sacada/torres/varanda/alojamento/pavimento/piso/ponte/prédio/roque/torre/varanda/arena/balcão/cruz/monumento/monumentos/calendário/edifício/abrigo/casa/andar/alpendre/arco/corcova/divisória/fenestra/paredes/asilo/obstrução/parede/contrapeso/defesa/estabelecimento/arquitectura/impedimento/janela/monte/refúgio/equilíbrio/arco/obstáculo
estudante	pupilo/aluno
estupefação	estupor/choque
esvaziar	drenar/escoar
etapa	centúria/decênio/década/sazão/século/séculos/manhã/mês/noitada/século/estágio/semana/continuidade/trimestre/fase/tarde/duração/era/estação/idade/época/ano/noite/tempo/período/pré-história/jornada/noitada/temporada/semana/sono/prazo/sesta/era/estação/idade/juventude/época/licença/ano/hora/passado/momento/noite/dia/vida/tempo/período
evadir-se	foragir/escapulir/fugir/escapar
evaziar	drenar
evento	acção/feito/ato/ação/ocorrente/ocorrência/acontecimento
evidência	identificação/registro
evitar	entravar/estorvar/tolher/impedir/atrapalhar/defender/reter
exacerbar	irritar
exaltar	alentar/encorajar
examinar	comparar/escrutinar/inspeccionar/analizar/revistar/vistoriar/busca/comparação/vistoria/checar/pesquisar/revisão/acompanhamento/conferir/inspecionar/inspeção/buscar/procurar
excitar	atemorizar/amedrontar/assustar/aterrorizar/intimidar/inspirar/intoxicar/exaltar/elevar/convidar/tentar/animar/provocar
executar	enforcar/ensaiar/improvisar/desempenhar/exercitar/cumprir/praticar/realizar
executivo	ministro/diretor/presidente
execução	jeito/modo/maneira/ferramenta/meio/caminho/mecanica/mecanismo
exemplo	mostra/excepção/exceção/amostra/vez
exercer	oficiar/funcionar
exercício	revisão
exibir	mostrar
exibição	exposição
exigir	requerer
existir	imperilar/perigar/ameaçar/arriscar/habitar
existência	presença/vida/possibilidade/animação/realidade/chance/vida
expandir	entumescer/inflar/inchar
expectativa	esperança
expedir	aviar/despachar/enviar
experimentar	arrepender/arrepender-se/lamentar/regozijar/regozijar-se/alegrar-se/enraivecer/entreter/alegrar/arder/sustentar/sofrer/guardar/considerar/manter
experiência	realidade/mundo/vida
expirar	afogar-se/afogar/tombar/cair
explorar	minerar/minar/escavar
exploração	colonialismo
expor	mostrar
expressar	acentuar/pontuar/enfatizar/contar/falar/dizer/soltar/desejar/falar/dizer/representar
expressão	provérbio/ditado
exprimir	acentuar/mensurar/pontuar/quantificar/enfatizar/contar/falar/dizer/soltar/desejar/falar/dizer/representar
expulsar	ejetar/excluir/dividir/separar
extensão	altitude/altura/limitação/fronteira/limite
extremidade	fronteiras/fim/final/fronteira/limite
exército	corpo
fabricar	cozinhar/moldar/forjar/modelar/formar/preparar
face	fundo/dianteira/frente
facto	detalhe
faculdade	vontade/sentido/memória/entendimento/linguagem/discurso/razão/idioma/inteligência/língua
faixa	arco/gola/colarinho
falar	cochichar/balbuciar/retrucar/sussurrar/resmungar/discutir/murmurar/replicar/berrar/cantar/responder/gritar/prefaciar/balbuciar/dialogar/gaguejar/ladrar/bradar/proclamar/vociferar/discutir/murmurar/preceder/tagarelar/conversar/reclamar/introduzir/anunciar/apresentar/enrolar/declarar/representar
falecer	afogar-se/afogar/tombar/cair
falha	equívoco/engano/erro/mácula/fiasco/fracasso/bobagem/derrota/gafe/descuido/mancha/perda/negligência/erro
falsificação	dissimulação/enganação
falta	ausência/escassez
familia	genealogia/família
família	casal/casamento/genealogia/categoria/espécies/raça/género/povo/tipo/classe
fase	alcance/auge/ápice
fatia	seção/parte
fato	acção/feito/ato/ação/ocorrente/ocorrência/acontecimento
fator	ponto
fazedor	fabricante/produtor
fazenda	importação/seda/algodão/mercadoria/produto/artigo/crepe/mohair/plantação/plantio/viveirodeplantas/exportação/pano/trama/malha/rede
fazer	atrever/atrever-se/ousar/participar/pincelar/virar-se/voluntariar/compartilhar/pintar/recriar/aguentar/copiar/lidar/sobreviver/tentar/soar/procurar/oferecer/tocar/batucar/borburar/desovar/efectivar/interagir/ocasionar/perpetrar/pioneirar/proceder/tique-taque/atrever/atrever-se/buzinar/chocalhar/cometer/edificar/efectuar/efetivar/empreender/ensaiar/ousar/ratear/reiterar/ronronar/sussurrar/apitar/assobiar/borbulhar/comportar-se/concretizar/confeccionar/disturbar/ecoar/imaginar/improvisar/performar/retratar/exercitar/fabricar/procriar/reagir/recriar/reproduzir/substanciar/aguardar/efetuar/personificar/praticar/ressoar/reverberar/verbalizar/acelerar/gerar/lidar/apressar/prosseguir/surpreender/causar/produzir/repetir/permanecer/preparar/interromper/perturbar/reter/soar/construir/realizar/criar/esperar/iniciar/resistir/continuar/correr/seguir/provocar/representar/conduzir/começar/dar/bater
façanha	rebatida/jogada/proeza/feito/obtenção/andada/batida/realização
fechar	bater/tirar
fecundar	emprenhar/engravidar
feder	tresandar
feito	critica/juízo/rejeição/recuperação/julgamento/partida/comunicado/descobrimento/efetuação/insucesso/paralização/rebatida/causalidade/descoberta/distribuição/escapatória/escape/implementação/interferência/jogada/ociosidade/paralisação/proeza/propulsão/uso/acção/atrapalhação/obtenção/permanência/andada/comunicação/eliminação/façanha/fuga/impulsão/contato/disposição/habitação/impedimento/atividade/ocupação/toque/ato/batida/falha/causa/execução/aquisição/ação/parada/realização
feição	disposição/atividade/egocentrismo/índole/bobeira/caráter/sagacidade/sapiência/conduta/egoísmo/firmeza/modalidade/natureza/disciplina/sabedoria/sensatez/comportamento/procedimento/personalidade/maneira
fenda	greta/racha/ranhura/fresta/fissura/rasgão/rasgo/boca/buraco
fenómeno	ensejo/consequência/fortuna/conseqüência/azar/efeito/sorte/resultado/fim
fenômeno	ensejo/consequência/fortuna/conseqüência/azar/efeito/sorte/resultado/fim
ferir	lesionar/lesar/machucar/atropelar/estirar/tirotear/arranhar/raspar/puxar/atirar
ferramenta	acendedor/brocha/chibata/encosto/escova/aparato/açoite/chicote/implemento/maquinaria/pincel/tecla/apoio/encendedor/isqueiro/aparelho/armamento/bastão/pau/equipamento/vara/arma/chave/mecanismo/máquina/suporte/agulha/instrumento/aquecedores/exaustor/leque/magnete/parafernália/utensílio/íman/arpão/pente/ímã/aquecedor/material/ventilador/lança/lâmpada/metro/luz/restrição/barra/limitação/guarda
fertilizar	emprenhar/engravidar
festa	boda/cerimónia/funeral/boda/enterro/festival/funeral/cerimônia/casamento/rotulagem/celebração/balada
festividade	festival
fibra	bisso
fibras	bisso
ficar	caber/ajustar
figura	foto/mapa/retrato/cópia/reprodução/fotografia/esquema/imagem/ilustração/modelo/desenho/sub-figura/documento
filho	bebé/criancinha/nenê/recém-nascido/criança/bebê/menino/filha/rapaz/menino
fim	efeitos/influência/pico/ponta/efeito
final	pico/ponta
finalizar	encerrar/acabar/terminar/abortar/cumprir/efetuar/suspender/resolver/interromper/decidir/executar/concluir/desistir/realizar/acabar/terminar/aceitar/parar/abandonar/atingir
finança	investimento
fio	corda
fixar	trancar/pendurar/implantar/conectar/pendurar/amarrar/atar/forçar/ligar/colocar
flanco	base
flora	chaparral/epifitismo/epífito/traqueófitos/bosque/mata/floresta
fluido	líquido/gás
fluir	correr
flutuação	diferença
fluído	líqüido
folha	lauda/escudeiro/página/folhas
folhas	lauda/escudeiro/página/folha
forjar	plasmar/amoldar/martelar/moldar/fundir/modelar/transformar
forma	sólida/sólido/figura/linha/plano/ligação
formar	plasmar/achatar/amoldar/retorcer/aplainar/moldar/enxugar/forjar/fundir/modelar/torcer/transformar
formato	sólida/sólido/figura/linha/plano/ligação
formação	alcantilado/penhasco/cordilheira/falésia/fila/declive/declives/serra/subida/encosta/costa/ladeira/nascente/bicha/linha/desembocadura/foz/orla/elevação/costa/litoral/bicha
fornada	bolo/pão/pastel
fornecedor	conexão
fornecer	apetrechar/aparelhar/equipar/suprir/servir/dar/abrigar/amparar/mobiliar/armar/despejar/prover/derramar/suprir/ajudar/satisfazer/alimentar/servir/dar
força	efeitos/potência/vigor
forçar	coagir/compelir/obrigar/propulsionar/empurrar
fracasso	derrota/perda
fragmentar	triturar/moer/ranger
fragmento	porção/chapéu/gota/órgão
fraqueza	lassidão/letargia
fresta	ranhura
fronteira	delimitação/itinerário/itinerários/percurso/rota/superfície/linha/curso/borda/estrada/caminho/limite/aba/margem/borda/limite
fronteiras	delimitação/superfície/borda/fronteira/limite/margem/borda/fronteira/limite
fruta	tâmara/maçã/espiga
fruto	espiga/fruta
fuga	escapada/escape
fugir	foragir/escapulir/escapar/evadir-se/escapar
funcionar	desdobrar/servir
funcionário	magistrado/jurista/juiz/servidor
fundo	pé
fungo	micetes/bolor/mofo/líquen/líquenes
fungos	micetes/bolor/mofo/líquen/líquenes
função	lugar/posição
furar	perfurar/atravessar
furo	buraco
fusão	confederação/aliança
fábrica	casademoinho/manufatura/usina
fé	doutrina/convicção/religião/filosofia/certeza/espirito/perspicácia/confiança/pensamento/opinião
fêmea	garotinha/guria/menininha/meninota/mocinha/menina/garota/moça/rapariga/mulher/filha
galera	ralé
gameta	óvulo
gastar	delapidar/dilapidar/esbanjar/desperdiçar/torrar/dispor/consumir/investir/poder
gastos	pagamento/taxa/recompensa/preço/custo
genealogia	sangue/descendência/linhagem/família
genitor	progenitora/papai/papá/painho/progenitor/pai/mãe
gente	galera/vulgo/nação/estrato/geração/inimigo/mundo/população/pessoal/povo/classe/freguesia/ralé/clientela/audiência/coorte/espectador/nação/povo
gerente	gestor/director/dirigente/administrador/diretor/executivo
gesticular	anuir/curvar-se/inclinar-se/acenar
gestos	gesto
gestão	tratamento/gerenciamento/autorização/administração
girar	rodar/enrolar
gleba	campos/parque/praça/gramado/locação/sítio/terreno/campo/lugar
golpe	porrada/pontapé/chute
golpear	chutar/bater
gordura	lípidos/óleo
gosto	cordialidade
governador	castelão/senhor
governante	castelão/senhor
governar	gerir/reinar/reger/manobrar/canalizar/lidar/cuidar/guiar/dirigir
grafema	caracter/caractér/carácter/letra
gramínea	grama/relva
gramíneas	grama/relva
grandeza	amplidão/tamanho/dimensão/medida/proporção/magnitude/extensão/alcance/quantidade/extensão/número
grau	alcance/auge/intensidade/ápice
grudar	aderir/colar
grupo	assentamento/colecção/júri/camarilha/colônia/coleção/linhagem/aglomeração/júri/raça/acúmulo/população/gente/pessoal/sistema/organização/povo/classe/parelha/arranjo/humanidade/vocação/associação/voto/administração/mundo/par/população/gente/reino/união/organização/homem/povo/massa
guarda	sentinela/vigília
guardar	negar/deter/deduzir/poupar/preservar/conservar/registar/reter/registrar/segurar/manter
guardião	guarda
guiar	estacionar/administrar/gerenciar/gerir/lidar/cuidar/tratar/organizar/dirigir/conduzir
guloseima	bala/doce
gâmeta	óvulo
género	variante/versão/espécie/variedade/estilo/tipo/classe
gênese	causa
habilidade	metodo/método/métodos/aptidão/meta/técnica/arte/inteligência/controle/talento/criatividade/aptidão/faculdade/liderança/talento
habitante	europeu
habitar	alojar/morar
habitação	vivenda/casa
harmonia	consenso/acordo
hemípteros	himenópteros/sota/rainha/operário
hidrocarboneto	benzina/gasolina/querosene/fuelóleo/petróleo
hierarquia	gradação/grau/primeiro
himenópteros	abelha/vespa
hipótese	fundação/base/pressuposição/suposição
homem	cavalheiro/garoto/moço/rapaz/senhor/menino/garoto/moço/rapaz/sujeito/menino/cara
homemdenegócios	dono/proprietário
hominídeo	humano
honestidade	justeza/justiça
honra	celebridade/fama/glória/renome
hora	meio-dia
hortaliça	folhas/vegetal
horticultura	floricultura
hortifruti	verdura/hortaliça/legume/vegetal/fruta
hortifruto	verdura/hortaliça/legume/vegetal/fruta
hostilidade	violência/força
hotel	albergaria/albergue/hospedaria/pousada
humano	humanidade/mundo/homem/povo
humilhar	degradar/aviltar/desvalorizar/rebaixar
humor	felicidade/alegria
hábito	rito/ritual/costume/maltrato/escravidão/ritual/costume/emprego
idade	era/período
ideia	atributo/categoria/possibilidade/soma/característica/suposição/teoria/quantidade/hipótese/propriedade/qualidade/família/número/classe/abstracção/raciocinio/razoamento/abstracto/argumentação/planejamento/abstrato/raciocínio/totalidade/lei/preparação/componente
identificar	distinguir/diferenciar/separar
idioma	locução/conversação/linguagem/provérbio/ditado/expressão/conversa/língua/provérbio/debate/ditado/discussão
idéia	projecto/conceito/atributo/categoria/concepção/possibilidade/programação/soma/característica/suposição/tema/teoria/motivo/projeto/quantidade/hipótese/propriedade/qualidade/família/ideia/intenção/programa/plano/número/classe/abstracção/abstracto/abstrato/totalidade/sentido/lei/componente/significado/intenção
igreja	igrejas/templo
igualar	corresponder/combinar/concordar
iluminar	brilhar
iluminar-se	iluminar/brilhar
iluminação	trevas/escuridão
ilustração	foto/mapa/retrato/cópia/reprodução/fotografia/esquema/imagem/figura/modelo/desenho/documento
imagem	foto/mapa/retrato/cópia/reprodução/fotografia/esquema/figura/ilustração/modelo/desenho/documento
imaginar	conjeturar/conjecturar/pensar/afigurar/conceitualizar/envisionar/figurar/conceber/visualizar/inventar/pensar/ver
imaturidade	infância
imitação	paródia/mímica
imobiliária	terras/fazenda
imoralidade	aposta
impactar	influir/influenciar/afetar/atacar/atingir
impedimento	interferencia/atrapalhação/obstáculo/trava/obstrução/barreira/barra/obstáculo
impedir	entravar/estorvar/tolher/atrapalhar/defender/reter/evitar
impetrar	convocar/chamar/instruir
implementação	jeito/modo/maneira/ferramenta/meio/caminho
implemento	brocha/escova/pincel/bastão/pau/vara/agulha/instrumento/ferramenta/utensílio/arpão/lança/barra/ferramenta
importância	merecimento/mérito/preços/significação/virtude/preço/significado/qualidade
imposto	colectas/impostos/taxação/taxa/tributo
impotência	fraqueza
imprensa	periódico/jornal/folha
impressionar	disturbar/emocionar/perturbar
impulsionar	atirar/jogar/lançar/chutar/bater
impulsão	pontaria/tiro/alcar/puxão/levantamento/rolamento/elevação/empurrão/tração/forca/pulo/impulso/salto
imóvel	terras/fazenda
incapacidade	bloqueio
incapacitar	deter/confinar/reter/prender/manter
incerteza	descrença/dúvida
inclinar	declivar
inclinação	aceno
incluir	abranger/compreender/conter/ter
incumbir	consignar
indagar	consultar
independência	autonomia/liberalismo
indicar	cadastrar/ler/significar/apontar/mostrar/registrar/dizer
indicação	identificação/evidência/registro
indiferença	afastamento/apatia
indispor	cansar-se/constipar/exaurir-se/aleijar/ferir/doer/exaurir/machucar
indivíduo	conhecida/engenheiro/habitante/proponente/líder/morador/cientista/especialista/parente/conhecido/defensor/advogado/amizade/autoridade/vizinho/aluno/chefe/trabalhador/amigo/estudante/representante/adjudicator/amado/amo/comunicador/creador/desafortunado/desventurado/governante/hebraica/hebreia/infortunado/intelecto/possuidor/amiga/anomalia/autóctone/competidor/contendor/criatura/fêmea/governador/súdito/turista/capitalista/cidadão/criador/dono/hebreu/judia/artista/camarada/conhecido/criativo/hebraico/judeu/juvenil/menor/viajante/amizade/criança/juiz/proprietário/seguidor/amante/esperança/face/jovem/árbitro/amigo/intelectual/pessoa/varão/estudante/macho/rosto/cara/homem/ser/parte/vida
industria	transportação/indústria/manufatura/transporte/expedição/finança
induzir	persuadir/encorajar/compelir/obrigar/forçar/deixar
indício	evidência/indicação
indústria	produção
inexistência	impossibilidade
influenciar	convencer/persuadir
influir	convencer/persuadir
informar	desinformar/leccionar/lecionar/testificar/alertar/descerrar/ensinar/atestar/divulgar/evidenciar/narrar/recontar/esclarecer/testemunhar/avisar/enganar/advertir/instruir/apontar/introduzir/explicar/provar/revelar/apresentar/contar/indicar/mostrar/redizer/denotar/descrever/pressagiar/reapresentar/reiterar/evidenciar/assinalar/relatar/sugerir/sinalizar/prever/repetir/anunciar/contar/indicar/mostrar/transmitir/dar
informação	notícia/circunstância/instância/notícias/consideração/fato/exemplo/representante/artigo/datum/facto/arcano/estimulante/estímulo/materiais/material/dado/segredo/leitura/verdade/base
infortunado	cativo/preso/prisioneiro/refém
infra	fenestra/janela
infra-estrutura	aeroporto/aeródromo/instalação/água/estação/origem/pista/posto/fonte/campo
ingerir	deglutir/ingurgitar/papar/fumar/beber/engolir/comer/experimentar/provar/tomar/beber/consumir/comer/tomar/usar
ingrediente	aromatizante/condimento/tempero
ingressar	unificar/reunir
ingresso	inscrição/matricula/matrícula/registro
iniciar	endereçar/lidar/tratar/falar/cobrir/constituir/fundar/estabelecer
iniciação	causa
injustiçar	victimizar/vitimar
injúria	afronta/desconsideração/insulto/ofensa/perseguição
inquérito	indagação/quesito/interrogação/pergunta/questão/interrogatório
insecto	himenópteros/sota/rainha/operário
insectos	himenópteros/sota/rainha/operário
inseminar	emprenhar/engravidar
inseto	himenópteros/sota/rainha/operário
insetos	himenópteros/sota/rainha/operário
insistir	reinvindicar/asseverar/sustentar/manter
insolvência	bancarrota/falência
inspecionar	escrutinar/inspeccionar/revistar/vistoriar/busca/comparação/vistoria/revisão/acompanhamento/inspeção/buscar/procurar
inspirar	alentar/encorajar
instalação	calefacção/aquecimento/calefação/aeroporto/aeródromo/água/estação/origem/pista/posto/fonte/campo
instante	saída/prazo/início/começo/princípio/hora/momento/segundo
instruir	educar/preparar/treinar/palestrar/falar
instrumento	acendedor/brocha/chibata/encosto/escova/açoite/chicote/implemento/maquinaria/pincel/tecla/apoio/encendedor/isqueiro/aparelho/armamento/bastão/pau/equipamento/vara/arma/chave/mecanismo/máquina/suporte/agulha/ferramenta/aquecedores/conector/contentor/contêiner/exaustor/leque/magnete/mídia/utensílio/íman/aparato/arpão/dispositivo/implemento/mobília/pente/ímã/aquecedor/mobiliário/ventilador/aparelho/armamento/munição/recipiente/equipamento/lança/lâmpada/metro/móvel/veículo/arma/luz/mecanismo/restrição/sistema/barra/limitação/ferramenta/guarda/ligação
instrução	experiência
instância	mostra/excepção/exceção/amostra/vez
insucesso	equívoco/engano/falha/erro/fracasso/falha/negligência/erro
inteligência	agudez/astucidade/agudeza/sagacidade/astúcia/cérebro
intensidade	violência/força
intensificar	agilizar/acelerar/apressar
intenção	objetivo/fim/morais/moralidade/ética/moral/programa/vida
interagir	tratar/tramitar/transaccionar/transacionar/relacionar-se/comunicar/relacionar/convidar/combinar/transmitir
interação	contato/ligação
intercorrência	cabimento/possibilidade
interessar	absorver/engajar/ocupar
interesse	preocupação/caso
interferência	obstrução
interpretação	caracterização/imitação/personificação/ato
interromper	parar
interseção	origem
intervalo	interrupção/horário/suspensão/pausa
intimar	convocar/chamar/instruir
intolerância	fanatismo
intérprete	actor/ator/artista/instrumentalista/instrumentista/tocador/músico
inventar	manufaturar/fabricar
invertebrado	verme/artropode/artrópode/artrópodes/celenterados/equinodermo/equinodermos/molusco/moluscos
invertebrados	verme/artropode/artrópode/artrópodes/celenterados/equinodermo/equinodermos/molusco/moluscos
inverter	retificar/corrigir
investigação	inquérito/pesquisa/inspecionar/examinar
início	gênese/alvorecer/iniciação/manhã/constituição/madrugada/amanhecer/concepção/estabelecimento/origem/começo/criação/princípio/organização
ir	engatinhar/gatinhar/rastejar/rastejar-se/serpear/vadiar/vagabundear/vaguear/boiar/pisar/ascender/escorregar/nadar/errar/passear/perambular/vagar/deslizar/voar/apressar/acompanhar/atravessar/caminhar/dirigir/correr/seguir/andar/subir/passar/apressar-se/bicicletar/coxear/despachar-se/esgueirar/esquiar/mancar/vadear/cavalgar/desfilar/pedalar/progredir/avançar/marchar/perambular/perseguir/tropeçar/vagar/acelerar/rodar/voar/apressar/descer/montar/prosseguir/baixar/circular/viajar/atravessar/espalhar/vir/caminhar/continuar/seguir/andar/passar/cair
ira	fúria/cólera/raiva
irar	abespinhar/encolerizar/exasperar/enfurecer
ironizar	mangar/pagodear/zoar/rir/ridicularizar/sacanear/zombar
irritar	coçar/esfregar
itinerário	rumo/direcção/direção/curso
itinerários	rumo/direcção/direção/curso
jogar	apostar/apanhar/apostar/capturar/anunciar
jogo	competição/torneio/corrida/combate/partida/luta/classe/parelha/esporte/corrida/par/união/partida
jornada	anoitecer/véspera/tarde/passeio/noite/excursão
jornal	periódico/folha/número
jornalismo	periódico/jornal/folha
jovem	criança/menino
juiz	magistrado/jurista
julgamento	revogação/avaliação/estimativa/cálculo
julgar	hierarquizar/inocentar/ranquiar/antecipar/absolver/medir/classificar/estimar/avaliar/pensar/achar/imputar/ensaiar/pronunciar/rotular/atribuir/testar/tentar/estimar/aprovar/rejeitar/declarar/aceitar
juntar	catar/aderir/fixar/colher/apanhar/grudar/amarrar/atar/colar/prender/acasalar/anilhar/respigar/copular/etiquetar/inserir/rotular/anexar/colher/suplementar/grudar/colar/pregar/introduzir/prender/pegar
juntar-se	unificar/reunir
jurisdição	diocese
justiça	justeza
juvenil	criança/jovem/menino
juízo	avaliação/estimativa/cálculo
laboratório	chácara/granja/quinta/oficina/sítio/fazenda/central
lacticínio	manteiga/queijo/creme/nata/leite
lado	fundo/dianteira/frente
lançar	difundir/esparramar/espalhar
lar	vivenda/habitação/casa
larva	lagarta/verme
laticínio	manteiga/queijo/creme/nata/leite
lavar	lavar-se/limpar/enxaguar
leccionar	educar/instruir/preparar/treinar/palestrar/falar
lecionar	educar/instruir/preparar/treinar/palestrar/falar
legalidade	validade
legar	lembrar-se/lembrar
legislatura	parlamento/assembléia
legume	folhas/vegetal
lei	constituição
leis	constituição
leitura	hora
lembrar	reconhecer/caracterizar/caraterizar/qualificar
lembrar-se	reconhecer
lesar	atropelar/estirar/tirotear/arranhar/raspar/puxar/atirar
lesionar	atropelar/estirar/tirotear/arranhar/raspar/puxar/atirar
lesão	fractura/fratura
letra	caracter/caractér/carácter
levar	carregar/aerotransportar
liberdade	autonomia/independência/liberalismo
lidar	administrar/lotear/gerenciar/gerir/atribuir/cuidar/tratar/organizar/dirigir/conduzir
liderança	administrador/gerente
liga	aço
ligar	desligar/amarrar/atar/apagar
ligação	pertinência/relevância/amizade/conexão/relação/coalizão/coerência/coesão/coligação/continuidade/articulação/junção/fusão/união/relação
limitar	restringir/conter/delimitar/marcar/restringir/treinar
limite	delimitação/superfície/borda/fronteira/aba/margem/borda/fronteira
limpar	lavar-se/lavar/desinfectar/desinfetar/escovar/varrer
linguagem	idioma/língua/dispositivo
linha	curvas/curva/arco/encabeçamento/recta/rumo/direcção/reta/direção/corda/curso/borda/fronteira/limite
linhagem	família
lipido	lípidos/gordura/óleo
lipídio	lípidos/gordura/óleo
liquidar	amortizar
listagem	lista
litoral	beira-mar/costa
livrar	descartar
livro	diário/autoridade
livros	diário
local	direita/lugar/marina/fronte/frente/posição
localização	regiões/selva/floresta/região/lar/região/fronteira/lugar/casa
locação	regiões/selva/floresta/região/lar/região/fronteira/lugar/casa
locomoção	caminhada/corrida/passo
locução	provérbio/ditado
loja	botica/drogaria/drograria/farmacia/farmácia
lotear	alocar
lousa	tábua/quadro/placa
louvar	adular/exaltar/glorificar/bajular
louça	vidro
lugar	regiões/procedência/selva/vértice/direita/floresta/raiz/centro/área/canto/nascente/região/fonte/foco/marina/umbigo/foco/fronte/local/frente/lar/região/fronteira/casa/posição
luminaria	candeeiro/lustre/candelabro
luminária	candeeiro/lustre/candelabro
lustrar	aculturar/civilizar/escolar/educar/cultivar/treinar
luta	peleja/pugna/insurreição/revolta/rebelião/disputa/combate/batalha/conflito/disputa
lutar	aguerrir/combater/guerrear/digladiar/assaltar/batalhar/atacar
luz	sol/luar
líder	empregador/administrador/gerente/cabeça/chefe/liderança/exemplo/responsável/modelo/político/presidente/superior
língua	linguagem/idioma/dispositivo
lípido	lípidos/gordura/óleo
lípidos	gordura/óleo
líquido	água
líqüido	bebida/líquido/gás
macho	garoto/moço/rapaz/menino/homem/garoto/moço/cavalo/rapaz/sujeito/menino/cara/homem
machucado	fractura/fratura
machucar	lesionar/lesar/ferir/atropelar/estirar/tirotear/excruciar/torturar/arranhar/atormentar/raspar/puxar/atirar
magnitude	amplidão/tamanho/dimensão/medida/proporção/extensão/significação/alcance/altitude/altura/quantidade/significado/extensão/número
magoar	humilhar/prantear/descompor/mortificar/aviltar/ofender/insultar/rebaixar/lamentar
mal	fractura/fratura
maltratar	victimizar/vitimar
maltrato	abuso/injúria/victimização/exploração
mamífero	primata/roedor/primatas/carnívoro/ungulados
manar	fluir/correr
mandar	convocar/chamar/instruir
maneira	caimento/feitio/modo/corte
manejar	operar/amassar/trabalhar/controlar/empunhar/manusear
manipular	operar/amassar/trabalhar/controlar/empunhar/manejar/manusear
manobra	ofensiva/campanha/ataque/obstrução
manobrar	estacionar
manter	negar/distanciar-se/distanciar/afastar/deter/deduzir/poupar/preservar/conservar/amarrar/atar/registar/reter/guardar/registrar/segurar
manufatura	produção
manusear	operar/amassar/trabalhar/controlar/empunhar/manejar/manipular
maquinaria	moinhos/calculadora/maquinário/moinho/computador/máquina/motores/motor
maquinário	moinhos/moinho
marcar	traçar/delinear
marido	esposa/mulher
mascarar	esconder
massa	audiência/espectador
matar	decapitar/degolar/executar/chacinar/trucidar/aniquilar/balear/devastar/dizimar/massacrar/assassinar/erradicar/afogar/asfixiar/liquidar/despachar/estrangular/neutralizar/sufocar/executar
materiais	minérios/química/thread/mineral/fibras/lixo/resíduo/condutor/fibra/substância/papel/colorante/matéria-prima/corante/átomo/rocha/cimento/partícula/tinta/pedra/solo/cor
mato	rosa/rosas/rosa/pimentão/pimenta/algodão
matéria	líqüido/sedimento/fluido/substância/depósito/residuo/sólida/área/sólido
mecanismo	acendedor/encosto/maquinaria/tecla/apoio/encendedor/isqueiro/aparelho/chave/máquina/suporte/instrumento/ferramenta/aquecedores/exaustor/leque/magnete/íman/pente/ímã/aquecedor/ventilador/lâmpada/luz/restrição/limitação/guarda
medicamento	terapia/remédio/analgésicos/intoxicante/analgésico/narcótico/sedativo/calmante
medida	peso
medir	durar/enaltecer/elogiar/louvar
medição	peso
medo	pânico/terror/calafrio/tremedeira/tremura/arrepio/tremor
melhoramento	retificação/reforma/correção/conserto/limpada/reparo/desenvolvimento/reparação/limpeza
melhorar	convalescer/reparar/emendar/lustrar/consertar/polir/recuperar/refinar/embonecar/perfazer/atenuar/cicatrizar/empetecar/sarar/amenizar/aperfeiçoar/embelezar/curar/acordar/resolver/aliviar
melhoria	retificação/reforma/anexo/correção/asa/conserto/limpada/reparo/desenvolvimento/reparação/limpeza
melodia	encabeçamento
membro	perna/aleta/dígito/soror/barbatana/irmã/dedo/perna
memória	associação/conexão
menino	bebé/criancinha/nenê/recém-nascido/bebê/filha/garoto/filho/rapaz
menor	criança/jovem/menino
menosprezar	mangar/pagodear/zoar/rir/ridicularizar/sacanear/zombar
mensagem	narrativa/narração/significância/agouro/indício/presságio/significação/correio/indicação/linguagem/matéria/tópico/assunto/discurso/tema/idioma/informação/significado/língua/história/sinal/intenção/telegrama/documento/proposta/afirmação/aplauso/linguagem/tópico/assunto/conteúdo/discurso/reconhecimento/voz/declaração/anúncio/língua/estilo/aprovação
mensurar	cronometrar
mercadoria	importação/produto/artigo/carregamento/exportação/frete/carga
mercantilismo	industria/pagamento/empresa/negócio/comércio/venda
mesa	escrivaninha/secretária
meta	arte/objetivo/fim/habilidade/intenção
metais	cobre/estanho/chumbo/cobre/ferro
metal	cobre/estanho/chumbo/cobre/ferro
metodo	sistema
metro	relógio
mexer	contorcer/enroscar/espernear/torcer-se/manar/virar-se/dançar/fluir/pulsar/tornar-se/girar/sacudir/tremer/sair/correr/partir/agitar/deixar/virar/separar/vassourar/bailar/oscilar/dançar/ondular/varrer/encostar/rolar/atravessar/desaparecer/agitar/bater
microorganismo	protoctista/prototista
microrganismo	protoctista/prototista
migração	emigração/expatriação
militar	oficial
mirar	fitar/vislumbrar/espiar/encarar/contemplar/olhar/ver/embasbacar/embasbacar-se/admirar/contemplar/ver
missiva	invitação/convite
mistura	soluto/solução/liga/solução/suspensão
misturar	mesclar/combinar
mobiliário	alfaia/aparelhador/cómoda/gaveteiro/movéis/reposteiro/candeeiro/cortina/cômoda/luminária/mobília/assento/mesa/móvel/cadeira/guardarroupas/guarda-roupas/estante/mesa/armário
mobília	alfaia/aparelhador/cómoda/gaveteiro/movéis/reposteiro/candeeiro/cortina/cômoda/luminária/mobiliário/assento/mesa/móvel/cadeira/guardarroupas/guarda-roupas/estante/mesa/armário
modelar	plasmar/achatar/amoldar/retorcer/aplainar/moldar/enxugar/forjar/fundir/torcer/transformar
modificar	impactar/aperfeiçoar/acertar/completar/afetar/modelar/formar/substituir/ajustar/corrigir/melhorar/encher/trocar/reduzir/diminuir/acostumar-se/adequar/amalgamar/aprontar/assear/cevar/depravar/desabilitar/desordenar/evaziar/fortalecer/habituar/habituar-se/indispor/inseminar/perverter/transubstanciar/acostumar/adaptar/afectar/afrouxar/agravar/ampliar/avariar/corromper/desativar/desobstruir/emprestar/engordar/equiparar/exacerbar/fecundar/fertilizar/incapacitar/transmudar/viciar/alumiar/desvirtuar/encerrar/esfriar/estreitar/macular/purgar/refrigerar/resfriar/secar/subverter/bagunçar/contaminar/contribuir/enrijecer/fortificar/gelar/molhar/progredir/sujar/amortecer/aviltar/converter/danificar/esquentar/esvaziar/refrescar/traduzir/unificar/afetar/aquecer/enxugar/igualar/apertar/clarear/endurecer/piorar/enfraquecer/manchar/marcar/baixar/finalizar/preparar/adicionar/ajustar/transformar/concluir/encher/trazer/misturar/terminar/deixar/limpar/carregar/conduzir/cair/aumentar/fazer
modificação	decréscimo/falecimento/dano/estrago/flutuação/avaria/variação/prejuízo/surpresa/queda/diminuição/abatimento/morte/mudança/transmutação/nascimento/transformação/crescimento/transição/aumento/mudança
moeda	cache/numerário/divisa/peça/capital/prata/dinheiro/fundo/cobres/grana/guito/dólar/dinheiro/massa
moita	rosa/rosas/rosa/pimentão/pimenta/algodão
moldar	plasmar/amoldar/forjar/fundir/modelar/transformar
momento	saída/prazo/início/começo/princípio/instante/hora/segundo/dia
montão	leva/horda/turba/tropa/legião/exército/multidão/massa
morada	vivenda/habitação/casa
moradia	vivenda/habitação/casa
morador	europeu
moral	honestidade/justiça
moralidade	honestidade/justiça
morar	alojar
morrer	afogar-se/afogar/tombar/cair
mortificar	degradar/aviltar/desvalorizar/rebaixar
morto	enchido/defunto/cadáver/corpo
mostrar	acentuar/pontuar/enfatizar/manifestar/demonstrar/expor/exibir/revelar/apresentar/descobrir/trazer/divulgar/reportar/relatar/anunciar
mota	ciclomotor/moto/motocicleta
motivação	morais/moralidade/ética/moral/vida
motivo	morais/moralidade/ética/moral/vida
moto	ciclomotor/mota/motocicleta
motocicleta	ciclomotor/moto/mota
motor	motores/máquina
motores	motor/máquina
mover	arredar/contorcer/enroscar/espernear/torcer-se/alçar/botar/manar/virar-se/dançar/fluir/largar/entornar/pulsar/tornar-se/verter/derramar/elevar/expulsar/puxar/erguer/transportar/empurrar/forçar/girar/pôr/sacudir/soltar/tremer/sair/transmitir/correr/levantar/levar/partir/agitar/colocar/deixar/virar/carregar/tirar/separar/afugentar/arriar/deslocar-se/desvanecer/engatar/vassourar/abalroar/bailar/brandir/expedir/oscilar/propulsar/propulsionar/rechaçar/revolver/dançar/ondular/revirar/transladar/afastar/submergir/deslocar/engajar/transferir/varrer/deslizar/despachar/encostar/impulsionar/rodar/situar/rebaixar/rolar/afundar/embarcar/baixar/mexer/transportar/empurrar/atravessar/guiar/desaparecer/transmitir/enviar/trazer/partir/agitar/conduzir/lançar/dividir/tocar/separar/bater
movimento	migração/precipitação/regresso/vaga/onda/retorno/caçada/descensão/travessia/ascensão/avanço/locomoção/elevação/perseguição/progressão/aceleração/onda/manobra/viagem
movéis	aparelhador/cómoda/gaveteiro/candeeiro/cômoda/luminária/assento/mesa/cadeira/guardarroupas/guarda-roupas/estante/mesa/armário
mudança	decréscimo/falecimento/ascenção/dano/estrago/flutuação/rotação/avaria/variação/gesto/promoção/prejuízo/surpresa/queda/diminuição/sinal/abatimento/morte/reviravolta/ajuste/alteração/conversão/reorientação/transmutação/traslado/agitação/deslocamento/modificação/nascimento/transformação/crescimento/golpe/melhoria/transição/diferença/progresso/inclinação/movimento/aumento
mudar	amarfanhar/amarrotar/descontrair/esboroar/esfarelar/fraccionar/fracionar/perecer/repartir/transmutar/despedaçar/falecer/fender/fracassar/impactar/levantar-se/aperfeiçoar/colapsar/despertar/expirar/relaxar/acertar/completar/decair/afetar/fundir/modelar/piorar/formar/acordar/desmoronar/morrer/substituir/ajustar/congelar/corrigir/transformar/combinar/melhorar/encher/misturar/trocar/reduzir/dividir/diminuir/separar/acalmar-se/acostumar-se/adequar/amalgamar/aprontar/assear/carburar/cevar/depravar/desabilitar/desordenar/desoxidar/ebulir/estabilizar-se/evaziar/fortalecer/habituar/habituar-se/iluminar-se/indispor/inrijecer/inseminar/nascer/perverter/transubstanciar/vestir-se/acostumar/adaptar/afectar/afrouxar/agravar/ampliar/aprumar/arrumar-se/avariar/azedar/combustir/conflagrar/corromper/desativar/desobstruir/emprestar/engordar/equiparar/exacerbar/fecundar/fertilizar/incapacitar/incinerar/solidificar/transmudar/viciar/alumiar/amenizar/cozinhar/descolorir/desintegrar/desvirtuar/dissolver/emagrecer/encerrar/escurecer/esfriar/estreitar/evaporar/incorrer/inverter/largar/macular/nivelar/purgar/refrigerar/resfriar/secar/subverter/vaporizar/amanhecer/bagunçar/contaminar/contribuir/enrijecer/fortificar/gelar/iluminar/molhar/progredir/relaxar/reverter/sujar/acertar/amortecer/assentar/aviltar/converter/danificar/esquentar/esvaziar/fechar/refrescar/traduzir/unificar/afetar/aquecer/colorir/deformar/enxugar/igualar/tornar/apertar/clarear/endurecer/estragar/ferver/piorar/acender/enfraquecer/manchar/marcar/baixar/desmoronar/finalizar/preparar/vestir/adicionar/ajustar/experimentar/sofrer/transformar/abrir/estar/concluir/desenvolver/obter/adquirir/melhorar/sair/encher/receber/trazer/misturar/queimar/terminar/partir/ficar/abandonar/deixar/limpar/virar/carregar/conduzir/dividir/separar/pegar/cair/aumentar/fazer
mulher	dona-de-casa/dona/esposa/senhora/dama/madame/senhorita/senhora/dama/garota/moça/rapariga
multidão	leva/horda/turba/tropa/legião/exército/massa
municipalidade	arraial/burgo/aldeia/distrito/povoado/vila/metrópoles/metrópole/cidade
município	arraial/burgo/aldeia/distrito/povoado/vila/metrópoles/metrópole/cidade
munição	bomba
musico	compositor
mutante	esdrúxulo/monstro
mutantes	esdrúxulo/monstro
mutação	esdrúxulo/monstro
mágoa	desgosto/amargura/tristeza/dor/pesar
máquina	moinhos/calculadora/maquinaria/maquinário/moinho/computador/roda/motores/motor
mãe	progenitora/papai/papá/painho/pai
mão-de-obra	empenho/esforço
médico	aia/ama-seca/dentista/enfermeira/enfermeiro/enfermeiros/odontólogo/dr./doutor
método	sistema
métodos	sistema
mês	lua
mímica	paródia
móvel	alfaia/aparelhador/cómoda/gaveteiro/movéis/reposteiro/candeeiro/cortina/cômoda/luminária/mobília/mobiliário/assento/mesa/cadeira/guardarroupas/guarda-roupas/estante/mesa/armário
música	seção/parte
músico	compositor
narcótico	ópio
natureza	temperamento/disposição
navio	vapor
navios	vapor
nação	ralé
necessidade	ausência/escassez/deficiência/falta/carência/morais/moralidade/ética/moral/vida
negar	reter/conter
negação	abjuração
negociador	representante/intercessor/mediador/intermediário
negociante	dono/proprietário
negócio	transportação/indústria/manufatura/transporte/expedição/finança/negociação/transação
nicho	abside/ábside
nojo	enjôo/náusea
nome	título/denominação/cognome/sobrenome/antenome/prenome/apelido/título
nomear	baptizar/batizar/delegar
noção	psique/atitude/mente/cabeça/incapacidade/informação/capacidade/conhecimento/poder/habilidade/talento
nutriente	repasto/refeição/bebida/prato/alimentos/comestivel/petisco/provisões/suprimentos/guloseima/ração/alimentação/nutrição/comida/alimento/prato
nutrição	repasto/refeição/prato/petisco/guloseima/prato
náusea	enjôo
não-ficção	artigo
nível	alcance/auge/ápice
número	acrescentamento/amplidão/marcador/tamanho/dimensão/medida/proporção/magnitude/extensão/aumento/maioridade/montante/ascendência/contagem/maioria/totalizar/alcance/soma/quadrado/quantidade/conta/extensão/base
obedecer	escutar
objectivo	objetivo/fim/intenção
objecto	paixão/afeição/amor
objetivo	paixão/afeição/amor
objeto	paixão/chão/locação/relevo/localização/paixão/solo/terra/afeição/amor/ponto/lugar/solos/coisas/todo/lua/resto/porção/unidade/solo/formação/terra/parte
objeção	queixa
obra	publicação/edição
obrigar	coagir/compelir/forçar
obrigação	incumbência/serviço/designação/função/tarefa/papel
observar	fitar/vislumbrar/espiar/encarar/contemplar/olhar/ver/embasbacar/embasbacar-se/admirar/contemplar/ver
obstrução	interferencia/atrapalhação/obstáculo/trava/barreira/barra/obstáculo
obstáculo	interferencia/estacada/paliçada/atrapalhação/cerca/barreira/dificuldade/problema/guarda-lama/trava/barreira/barra/problema
obtenção	récorde/triunfo/êxito/sucesso
obter	beneficiar-se/re-adquirir/beneficiar/reconquistar/reganhar/auferir/lucrar/comprar/recuperar/ganhar/adquirir/encontrar/atingir/compartir/fretar/reganhar/topar/partilhar/alugar/ganhar/adquirir/receber/encontrar/aceitar/atingir/achar/dividir
ocasionar	cumprir/efetuar/executar/realizar/atingir
ocasião	virada/crise/vez
ociosidade	retardar/atraso/adiar/intervalo/pausa
ocorrente	revés/alteração/incidente/ocorrência/quebra/instância/modificação/ocasião/variação/coincidência/evento/colapso/acidente/caso/vitória/exemplo/problema/mudança/conjuntura/deflagração/surto/epidemia/eventualidade/incêndio/convergência/episódio/fado/ocasião/acontecimento/desastre/erupção/evento/interrupção/destino/fogo/início/ruído/toque/coisa/começo/explosão/princípio/som/sorte/experiência/movimento/pausa/ponto
ocorrer	materializar/re-ocorrer/reincidir/calhar/recorrer/prosseguir/suceder/repetir/acontecer/ir
ocorrência	revés/alteração/incidente/quebra/instância/modificação/ocasião/variação/coincidência/evento/colapso/acidente/caso/vitória/exemplo/problema/mudança/conjuntura/deflagração/surto/epidemia/eventualidade/incêndio/convergência/episódio/fado/ocasião/acontecimento/desastre/erupção/evento/interrupção/vez/destino/fogo/início/ruído/toque/coisa/começo/explosão/princípio/som/sorte/experiência/movimento/pausa/ponto
ocultar	disfarçar/mascarar/encobrir/esconder/sepultar/soterrar/enterrar
ocultação	camuflagem
ocupação	abastecimento/posicionamento/treinamento/treino/protecção/provimento/auxílio/conduta/socorro/colocação/fornecimento/ajuda/comportamento/procedimento/processo/esforço/liderança/manobra/preparação/proteção/assistência/costume/criação/tentativa/hábito/operação/jogo/agrupamento/calibração/controlo/delito/desabafo/galhofa/mensuração/recreaçao/adoração/amparo/desperdício/medição/ocultação/transgressão/uso/utilização/atuação/cerimônia/diversão/escrita/música/animação/comportamento/divertimento/medida/representação/vez/preparação/suporte/buscar/tarefa/interpretação/operação/mercado/organização/controle/jogo/procurar/trabalho
odor	aroma/fragância
ofender	humilhar/descompor/mortificar/aviltar/insultar/rebaixar
ofensa	infracção/infração/afronta/desconsideração/insulto/crime/injúria
oferecer	legar/deixar/entregar/passar/dar/render-se/ceder/entregar/dar
oficina	chácara/granja/quinta/sítio/fazenda/central
ofício	pintura
olhar	fitar/vislumbrar/espiar/encarar/contemplar/ver/embasbacar/embasbacar-se/admirar/contemplar/ver
omitir	disfarçar/mascarar/encobrir/esconder/sepultar/soterrar/enterrar
onda	pulsação
ontogenia	cultura
ontogénese	cultura
operar	avionar/esterilizar/pilotar/desdobrar/voar/funcionar/servir
operação	ofensiva/campanha/ataque/manobra/combinação
opinião	doutrina/projecto/conceito/convicção/religião/filosofia/concepção/programação/certeza/idéia/tema/motivo/projeto/fé/ideia/intenção/programa/plano/espirito/perspicácia/juízo/confiança/pensamento/sentido/fé/significado/ideia/intenção
opor	protestar
oportunidade	audiência/ouvinte/chance/dia
oposição	resistência/reação
opção	cabimento/possibilidade
oração	bênção
ordem	guilda/camarilha/clube/tabela/calendário/sociedade/consórcio/mandamento/gangue/sindicato/instituição/quadrilha/sequência/série/instituto
ordenar	convocar/chamar/instruir/arrumar/organizar
ordenação	sequência/sucessão
organismo	alguém/criatura/flora/animal/besta/bicho/indivíduo/planta/alma/vegetal/pessoa/ser/fungo/microorganismo/microrganismo/mutante/anfitrião/comensalismo/fungos/hospedeiro/mutantes/mutação/parasita
organizar	arrumar/ordenar/arrumar
organização	guilda/clube/elenco/associação/calendário/chapa/comissão/comité/comitê/legenda/partido/delegação/economia/embaixada/missão/sociedade/pessoal/união/companhia/ordem/consórcio/ordenação/coalizão/coligação/gangue/sindicato/empresa/instituição/quadrilha/instituto/aliança/companhia
orientador	capataz/supervisor/chefe
orientação	ideologia/perspectiva/visão/posição/mirada
orifício	boca
origem	causa
orla	beira-mar/costa/litoral
ornamento	joalharia/joalheria/jóia/naipe/emblema/decoração
ornato	ornamento/decoração
oscilar	balançar/sacudir
osso	dentes/dente
pacote	baralho
pagamento	prestação/recompensa
pagar	reintegrar/retribuir/despender/restituir/repagar/gastar/desembolsar/corromper/indenizar/subornar/doar/recompensar/contribuir/gastar/liquidar/compensar
pai	progenitora/papai/papá/painho/mãe
pano	patch/remendo/seda/algodão/vela/crepe/lenço/mohair/trama/malha/sobra/resto/rede
papar	mordiscar
papel	folhas/cartão/carta/folha/folhas/folha/lugar/posição
parar	interromper/desistir/abandonar
parecer	recender/disturbar/emocionar/cheirar/perturbar/assemelhar/esfriar/radiar/reagir/ressoar/conquistar/copiar/surgir/endurecer/irradiar/imitar/soar/adquirir/fazer
parede	muro
paredes	muro/parede
parente	antecessor/cónjuge/prima/consorte/cônjuge/esposa/esposo/marido/tio/ancestral/antepassado/descendência/primo/companheiro/descendente/filho/família
parentesco	paternidade
parte	hardware/fatia/segmento/adição/tira/peça/seção/melhoria/componente/conclusão/pedaço/anatomia/pixel/píxel/segmento/apêndice/chapéu/órgão/canto/ponto
partida	despedida/competição/torneio/corrida/combate/jogo/luta/despacho/envio/saída/corrida/expedição
partilha	doação
partir	descolar/desgrudar/cindir/desconectar/dispersar/rasgar/espalhar/dividir/quebrar/separar
partição	doação
passar	agradecer/esfregar/apreciar/correr/comissionar/desobrigar/incumbir/materializar/re-ocorrer/reincidir/calhar/confidenciar/lembrar-se/confiar/recorrer/exalar/livrar/manifestar/alienar/exprimir/transferir/demonstrar/ocorrer/prosseguir/renunciar/suceder/expressar/repetir/significar/atravessar/lembrar/acontecer/desistir/indicar/mostrar/transmitir/liberar/correr/ficar/servir/abandonar/deixar/entregar/ir/pegar/dar
passivo	desvantagem
passo	manobra
pau	clava/porrete
pavimento	cave/mansarda/porão/trapeira/sótão/ático
paz	consenso/acordo
pecado	decadência/queda
peculiaridade	disposição/atividade/egocentrismo/índole/bobeira/caráter/sagacidade/sapiência/conduta/egoísmo/firmeza/modalidade/natureza/disciplina/sabedoria/sensatez/comportamento/procedimento/personalidade/maneira
pecuária	horticultura
pedagogo	acadêmico/professor
pedaço	fatia/tira/porção/anatomia/pano/segmento/gota/canto
pedido	invitação/convite/consumo/reza/súplica/pergunta/oração/petição/inquérito/questão/apelo
pedir	desafiar
pedra	litíase/matacão/rochedo/pedregulho/rocha
pegar	apreender/agarrar/capturar/prender/segurar/raptar/seqüestrar/sequestrar/agarrar/capturar/tomar/segurar
peleja	conflito/disputa
penalizar	executar
pendurar	suspender
penetrar	perfurar/furar
pensamento	projecto/conceito/concepção/programação/idéia/tema/motivo/projeto/ideia/intenção/programa/plano/juízo/sentido/opinião/significado/ideia/intenção
pensar	centrar/ruminar/concentrar/manufaturar/associar/cogitar/conectar/fabricar/relacionar/inventar/ponderar/especular/focar/contemplar/planejar/refletir/afigurar/balizar/envisionar/reputar/caracterizar/caraterizar/figurar/raciocinar/visualizar/qualificar/avaliar/lembrar/julgar/considerar/achar/ver
perceber	enxergar/ouvir/doer/escutar/cheirar/sentir/olhar/ver/avistar/divisar/sonhar/ver
percepção	ouvida/escuta/olhada/odor/cheiro/sensação/olhar
percurso	rumo/direcção/direção/curso
perda	capitulação/rendição
perder	olvidar/esquecer
perecer	afogar-se/afogar/tombar/cair
perfazer	aperfeiçoar/polir/melhorar
perfeição	sonho
performance	mecanica/mecanismo
perfurar	furar/atravessar/furar
pergunta	indagação/quesito/interrogação/questão/interrogatório
perguntar	consultar
perissodáctilos	equino/equídeo/ungulados
periódico	número
permitir	aturar/tolerar/aguentar/suportar/admitir/aceitar/confiar/autorizar
perseguir	caçar/seguir
personalidade	identidade/ânimo
personificação	mímica/imitação
perspicácia	juízo/opinião/ideia
persuadir	convencer
persuasão	arma/recurso
pertencer	referir-se
perturbar	angustiar/doer/machucar
período	centúria/decênio/década/estio/inverno/outono/primavera/sazão/século/séculos/verão/manhã/mês/noitada/semestre/século/velhice/estágio/semana/continuidade/trimestre/fase/tarde/duração/era/estação/idade/época/infância/ano/noite/tempo/pré-história/puberdade/jornada/noitada/temporada/semana/sono/prazo/sesta/era/estação/idade/juventude/época/licença/ano/hora/passado/momento/noite/dia/vida/tempo
pesar	terpena/desgosto/amargura/mágoa/remorso/tristeza/dor/desgosto/mágoa/tristeza/dor
pessoa	conhecida/engenheiro/habitante/proponente/líder/morador/cientista/especialista/parente/conhecido/defensor/identidade/advogado/amizade/autoridade/vizinho/aluno/chefe/personalidade/trabalhador/amigo/estudante/representante/adjudicator/amado/amo/comunicador/creador/desafortunado/desventurado/governante/hebraica/hebreia/infortunado/intelecto/possuidor/amiga/anomalia/autóctone/competidor/contendor/criatura/fêmea/governador/súdito/turista/capitalista/cidadão/criador/dono/hebreu/judia/artista/camarada/conhecido/criativo/hebraico/judeu/juvenil/menor/viajante/amizade/criança/juiz/proprietário/seguidor/amante/esperança/face/jovem/árbitro/amigo/intelectual/varão/estudante/macho/rosto/cara/homem/ser/parte/vida
pessoal	galera/vulgo/nação/estrato/geração/inimigo/mundo/população/gente/povo/classe/freguesia/ralé/clientela/coorte/mediação/nação/gente/povo
petisco	bala/doce
petição	invitação/convite/reza/súplica/pergunta/bênção/oração/inquérito/questão/apelo
peça	pano/dólar
piedade	afeição/empatia/compaixão
pioneirar	constituir/fundar/estabelecer
piorar	degenerar/degradar/deteriorar/adoecer/adoentar/decair/irritar
piso	cave/mansarda/porão/trapeira/sótão/ático
placa	tábua/lousa/quadro
placar	conseqüência/resultado
planejar	destinar
plano	programa
planta	casademoinho/fábrica/manufatura/usina/epifitismo/epífito/traqueófitos
plantar	produzir/fazer
planície	brejos/planícies/páramo/charneca
poder	influência/meta/técnica/inteligência/força/habilidade/talento/criatividade/efetividade/opulência/potencia/suntuosidade/criatividade/efeitos/eficiência/sumptuosidade/aptidão/eficácia/faculdade/luxo/valência/potência/liderança/riqueza/força/habilidade/talento
poliedro	pirâmide
poliedros	pirâmide
polir	aculturar/civilizar/escolar/educar/cultivar/treinar
político	prefeito
ponderar	questionar/perguntar
ponto	regiões/selva/floresta/região/virada/crise/lar/região/fronteira/lugar/casa
população	galera/vulgo/nação/estrato/geração/inimigo/mundo/gente/pessoal/povo/classe/freguesia/clientela/coorte/nação/gente/povo
porrada	pontapé/chute
portar	comportar-se/resistir/conduzir
porto	cais
porção	fatia/segmento/tira/peça/seção/componente/pedaço/parte/anatomia/drinque/fatia/segmento/apêndice/bebida/canto/pedaço
posicionar	alinhar
posição	gradação/direita/grau/lugar/marina/espaçamento/fronte/composição/frente/primeiro/lugar
posse	possessão/propriedade
possessão	dinheiro/imobiliária/imóvel/riqueza/fundo/bem
possibilidade	oportunidade/potenciabilidade/potencial/chance/pressuposição/suposição/hipótese
posto	gradação/grau/primeiro/posição
poupar	registar/registrar
povo	galera/vulgo/nação/estrato/geração/inimigo/mundo/população/gente/pessoal/classe/freguesia/ralé/clientela/audiência/coorte/espectador/nação/gente
povoar	alojar/morar
prata	dólar
prato	salada/sopa/sobremesa/doce
prazer	deleite/conforto/alegria
praça	piazza/adro/largo
precipitar	chover
precipitação	nevada/neve/chuva
predicado	feição/peculiaridade/temperamento/personalidade/pessoa/atributo/formato/forma/situação/condição/estado/propriedade/qualidade/tempo
prender	trancar/pendurar/implantar/conectar/pendurar/amarrar/atar/forçar/ligar/colocar
prenome	título/denominação/cognome/sobrenome/antenome/apelido/nome/título
preocupação	temor/medo/interesse/caso
preparar	preservar/conservar
preparação	prática/exercício/culinária/cozinha
presente	galardão/prémio/prêmio/ajuda
preservar	enlatar/conservar/registar/registrar
pressuposição	fundação/base
presságio	evidência/indicação
pressão	esmagamento/compactação
prestação	ordenado/salário/remuneração/retribuição
pretender	planear/planejar
pretensão	ambição/aspiração/afã/concupiscência/cio/eros/saudade/anelo/anseio/desejo
preço	custos/preços/importância/magnitude/custo/pagamento/taxa/recompensa/custo
preços	custos/importância/magnitude/preço/custo
primata	hominídeo
primatas	hominídeo
princípio	gênese/alvorecer/iniciação/manhã/madrugada/amanhecer/concepção/início/origem/começo/criação
privar	deserdar
problema	dificuldade/obstáculo/estrondo/aflição/infortúnio/azar/ruído
procedimento	modo/cálculo/maneira
processo	cálculo
proclamar	ditar
procurar	arriscar/vasculhar/revirar/arriscar
produto	livros/película/importação/cinema/filme/mercadoria/revista/livro/produção/artigo/carregamento/exportação/frete/obra/fruto/mercadoria/carga/jornal/produção/trabalho
produzir	cumprir/efetuar/executar/realizar/atingir
produção	livros/película/cinema/filme/revista/livro/obra/fruto/cultivo/criação/jornal/produto/rendimento/trabalho
proeza	rebatida/jogada/façanha/batida
proferir	cochichar/balbuciar/sussurrar/resmungar/murmurar/berrar/cantar/contar/falar/gritar/dizer/balbuciar/gaguejar/ladrar/bradar/proclamar/vociferar/discutir/murmurar/tagarelar/conversar/reclamar/soltar/desejar/falar/dizer/representar
professor	catedrático
profissional	jurista/advogado/educacionista/pedagogo/educador/médico
profissão	pedagogia/pintura/política
progenitor	progenitora/papai/papá/painho/pai/mãe/genitor
programa	planos/sub-rotina/subrotina/táctica/tática/estratégia/procedimento/função
programação	programa
progredir	amadurecer/evoluir/florir/desabrochar/florescer/avançar/alongar/elevar/crescer/desenvolver/aumentar
projecto	programa
projeto	aventura/bebê/programa
projeção	giba/montículo/protuberância/saliência/excrescência
pronunciar	inocentar/absolver/enrolar
propor	advocar/recomendar/urgir/promover
proposta	assessoramento/conselho/recomendação
propriedade	feição/peculiaridade/temperamento/constituição/fraqueza/grandeza/característica/odor/cheiro/composição/estrutura/idade/personalidade/possessão/magnitude/pessoa/grau/qualidade/força/número/imobiliária/atributo/formato/forma/imóvel/possessão/situação/condição/estado/maneira/riqueza/qualidade/fundo/estilo/tempo/bem
propulsar	atirar/jogar/lançar/chutar/bater
propulsionar	atirar/jogar/lançar/cotovelar/cutucar/acotovelar/chutar/bater
propulsão	pontaria/tiro/alcar/puxão/levantamento/rolamento/elevação/empurrão/tração/forca/impulsão/pulo/impulso/salto
prosa	não-ficção
protecção	tutela/cuidado
protetor	guarda
proteção	amparo/protecção/telhado/escudo/teto/tutela/cortina/cuidado
protocolar	recrutar/inscrever/registar/registrar
protoctista	algas/alga/protozoário
prototista	algas/alga/protozoário
provar	redundar/sobrevir/resultar/suceder/seguir
provedor	fornecedor/conexão
prover	apetrechar/aparelhar/equipar/suprir/servir/dar/abrigar/amparar/mobiliar/armar/possibilitar/despejar/providenciar/proporcionar/derramar/fornecer/suprir/permitir/ajudar/satisfazer/alimentar/servir/deixar/dar
providenciar	alienar/dispor
provisionar	servir/dar/suprir/ajudar/satisfazer/alimentar/servir
provocar	recriar/copiar/desovar/humilhar/ocasionar/pioneirar/adjudicar/descompor/edificar/empreender/concretizar/confeccionar/imaginar/mortificar/fabricar/procriar/recriar/reproduzir/substanciar/aviltar/cumprir/efetuar/ofender/verbalizar/gerar/insultar/rebaixar/causar/outorgar/produzir/preparar/executar/construir/realizar/criar/iniciar/atingir/dar/fazer
provérbio	ditado
prática	revisão
prédio	escolas/plantel/vivenda/estufa/hall/hotel/restaurante/viveiro/colégio/departamento/habitação/salão/centro/escola/casa/casadeoração/clube/ministério/igreja/templo/teatro/casa
psicopata	megalomania/psicose
psicopatia	megalomania/psicose
publicação	livro/coletânea/coleção/periódico/revista/compêndio/jornal
pugilismo	combate/luta
pugna	conflito/disputa
pulsar	palpitar
punir	executar
purgar	lavar/desinfectar/desinfetar/escovar/varrer
putrefação	cárie/ruína
puxar	arrastar/tremer
pão	pãozinho
pôr	deitar/semear/instalar/dispor/plantar/arranjar/colocar/estacionar/posicionar/instalar/posar/sentar-se/assentar/sentar/situar/acumular/sinalizar/erguer/experimentar/levantar
qualidade	faceta/semblante/custos/natureza/preços/aspecto/característica/importância/valor/magnitude/preço/custo/aparência/dificuldade/habilidade/elegância/impotência/popularidade/regularidade/incompatibilidade/moralidade/similardidade/certeza/diferença/moral/semelhança/virtude/poder
qualificar	distinguir/diferenciar/marcar
quantidade	acrescentamento/aumento/número/montante/totalizar/soma/número
quantificar	cronometrar
quarto	hall/bar/cozinha/banheiro/sala/biblioteca/banheiro/sala
queixa	reivindicação
querer	ansiar/suspirar/desejar/esperançar/aguardar/esperar/desejar
questão	indagação/quesito/interrogação/pergunta/interrogatório
química	explosivo
raciocinar	centrar/ruminar/concentrar/associar/cogitar/conectar/relacionar/ponderar/especular/focar/contemplar/planejar/refletir/balizar/computar/calcular/especular/avaliar/julgar
raciocinio	argumentação/raciocínio
raciocínio	argumentação/política
raiva	fúria/ira/cólera
ranger	mastigar/mascar
rapaz	garoto/filho/menino
razoamento	argumentação/raciocínio
raça	espécie/variedade/género/estilo/tipo/classe
re-adquirir	acessar
reagir	pestanejar/piscar
reajuste	alinhamento
realizar	bastar/desempenhar/cumprir/servir/cobrir
realização	récorde/jeito/modo/maneira/ferramenta/meio/caminho/mecanica/rebatida/jogada/proeza/triunfo/êxito/feito/obtenção/sucesso/andada/façanha/mecanismo/batida
rebaixar	degradar/aviltar/desvalorizar
rebater	opor
receber	beneficiar-se/re-adquirir/beneficiar/reconquistar/reganhar/auferir/lucrar/comprar/recuperar/ganhar/obter/adquirir/encontrar/atingir/compartir/fretar/reganhar/topar/partilhar/alugar/ganhar/adquirir/encontrar/aceitar/atingir/achar/dividir
recender	tresandar/feder/cheirar
recipiente	envelope/sobrecarta/vasilhame/sobrescrito/cesta/copo/cesto/lata/vasilha/vaso/caixa/sacola/embalagem/lata/molde/vasilha/saco/pacote/bolsa
recitar	contar
recolher	catar/colher/apanhar/respigar/colher
recompensa	compensação/prestação/remuneração
reconhecer	distinguir/diferenciar/separar
reconhecimento	saudação/agradecimento
reconquistar	acessar
recontro	atrito/fricção
recordar	reconhecer
recordar-se	reconhecer
recreaçao	entretenimento/esporte/hobby/celebração/diversão/entreterimento/festividade/passatempo/divertimento/festa/jogo/escapismo/gozação/sacanagem/travessura/brincadeira/dança/aposta/baile/trote
recriar	contrafazer/desempenhar/falsificar/apresentar/fazer/atuar/representar/fazer
recuperar	acessar
recuperação	salvamento/salvação
redigir	registar/registrar
redundar	derivar/resultar
reduzir	encurtar/resumir/condensar/abreviar/diminuir/circunscrever/encurtar/encolher/confinar/minimizar/ferver/limitar/restringir/diminuir
refinar	aculturar/civilizar/escolar/educar/cultivar/treinar
refletir	centrar/ruminar/concentrar/associar/cogitar/conectar/relacionar/ponderar/especular/focar/questionar/contemplar/perguntar/planejar/balizar/raciocinar/avaliar/julgar
refrear	limitar/restringir/conter/limitar/restringir/treinar
refutar	opor
refúgio	tenda/barraca
regalar	legar/deixar/entregar/passar/dar/render-se/ceder/entregar/dar
reganhar	acessar
reger	gerir/governar/reinar/manobrar/canalizar/lidar/cuidar/guiar/dirigir
registar	recrutar/inscrever/registrar/fotografar/anotar/filmar/protocolar/registrar
registrar	recrutar/inscrever/registar/fotografar/anotar/filmar/protocolar/registar
registro	crónica/crônica/fichário/ficheiro/registo/índices/registrador
região	cerque/circunscrição/comarca/districto/entorno/olimpo/paraíso/quadra/tumba/alturas/campos/envolvente/jazida/parque/praça/quarteirão/túmulo/distrito/gramado/hemisfério/locação/sepultura/território/céu/sítio/camada/estrato/interior/terreno/ambiente/bloco/zona/campo/domínio/meio/lugar/gleba/paragem/localidade/extremidade/profundeza/território/cena/esconderijo/exterior/vácuo/condado/refúgio/terreno/ambiente/topo/lado/área/parada/fundo/campo/ponto/domínio/traseiro
regiões	circunscrição/comarca/districto/distrito/território/domínio/território/ambiente/área/região/domínio
regozijar	animar-se/alegrar-se/alegrar/animar
regozijar-se	animar-se/alegrar-se/alegrar/animar
regulação	alinhamento
rejeitar	desconsiderar/descartar/esnobar/ignorar/menosprezar/repudiar/renunciar
relacionamento	romance
relacionar	mencionar/referir
relato	bisbilhotice/bisbolhetice/fofoca/anedota/historieta/piada
relatório	bisbilhotice/bisbolhetice/fofoca/anedota/historieta/piada
relação	pertinência/relevância/parentesco/comparação/fundação/amizade/afinidade/possessão/propriedade/paternidade/reciprocidade/relacionamento/parentesco/romance/posse/oposição/propriedade/bem/ligação
relevo	florestas/arvoredo/selva/bosque/ilha/mata/floresta/planície/chão/campanha/terra
relógio	relógios
remover	amputar/deletar/resgatar/cavar/escavar/retirar/apagar/sacar/tirar/desempacotar/desentranhar/desmarcar/destripar/desventrar/desviscerar/esventrar/desmantelar/desprender/estripar/tossir/desalojar/eviscerar/pigarrear/descascar/escovar/retirar/sacar/limpar/tirar
remédio	terapia/medicamento/analgésicos/intoxicante/analgésico/narcótico/sedativo/calmante
rendimento	safra/colheita
renunciar	rebater/refutar
reorientação	reversão
reparar	remendar/consertar
repartição	parcela/parte
repetir	recitar
repetição	recorrência
reporte	bisbilhotice/bisbolhetice/fofoca/anedota/historieta/piada
repousar	levantar/capotar/sonecar/dormir/dormitar/cochilar
representante	mostra/excepção/exceção/amostra/agente
representar	constituir/desmentir/enquadrar/retratar/personificar/compor/estabelecer/propor/apresentar
representação	foto/mapa/retrato/cópia/reprodução/fotografia/esquema/imagem/figura/ilustração/modelo/desenho/caracterização/documento/retrato/imitação/personificação/ato
reproduzir	simular/copiar/imitar/hibridizar/cruzar
repudiar	rebater/refutar
repugnância	enjôo/náusea
repulsa	enjôo/náusea
requerimento	invitação/convite/reza/súplica/pergunta/oração/petição/inquérito/questão/apelo
requisição	invitação/convite/reza/súplica/pergunta/oração/petição/inquérito/questão/apelo
residência	vivenda/habitação/casa/lar/casa
resistir	reinvindicar/asseverar
resistência	protesto/confronto/oposição
resolução	designação/nomeação/passo/movimento
resolver	seleccionar/selecionar/escolher/mensurar/regulamentar/regularizar/decretar/inferir/medir/adivinhar/supor
responsabilidade	desvantagem
responsabilizar	delegar
responsável	administrador/gerente
ressoar	soar/tocar/batucar/borburar/tique-taque/buzinar/chocalhar/crepitar/guinchar/ratear/ronronar/rugir/sussurrar/apitar/assobiar/borbulhar/ecoar/uivar/reverberar/soar/bater
resto	fossil/fósseis/fóssil
restringir	delimitar/marcar
resultado	efeitos/influência/efeito/conseqüência
resultar	redundar/sobrevir/derivar/suceder/seguir
reter	privar/adiar/negar/distanciar-se/distanciar/afastar/deter/deduzir/poupar/preservar/conservar/amarrar/atar/guardar/segurar/manter
retirar	amputar/resgatar/cavar/escavar/sacar/tirar/desempacotar/desentranhar/destripar/desventrar/desviscerar/esventrar/desmantelar/desprender/estripar/tossir/desalojar/eviscerar/pigarrear/descascar/escovar/remover/sacar/limpar/tirar
reunir	catar/colher/apanhar/casar-se/respigar/esposar/casar/celebrar/colher/juntar
reunião	audiências/cimeira/ouvintes/cimeira/sessão/turba/cúpula/dupla/aula/conferência/público/encontro/montão/par/multidão/curso/classe/acampamentos/cambada/turma/assembleia/gangue/municipalidade/município/comunidade/assembléia/acampamento/ano/concentração/curso/classe
reverter	retificar/corrigir
revestir	pintar
revista	número
revistar	vasculhar
reza	bênção
riqueza	dinheiro/opulência/suntuosidade/sumptuosidade/luxo
risco	desvantagem
rito	nupcias/casamento/liturgia
ritual	nupcias/casamento/solenidade
rocha	litíase/matacão/rochedo/pedregulho/pedra
rodada	partida
rodovia	entrada/caminho/avenida
roedor	mus/rattus/camundongo/mouse/ratazana/rato
roque	minarete/farol
rosto	expressão/aparência
rota	rumo/direcção/direção/curso
rotação	giro/torção
rotular	inocentar/denominar/absolver/chamar/nomear
roupa	farda/fardamento/saia/uniforme/camisa/fato/terno/traje/vestido/chapéu/sobretudo/vestuário/traje/vestido
ruminante	bovídeos
ruminantes	bovídeos
ruminar	ponderar/questionar/perguntar
rumo	curso
ruído	baterpalmas/rufo/batida/explosão/anilhagem/chilro/gorjeio/trinado
sabedoria	prudência
saber	disciplina/campo/realizar/compreender/domínio/entender/ciência
saco	bolsa
sacola	bolsa
sacramento	batismo
sacudir	estremecer/tremular/tiritar/tremer
sagacidade	prudência
sala	hall/bar/cozinha/banheiro/biblioteca/banheiro
salpicar	borrifar
sangue	família
santificação	consagração
sapiência	prudência
satisfazer	bastar/cumprir/acomodar/realizar/servir/cobrir
saudade	nostalgia/anelo
saudar	despidir
sazão	estio/inverno/outono/primavera/verão
secar	estorricar/ressecar
secreção	hormona/hormônio/hormônios
secção	fatia/tira/anatomia/segmento/canto
segmento	curva
seguidor	adepto/discípulo/apóstolo/aluno/estudante
seguir	derivar/resultar
segundo	hora
segurança	pose/altivez/aprumo/desembaraço/certeza/fé
segurar	abocanhar/apreender/beliscar/mordiscar/espremer/morder/apertar/negar/agarrar/prender/deter/deduzir/poupar/preservar/conservar/agarrar/capturar/reter/guardar/pegar/manter
seleccionar	eleger/votar/decidir/escolher/esposar/adoptar/adotar
selecionar	eleger/votar/decidir/escolher/esposar/adoptar/adotar
selecção	votação/eleição/voto/decisão/eleição/escolha/resolução
seleção	votação/eleição/voto/decisão/eleição/escolha/resolução
semblante	aspecto/rosto/aparência/feiura/feiúra/beleza/expressão/face/rosto/aparência
semelhança	similardidade/identidade
sensatez	prudência
sensação	som/gosto/sabor
sentença	revogação
sentimento	zanga/consternação/espírito/ira/cólera/temor/raiva/terror/humor/medo/alegria/ânsia/ódio/ansiedade/aversão/preocupação/afeição/amor
sentir	arrepender/arrepender-se/lamentar/regozijar/regozijar-se/alegrar-se/enraivecer/entreter/alegrar/arder/sustentar/sofrer/guardar/considerar/manter
separar	romper/estourar/arrebentar/explodir/quebrar/descolar/desgrudar/fragmentar/cindir/desfazer-se/desconectar/discriminar/dispersar/distinguir/rasgar/diferenciar/desmoronar/espalhar/dividir/quebrar/cair/cortar
separação	segmentação/partição/divisão
sequência	sucessão/série/curso
ser	alguém/cria/predadores/criatura/flora/prole/animal/besta/bicho/existência/filhote/importar/indivíduo/necessitar/presa/planta/agradar/alma/precisar/caber/depender/vegetal/pessoa/requerer/presença/contar/parecer/pesar/vida/ficar/servir/abrilhantar/considerar-se/fulgir/fulgurar/fungo/imperilar/invertebrados/meandrar/microorganismo/microrganismo/mutante/perigar/quedar/anfitrião/comensalismo/cordados/fungos/fêmea/herbívoro/hospedeiro/inter-relacionar/invertebrado/mutantes/refulgir/subjazer/aparentar/comparar/custar/mutação/parasita/repousar/totalizar/caça/larva/possibilidade/prometer/relacionar/valer/ameaçar/animação/arriscar/descansar/doer/habitar/jazer/medir/realidade/resultar/zumbir/comprar/dever/chance/vender/pertencer/macho/permanecer/adicionar/provar/sofrer/brilhar/estar/parecer/vida/chegar/continuar/aceitar/ficar/manter
serventuário	magistrado/jurista/juiz/servidor
servidor	manequim/secretário/secretária/modelo/doméstico/empregado
servir	qualificar-se/qualificar/dar/oficiar/caber/funcionar/suprir/ajustar/ajudar/satisfazer/alimentar
seção	curva/conclusão
shopping	boutique/loja/venda
significar	denotar/apontar/indicar/dizer
simbolo	numeral/símbolo/selo/número/marcadores/estigma/marca/mancha/selo
similardidade	identidade/semelhança
simpatia	afeição/empatia/compaixão/piedade
sinal	numeral/simbolo/símbolos/aceno/emblema/telefone/símbolo/selo/número/marcadores/estigma/evidência/indicação/marca/mancha/selo
sintoma	cefaleia/inflamação/dor
sistema	esqueleto/calendário/economia
situar	alinhar
situação	recontro/inimizade/relacionamento/confronto/conflito/hostilidade/liberdade/condição/relação/actividade/desordem/existência/imaturidade/imperfeição/ápice/acção/destruição/existência/perfeição/cena/cenário/iluminação/nível/delegação/fase/ambiente/atividade/bagunça/defeito/estado/prisão/união/grau/ação/movimento/morte/ser/habilidade/relação/lugar/ligação
soar	tocar/batucar/borburar/tique-taque/buzinar/chocalhar/crepitar/guinchar/ratear/ronronar/rugir/sussurrar/apitar/assobiar/borbulhar/ecoar/uivar/ressoar/reverberar/bater
sobretudo	casaco
sobrevir	derivar/resultar
sociedade	guilda/clube/ordem/consórcio/gangue/sindicato/instituição/quadrilha/instituto
socorrer	facilitar/aliviar
socorro	consolação/consolo/apoio/mão/ajuda/conforto/suporte/ajuda/misericórdia/piedade/assistência
sofrer	afligir-se/prantear/padecer/magoar/lamentar/ter
software	programa/sub-rotina/subrotina/procedimento/função
solicitação	invitação/convite/reza/súplica/pergunta/oração/petição/inquérito/questão/apelo
solidificar	gelar/congelar
solo	areia/florestas/arvoredo/selva/bosque/ilha/mata/floresta/terra/planície/chão/campanha/terra
soltar	latir/ladrar/relinchar/ecoar/repetir
solucionar	inferir/adivinhar/supor
solução	soluto/liga/suspensão
som	rufo/ruído/toque/batida/anilhagem/chilro/gorjeio/trinado/voz
soma	montante/totalizar/número
somar	pontuar/incluir/combinar/unir/misturar/reunir
sub-figura	flanco
subir	galgar/trepar/ascender/montar
substituir	converter/trocar/mudar
substância	líqüido/materiais/sedimento/átomo/fluido/depósito/fluído/proto-plasma/protoplasma/residuo/sólida/explosivo/solução/sólido/mistura
suceder	efectuar/efetuar/alcançar/obter/realizar/atingir/materializar/re-ocorrer/reincidir/calhar/recorrer/derivar/resultar/ocorrer/prosseguir/repetir/acontecer/ir
sucesso	estrondo/sensação
sugerir	advocar/recomendar/urgir/promover
sumir	esvanecer/desaparecer
superfície	tabuleiro/face/lado/firmamento/céu/lado/fundo
superior	orientador/supervisor
supervisor	capataz/chefe
suportar	acorrer/socorrer/assistir/auxiliar/ajudar/encorajar/promover/estimular
suporte	degrau/pedestal/pé/base/aderência/adesão/endosso/perna/pé
suposição	fundação/base/pressuposição/hipótese
suprir	apetrechar/aparelhar/equipar/abrigar/amparar/mobiliar/armar/despejar/prover/derramar/fornecer/alimentar/dar
surgir	mostrar-se/aparecer
surpresa	estupefação
suspender	interromper/parar
suspensão	vapor
século	era/período
série	sucessão/curso
símbolo	numeral/selo/número/marcadores/estigma/marca/mancha/selo
símbolos	numeral/símbolo/selo/número/marcadores/estigma/marca/mancha/selo
sólida	plastico/plásticos/plástico/pó/vidro/cubo/cilindro/bloco/poliedro/poliedros/concavidade/convexidade/cristal
sólido	plastico/plásticos/plástico/pó/vidro/cubo/cilindro/bloco/poliedro/poliedros/concavidade/convexidade/cristal
súdito	cidadã/cidadão
talento	meta/vontade/técnica/arte/sentido/inteligência/memória/habilidade/criatividade/entendimento/aptidão/faculdade/linguagem/discurso/razão/idioma/inteligência/liderança/língua/habilidade
tampar	disfarçar/mascarar/embrulhar/embalar/encobrir/esconder/cobrir/encadernar/sepultar/soterrar/revestir/submergir/enterrar/aplicar/colocar/cobrir
tapar	disfarçar/mascarar/encobrir/esconder/sepultar/soterrar/enterrar
tapete	capacho/carpete
tarefa	assintência/aventura/mão-de-obra/cuidado/dever/projeto/obrigação/trabalho/vigia/encargo/missão/procedimento/bebê/investigação/operação/guarda
taxa	imposto
taxon	espécie/espécies/espécie/filo/género/família/classe
taxón	espécie/espécies/espécie/filo/género/família/classe
tecido	estádio/sacada/torres/varanda/alojamento/pavimento/piso/ponte/prédio/roque/seda/torre/varanda/arena/balcão/cruz/monumento/monumentos/algodão/edifício/abrigo/casa/andar/alpendre/arco/corcova/crepe/divisória/mohair/pano/paredes/trama/asilo/malha/obstrução/parede/contrapeso/defesa/estabelecimento/impedimento/monte/refúgio/equilíbrio/arco/rede/obstáculo
teimar	reinvindicar/asseverar/sustentar/manter
telecomunicar	telefonar/chamar
telhado	abóbada
tema	área
temor	pânico/terror/medo/calafrio/tremedeira/tremura/arrepio/tremor
temperamento	identidade/personalidade
tempero	erva/adoçante/condimento
templo	igrejas/igreja
tempo	actualidade/centúria/decênio/década/estio/inverno/outono/primavera/sazão/século/séculos/verão/vindouro/manhã/mês/noitada/porvir/século/estágio/semana/continuidade/interrupção/trimestre/fase/horário/tarde/duração/era/estação/hoje/idade/época/futuro/presente/ano/passado/suspensão/noite/pausa/período/pré-história/tacto/jornada/noitada/temporada/semana/sono/prazo/sesta/era/estação/idade/juventude/época/contínuo/licença/ano/hora/partida/passado/momento/noite/dia/vida/período
tensionar	alongar/esticar/estender
tentar	arriscar
tentativa	chute/tacada/esforço/batalha/luta/teste
teoria	pressuposição/suposição/hipótese
ter	reter/guardar/segurar/manter/sustentar/manter
terminar	encerrar/finalizar/acabar/abortar/cumprir/efetuar/suspender/finalizar/resolver/interromper/decidir/executar/concluir/desistir/realizar/acabar/aceitar/parar/abandonar/atingir
terminação	desaparecimento/demissão/assassinato/destruição/homicídio/devastação/morte
termino	desaparecimento/demissão/assassinato/destruição/homicídio/devastação/morte
terra	areia/florestas/arvoredo/selva/bosque/ilha/mata/floresta/planície/chão/campanha
terras	plantação/plantio/viveirodeplantas
terreno	campos/parque/praça/gramado/locação/sítio/campo/lugar
território	quadra/jazida/quarteirão/bloco/localidade/jurisdição/cena/bairro/refúgio/vizinhança
terror	pânico/medo/calafrio/tremedeira/tremura/arrepio/tremor
teto	abóbada
texto	missiva/melodia/carta/linha
tez	tintura/matiz/tom
thread	bisso
tinta	pigmento/pintura/cor/pigmentos/corante/pigmento/tintura/cor
tipo	variante/versão/espécie/variedade/género/estilo/classe
tirar	amputar/deletar/arrastar/resgatar/cavar/escavar/retirar/apagar/sacar/desempacotar/desentranhar/desmarcar/destripar/desventrar/desviscerar/esventrar/desmantelar/desprender/estripar/tossir/desalojar/eviscerar/pigarrear/descascar/escovar/retirar/tremer/remover/sacar/limpar
tiritar	tremelicar/estremecer/tremer
tocar	rodear/contornar/atirar/jogar/lançar/atritar/aderir/manejar/arranhar/manusear/manipular/chutar/colar/cobrir/bater
todo	artefato/soma/totalidade
tomar	bebericar/deglutir/ingurgitar/papar/fumar/sorver/beber/engolir/comer/agarrar/capturar/experimentar/provar/segurar/pegar/raptar/seqüestrar/sugar/chupar/sequestrar/beber/consumir/comer/capturar/usar/pegar
tomo	fatia/tira/anatomia/segmento/canto
topar	admitir/aceitar
topo	capitel
toque	agarrão/beijo/ósculo/colisão/pegada/contato/batida/pegar
torcer	acovardar/acovardar-se/debruçar/inclinar
tornar	descontrair/perecer/falecer/levantar-se/despertar/expirar/relaxar/decair/piorar/acordar/morrer/congelar/acalmar-se/carburar/ebulir/nascer/azedar/combustir/conflagrar/engordar/emagrecer/relaxar/acertar/assentar/esvaziar/fechar/estragar/ferver/retificar/acender/corrigir/abrir/estar/melhorar/encher/queimar/ficar
tornar-se	defletir/encarar/curvar/dobrar/derrubar/girar/virar
torneio	competição/corrida/combate/partida/jogo/luta/corrida
torre	minarete/farol
torres	minarete/farol
totalidade	unidade
trabalhador	criado/assalariado/ajudante/assistente/empregado/servidor/operário
trabalhar	laborar/exercer/ralar/servir
trabalho	assintência/chácara/granja/mão-de-obra/quinta/oficina/cuidado/publicação/sítio/edição/dever/projeto/tarefa/fazenda/obrigação/empenho/procedimento/central/esforço/investigação/operação
traje	farda/fardamento/uniforme/chapéu/vestuário/roupa/vestido
transação	comercialismo/mercantilismo/comércio
transferir	mandar/ceder/enviar/entregar/passar/dar/institucionalizar/internar/admitir/trocar/entregar/dar
transferência	entrega
transformar	martelar/forjar/trabalhar
transformação	melhoria/progresso
transgressão	pecado/crime/ofensa/imoralidade/adulteração/desonestidade/falsificação/maldade
transição	pulo/salto
transmissão	canaleta/canal
transmitir	indagar/mensurar/quantificar/redigir/agradecer/mandar/perguntar/saudar/escrever/apreciar/enviar/falar/dizer/gesticular/institucionalizar/telecomunicar/dialogar/proferir/dirigir-se/internar/compartilhar/exalar/manifestar/remeter/exprimir/verbalizar/conversar/demonstrar/despachar/informar/expressar/significar/admitir/indicar/mostrar/enviar/falar/dizer/passar
transmudar	trabalhar
transmutação	melhoria/progresso
transportar	carregar/aerotransportar/aviar/despachar/enviar
transporte	entrega
transtorno	doença
transubstanciar	trabalhar
traqueófitos	maconha/hidrófita/parreira/cipó/videira/erva
traseiro	pé
traslado	migração/precipitação/regresso/retorno/caçada/descensão/travessia/ascensão/avanço/locomoção/elevação/perseguição/progressão/aceleração/manobra/viagem
traspassar	perfurar/furar
tratar	amimar/mimar/mimosear/afagar/injustiçar/ironizar/desconsiderar/esnobar/maltratar/ignorar/menosprezar/zombar
traumatismo	fractura/fratura
travessia	etapa/jornada/caminhada/andada/passeio/viagem/parada
trazer	mandar/enviar/aviar/institucionalizar/internar/despachar/admitir/enviar
traçar	escrever
traço	bochecha/chinchilla/mento/testa/têmpora/queixo
treinamento	prática/exercício
treino	prática/exercício
tremer	estremecer/tremular/tiritar/tremelicar/estremecer/tiritar
tremular	tremelicar/estremecer/tiritar/tremer
tribo	genealogia/família
trilha	caminhos/senda/trilhos/trilho/caminho
tristeza	terpena/desgosto/amargura/mágoa/remorso/dor/pesar/desgosto/mágoa/dor/pesar
triunfo	estrondo/sucesso/sensação
trocar	permutar/vender
tronco	galho/ramo
trâmite	caminho
tubo	vaso
tumores	neoplasia/tumor
turba	leva/horda/tropa/legião/exército/multidão/massa
turista	estrangeira/visitante/visita/estrangeiro
turno	partida
táxon	espécie/espécies/espécie/filo/género/família/classe
técnica	arte/habilidade/sistema
têxteis	seda/algodão/crepe/mohair/pano/trama/malha/rede
tópico	narrativa/narração/significância/significação/matéria/assunto/tema/informação/significado/história/intenção/proposta/afirmação/aplauso/reconhecimento/declaração/área/aprovação
tórax	peito
ungulados	égua/cavalo/artiodáctilos/artiodátilos/equino/equídeo/perissodáctilos/ruminantes/artiodátilo/ruminante
unidade	molécula/peso/artefato/soma/totalidade/radical/cadeia
unificar	casar-se/mesclar/esposar/casar/combinar/juntar/misturar
unir	fixar/amarrar/atar/prender/acasalar/anilhar/copular/etiquetar/inserir/rotular/anexar/suplementar/grudar/colar/pregar/introduzir/juntar/prender/pegar
união	guilda/clube/federação/confederação/sociedade/conexão/ordem/ligação/consórcio/coalizão/coligação/gangue/sindicato/instituição/quadrilha/fusão/instituto/ligação
usar	experimentar
usina	casademoinho/fábrica/manufatura
uso	utilização/aplicação/desenvolvimento/exploração/jogar
utilização	aplicação/desenvolvimento/exploração/jogar
valor	merecimento/mérito/preços/virtude/preço/qualidade
valorizar	reconhecer
vara	clava/porrete
variar	adequar/adaptar/ajustar
variação	decréscimo/falecimento/dano/estrago/flutuação/avaria/prejuízo/surpresa/queda/diminuição/abatimento/morte/mudança/transmutação/nascimento/transformação/crescimento/transição/diferença/aumento/mudança
variedade	variante/versão
varão	garoto/moço/rapaz/menino/homem/garoto/moço/rapaz/sujeito/menino/cara/homem
vasilha	garrafa/biberão/botelha/frasco/banheira/garrafa
vasilhame	garrafa/biberão/botelha/frasco/banheira/garrafa
vaso	garrafa/biberão/botelha/frasco/banheira/garrafa
vegetal	epifitismo/epífito/traqueófitos/folhas
vegetação	chaparral/bosque/mata/floresta
venda	botica/drogaria/drograria/farmacia/farmácia
ver	fitar/prezar/respeitar/venerar/vislumbrar/espiar/encarar/contemplar/olhar/embasbacar/embasbacar-se/escrutinar/inspeccionar/revistar/valorizar/vistoriar/admirar/incluir/inspecionar/buscar/contemplar/gostar/apreciar/julgar/procurar/considerar/manter
verbalizar	cochichar/balbuciar/sussurrar/resmungar/murmurar/berrar/cantar/contar/falar/gritar/dizer/balbuciar/gaguejar/ladrar/bradar/proclamar/vociferar/discutir/murmurar/tagarelar/conversar/compor/reclamar/escrever/soltar/desejar/falar/dizer/representar
verdade	detalhe
verdura	folhas/vegetal
vergar	acovardar/acovardar-se/debruçar/inclinar
vergonha	ignomínia/desgraça
vertebrado	répteis/réptil/ave/pássaro/anfibios/anfíbios/mamífero/anfíbio
vestido	farda/fardamento/uniforme/chapéu/vestuário/traje/roupa
vestimenta	farda/fardamento/uniforme/chapéu/vestuário/traje/roupa/vestido
vestir	caber/experimentar/pôr/usar/trocar/colocar/mudar
vestir-se	caber/vestir/pôr/usar/trocar/colocar/mudar
vestuário	farda/fardamento/saia/uniforme/camisa/fato/terno/traje/vestido/chapéu/sobretudo/traje/roupa/vestido
veículo	ambulancia/taxi/ambulância/táxi/viatura/calhambeque/jipe/sedan/sedã/carro
via	alameda/rodovia/entrada/estrada/caminho/abordagens/avenida/trilha/acesso/passagem/estrada/caminho
viagem	passeio/etapa/jornada/caminhada/excursão/andada/passeio/parada
viajante	estrangeira/visitante/visita/estrangeiro
viajar	engatinhar/gatinhar/rastejar/rastejar-se/serpear/vadiar/vagabundear/vaguear/boiar/pisar/ascender/escorregar/nadar/errar/perambular/vagar/deslizar/voar/apressar/acompanhar/atravessar/caminhar/dirigir/correr/seguir/ir/andar/subir/passar/apressar-se/despachar-se/esquiar/cavalgar/progredir/avançar/perambular/perseguir/vagar/acelerar/rodar/voar/apressar/descer/montar/prosseguir/baixar/circular/espalhar/vir/continuar/seguir/ir/andar/passar/cair
vianda	corte
viatura	ambulancia/taxi/ambulância/táxi/calhambeque/jipe/sedan/sedã/carro
victimizar	iludir/lograr/calotear/defraudar/trapacear/enganar
victimização	colonialismo
vinda	regresso/volta/retorno/ingresso/entrada
vir	acercar/avizinhar/chegar/acostar/cumprimentar
virar	descontrair/perecer/falecer/levantar-se/despertar/expirar/relaxar/decair/piorar/acordar/morrer/congelar/acalmar-se/carburar/ebulir/nascer/azedar/combustir/conflagrar/defletir/engordar/emagrecer/relaxar/acertar/assentar/encarar/esvaziar/fechar/rodar/tornar/curvar/estragar/ferver/retificar/acender/corrigir/dobrar/abrir/derrubar/estar/girar/melhorar/encher/queimar/ficar
virar-se	defletir/encarar/curvar/dobrar/derrubar/girar/virar
virtude	honestidade/justiça
visita	visitante/companhia
visitante	visita/companhia
vitimar	iludir/lograr/calotear/defraudar/trapacear/enganar
vitória	independência
viver	alojar/morar
vulgo	ralé
vão	greta/racha/fresta/fissura/fenda/rasgão/rasgo/boca/buraco/fenda
zanga	fúria/ira/cólera/raiva
zangar	abespinhar/encolerizar/exasperar/irar/enfurecer
zombar	mangar/pagodear/zoar/rir/ridicularizar/sacanear
zona	ilha
zumbir	enxamear/formigar/pulular
água	charco/poça/córrego/lago/corrente/mar
álcool	brandy/conhaque
ápice	alcance/auge
árbitro	magistrado/jurista/juiz
área	quadra/tumba/jazida/quarteirão/túmulo/sepultura/bloco/zona/paragem/localidade/cena/esconderijo/refúgio/parada/ponto
ânsia	temor/medo/preocupação
égua	cavalo
época	velhice/idade/infância/puberdade/era/idade/dia/período
êxito	estrondo/sucesso/sensação
índole	temperamento/disposição
ódio	inimizade/ressentimento/hostilidade/repulsa/aversão
órgão	caule/folhagem/ala/raíz/asa/raiz/tronco/língua/folha/cristalino/genitália/genitália/víscera/lente
