aba	fronteira/limite
abalo	emoção/sentimento/impressão
abastecimento	atividade/ocupação
abatimento	alteração/modificação/variação/mudança
abdome	anatomia
abdómen	anatomia
abdômen	anatomia
abelha	himenópteros
abertura	artefato
abjuração	negação
abominação	aversão
abordagens	via/estrada/caminho
abrigo	edifício/tecido/estrutura
abside	nicho
abstinência	auto-monitorização/auto-controle
abstracto	conceito/concepção/idéia/ideia
abstracção	conceito/concepção/idéia/ideia
abstrato	conceito/concepção/idéia/ideia
abstração	entidade
absurdidade	bobeira
abuso	maltrato
abóbada	telhado/teto
acadêmico	educacionista/pedagogo/educador
acampamento	alojamento/abrigo/casa/reunião
acampamentos	reunião
aceleração	traslado/deslocamento/movimento
acendedor	aparato/dispositivo/aparelho/equipamento/mecanismo/instrumento/ferramenta
aceno	sinal/inclinação
acesso	via/estrada/caminho
acidente	ocorrente/ocorrência/acontecimento/azar
acolhimento	aquisição
acompanhamento	inspecionar/examinar
acontecimento	ocorrente/ocorrência/evento/fato
acordo	concórdia/harmonia/paz/conformidade
acrescentamento	quantidade/número
acta	ato
actividade	situação/condição/estado
actor	intérprete
actualidade	tempo
acumulação	ganancia/acúmulo/rendimento/aumento
acção	feito/ato/ação/acontecimento/evento/fato/situação/condição/estado
acúmulo	colecção/coleção/aglomeração/agrupação/acumulação/conjunto/aumento/grupo
adepto	seguidor
aderência	apoio/suporte
adesão	apoio/suporte
adiar	ociosidade
adição	componente/parte
adjudicator	alguém/indivíduo/alma/pessoa
administrador	líder/gerente/cabeça/chefe/liderança/responsável
administração	gestão/comunidade/grupo
admiração	emoção/sentimento/impressão
adoração	atividade/ocupação
adorno	artefato
adoçante	aromatizante/condimento/tempero
adro	praça
adulteração	delito/transgressão
adversário	competidor/contendor
advogado	alguém/indivíduo/alma/pessoa/profissional
aeronave	navio
aeroplano	navio
aeroporto	infra-estrutura/instalação/aeródromo
aeródromo	infra-estrutura/instalação/aeroporto
afastamento	indiferença/apatia
afecção	emoção/sentimento/impressão
afeição	abalo/comoção/emoção/sentimento/camaradagem/objecto/simpatia/emoção/objeto/sentimento/compaixão/objetivo/piedade/impressão
afete	emoção/sentimento/impressão
afetividade	emoção/sentimento/impressão
afeto	emoção/sentimento/impressão
afiguração	criação
afinidade	conexão/relação
afirmação	mensagem/tópico/assunto/conteúdo
aflição	problema
afronta	desfeita/ofensa/injúria
afã	apetite/pretensão/anseio/desejo
agarrão	contato/toque
agencia	empresa
agente	representante
agitação	mudança
aglomeração	colecção/coleção/acúmulo/agrupação/conjunto/grupo
agouro	mensagem/comunicação
agradecimento	reconhecimento
agregação	agrupamento
agressão	acção/atividade/ato/ação
agricultura	cultivo
agrupamento	atividade/ocupação
agrupação	abstração
agudez	inteligência
agudeza	inteligência
agulha	implemento/instrumento/ferramenta
agência	empresa
aia	médico
ajuda	dádiva/auxílio/brinde/dom/socorro/doação/assistência/presente/atividade/ocupação
ajudante	trabalhador
ajustagem	calibração
ajuste	mudança
ala	órgão
alameda	via/estrada/caminho
albergaria	hotel
albergue	alojamento/hotel/abrigo/casa
alcance	grandeza/magnitude/número/ápice/nível/fase/grau
alcantilado	formação
alcar	propulsão/impulsão
aldeia	municipalidade/município/comunidade
alegria	abalo/comoção/espírito/emoção/prazer/sentimento/humor/emoção/sentimento/impressão
aleta	membro
alfaia	mobília/mobiliário/móvel
alga	protoctista/prototista
algas	protoctista/prototista
algibeira	bolsa
algodão	arvoreta/têxteis/arbusto/mato/moita/pano/tecido/fazenda
alguém	causador/causa/organismo/ser
aliança	organização/coalizão/coligação/fusão
alicerce	base
alimentação	nutriente/comida/alimento
alimento	nutriente/comida/substância
alimentos	nutriente/comida/alimento
alinhamento	ajustagem/reajuste/regulação
alma	causador/causa/espirito/organismo/ser
almofada	enchimento
alojamento	edifício/tecido/estrutura
alpendre	edifício/tecido/estrutura
alteração	ocorrente/ocorrência/acontecimento/mudança
alternativa	decisão
altitude	amplidão/dimensão/magnitude/extensão
altivez	certeza/segurança
altura	amplidão/dimensão/magnitude/extensão
alturas	região
aluno	alguém/indivíduo/alma/pessoa/seguidor/estudante
alvorecer	início/começo/princípio
alça	apêndice
ama-seca	médico
amabilidade	acção/atividade/ato/ação
amado	alguém/indivíduo/alma/pessoa
amanhecer	início/começo/princípio
amante	alguém/indivíduo/alma/pessoa/amado
amargura	desgosto/mágoa/tristeza/dor/pesar
ambiente	regiões/situação/condição/região/região
ambição	apetite/pretensão/anseio/disposição/desejo
ambulancia	auto/automóvel/viatura/carro/veículo
ambulância	auto/automóvel/viatura/carro/veículo
ameaça	causador/causa
amiga	alguém/indivíduo/alma/pessoa
amigo	alguém/indivíduo/alma/pessoa/amiga/camarada/conhecido/amizade
amizade	alguém/indivíduo/alma/pessoa/relação/ligação
amo	alguém/indivíduo/alma/pessoa
amor	abalo/comoção/emoção/sentimento/amado/objecto/emoção/objeto/sentimento/amante/objetivo/impressão
amostra	instância/exemplo/representante
amparo	atividade/ocupação/proteção/capa
amplidão	grandeza/magnitude/número
analgésico	medicamento/remédio
analgésicos	medicamento/remédio
anatomia	tomo/secção/porção/pedaço/parte
anca	anatomia
ancestral	parente
andada	feito/conquista/façanha/realização/travessia/viagem
andar	edifício/tecido/estrutura
anedota	contas/reporte/relato/relatório
anelo	apetite/pretensão/anseio/desejo/saudade/anseio/desejo
anexo	adição/melhoria
anfibios	vertebrado
anfitrião	adulto/organismo/ser
anfíbio	vertebrado
anfíbios	vertebrado
angústia	emoção/sentimento/impressão
anilhagem	ruído/som
animal	organismo/ser
animação	existência/existência/atividade/ocupação/ser
anjo	espirito
ano	etapa/tempo/período/reunião
anoitecer	jornada/dia
anomalia	alguém/indivíduo/alma/pessoa
anseio	apetite/pretensão/desejo/emoção/sentimento/impressão
ansiedade	abalo/comoção/emoção/sentimento
antecessor	parente
antenome	prenome/nome
antepassado	antecessor/ancestral/parente
anúncio	mensagem/comunicação
aparato	equipamento/ferramenta/apetrecho/equipamento/instrumento
aparelhador	alfaia/movéis/mobília/mobiliário/móvel
aparelho	equipamento/ferramenta/aparato/apetrecho/dispositivo/equipamento/mecanismo/instrumento/ferramenta
apartamento	alojamento/abrigo/casa
aparência	semblante/aspecto/semblante/qualidade/rosto
apatia	indiferença
apego	emoção/sentimento/impressão
apelido	antenome/prenome/nome
apelo	requerimento/requisição/solicitação/pedido/petição
apetite	emoção/sentimento/impressão
apetrecho	artefato
aplauso	mensagem/tópico/assunto/conteúdo
aplicação	uso/utilização
apodrecimento	atividade/ação
apoio	auxílio/socorro/ajuda/assistência/aparato/dispositivo/aparelho/equipamento/mecanismo/instrumento/ferramenta
aposento	alojamento/abrigo/casa
aposta	recreaçao/imoralidade/diversão
apresentação	entretenimento/diversão/entreterimento/divertimento
aprovação	mensagem/tópico/assunto/conteúdo
aprumo	certeza/segurança
aptidão	capacidade/poder/habilidade/talento
apêndice	porção/parte
apóstolo	seguidor
aquecedor	aparato/dispositivo/aparelho/equipamento/mecanismo/instrumento/ferramenta
aquecedores	aparato/dispositivo/aparelho/equipamento/mecanismo/instrumento/ferramenta
aquecimento	instalação
aquisição	acção/feito/ato/ação
aracnideos	artropode/artrópode/artrópodes
aracnídeo	artropode/artrópode/artrópodes
aracnídeos	artropode/artrópode/artrópodes
arcano	informação
arco	curva/edifício/tecido/estrutura/faixa/linha
arco-íris	arco
areia	solo/terra
arena	edifício/tecido/estrutura
argumentação	ideia/raciocinio/razoamento/raciocínio
aridez	estado/situação/condição/estado
arma	aparelho/armamento/instrumento/ferramenta/convencimento/persuasão/apetrecho/catequizar/equipamento/instrumento
armamento	aparelho/instrumento/ferramenta/apetrecho/equipamento/instrumento
armazenamento	colocação/depósito
armário	alfaia/movéis/mobília/mobiliário/móvel
aroma	odor/cheiro
aromatizante	ingrediente
arpão	implemento/instrumento/ferramenta
arquitectura	constituição/composição/estrutura
arraial	municipalidade/município
arranjo	agrupação/conjunto/grupo
array	arranjo
arrepio	consternação/temor/terror/medo
arte	meta/ofício/técnica/profissão/ocupação/criação/emprego/função/habilidade/talento/serviço/trabalho/lugar/criação
artefato	todo/unidade
articulação	anatomia/ligação
articulações	anatomia
artigo	informação/artefato/bens/não-ficção/mercadoria/peça/fazenda/produto/bem
artiodáctilos	ungulados
artiodátilo	ungulados
artiodátilos	ungulados
artista	alguém/indivíduo/alma/intérprete/pessoa/creador/criador/criativo
artropode	invertebrados/invertebrado
artrópode	invertebrados/invertebrado
artrópodes	invertebrados/invertebrado
arvoredo	chão/relevo/solo/terra/bioma/biomas
asa	adição/melhoria/órgão
ascendencia	estado/situação/condição/estado
ascendência	número
ascensão	traslado/deslocamento/movimento
ascenção	mudança
asco	aversão
asilo	edifício/tecido/estrutura
aspecto	semblante/aparência/qualidade
aspiração	apetite/pretensão/anseio/disposição/desejo
aspirina	analgésicos/analgésico
assalariado	trabalhador
assalto	atentado/ataque
assassinato	termino/terminação/homicídio/conclusão
assassínio	homicídio
assembleia	reunião
assembléia	legislatura/reunião
assentamento	comunidade/grupo
assento	alfaia/movéis/mobília/mobiliário/móvel/cadeira
asserção	afirmação/declaração
assessoramento	proposta
assintência	tarefa/trabalho
assistente	trabalhador
assistência	auxílio/socorro/ajuda/atividade/ocupação
associado	pário/igual/par
associação	organização/comunidade/memória/grupo
assunto	mensagem/comunicação/mensagem/tópico/conteúdo/coisa
astucidade	inteligência
astúcia	inteligência
ataque	manobra/operação/aflição
atitude	cognição/noção/conhecimento/compreensão
atividade	feição/peculiaridade/acção/feito/ato/ação/situação/condição/estado
atleta	competidor/contendor
ato	acção/feito/ação/atuação/acontecimento/evento/fato/representação/interpretação
ator	intérprete
atrapalhação	acção/feito/ato/ação/obstrução/impedimento/obstáculo
atraso	ociosidade
atribuição	activos/ativos/bens/recursos/ativo
atributo	conceito/concepção/idéia/ideia/abstração/predicado/característica/propriedade
atrito	recontro/confronto/conflito
atuação	espectáculo/show/atividade/ocupação
audiência	oportunidade/chance/gente/povo/massa
audiências	reunião
auge	ápice/nível/fase/grau
aula	didáctica/ensinamento/ensino/pedagogia/educação/instrução/formação/reunião
aumento	acrescentamento/alteração/modificação/variação/mudança/quantidade/número
auspício	endosso
ausência	necessidade/carência/falta
auto-estima	emoção/sentimento/impressão
autonomia	independência/liberdade
autor	comunicador
autoridade	alguém/especialista/indivíduo/alma/pessoa/livro
autorização	gestão/administração
autóctone	alguém/indivíduo/alma/pessoa
auxílio	atividade/ocupação
aval	declaração/garantia
avaliador	autoridade
avaliação	critica/juízo/julgamento
avanço	traslado/deslocamento/movimento
avaria	alteração/modificação/variação/mudança
ave	vertebrado
avenida	via/rodovia/estrada/caminho
aventura	projeto/tarefa
aventurança	causador/causa
aversão	abalo/comoção/emoção/sentimento/ódio/emoção/sentimento/impressão
avião	navio
avó	avós/antepassado/avô
avós	antepassado
avô	avós/antepassado/avó
azar	fenómeno/fenômeno/problema
aço	liga
açoite	aparelho/instrumento/ferramenta
ação	acção/feito/ato/acontecimento/evento/fato/situação/condição/estado
açúcar	adoçante
bagunça	situação/condição/estado
baile	recreaçao/diversão
bairro	circunscrição/comarca/districto/distrito/território/domínio/comunidade
baixada	depressão
bala	petisco/guloseima/doce
balada	acontecimento/festa
balcão	edifício/tecido/estrutura
balsa	batel/bote/escaler/barco
bancarrota	insolvência
banda	anatomia/artefato
banheira	vasilhame/vasilha/vaso
banheiro	aposento/quarto/sala
bar	aposento/quarto/sala
baralho	pacote
barbatana	membro
barca	batel/bote/escaler/barco
barcaça	batel/bote/escaler/barco
barco	batel/embarcações/bote/embarcação/escaler/navios/navio
barra	implemento/obstrução/impedimento/instrumento/ferramenta/obstáculo
barraca	asilo/refúgio
barranco	elevação
barreira	obstrução/impedimento/obstáculo
barriga	anatomia
base	encosto/apoio/suporte/flanco/pressuposição/suposição/informação/conhecimento/hipótese/número
bastão	implemento/instrumento/ferramenta
batalha	esforço/tentativa/combate/empenho/conflito/esforço/luta
bateira	batel/bote/escaler/barco
batel	embarcações/embarcação/navios/navio/barco
baterpalmas	ruído
batida	proeza/feito/façanha/contato/ruído/toque/som/realização
batismo	sacramento
bebida	nutriente/comida/alimento/porção/líqüido
bebé	criança/filho/menino
bebê	criança/filho/projeto/tarefa/menino
beijo	contato/toque
beira-mar	orla/costa/litoral
belas-artes	criação
beleza	semblante/aspecto/aparência
bem	possessão/propriedade/artefato/conexão/relação
benefício	vantagem/virtude/propriedade/recurso/bem
bens	artefato/criação
benzina	carburante/combustível/hidrocarboneto
besta	organismo/ser
biberão	vasilhame/vasilha/vaso
biblioteca	colecção/aposento/coleção/aglomeração/acúmulo/quarto/sala
bicha	formação
bicho	organismo/ser
bigorna	bloco
biografia	crónica/crônica
biologia	colecção/coleção/aglomeração/acúmulo
biota	colecção/coleção/aglomeração/acúmulo
bisbilhotice	contas/reporte/relato/relatório
bisbolhetice	contas/reporte/relato/relatório
bisso	thread/fibras/fibra
bloco	colecção/coleção/aglomeração/acúmulo/artefato/sólida/território/ambiente/área/região/sólido
bloqueio	incapacidade
bobagem	equívoco/engano/falha/erro
bobeira	feição/peculiaridade
boca	orifício/vão/fenda
bochecha	traço
boda	cerimónia/cerimônia/festa
bola	brinquedo/aglomeração
bolo	fornada
bolor	fungo/fungos
bolsa	contentor/contêiner/sacola/recipiente/saco
bolso	bolsa
bomba	armamento/munição/arma
bombardeio	ataque
bondade	acção/atividade/ato/ação
boneca	brinquedo
boneco	brinquedo
booker	agente
borda	fronteira/limite/fronteiras/linha/fronteira/limite
bordado	criação
bosque	flora/vegetação/chão/relevo/solo/terra/bioma/biomas
bota	calçados/calçado
bote	embarcações/embarcação/navios/navio/barco
botelha	vasilhame/vasilha/vaso/conteúdo
botica	boutique/loja/venda
boutique	shopping
bovídeos	ruminantes/ruminante
brandy	álcool
brejos	planície/campanha
brincadeira	recreaçao/diversão
brinde	aquisição
brinquedo	artefato
brocha	implemento/instrumento/ferramenta
broker	empresário
broto	departamento/divisão
bumbum	anatomia
bunda	anatomia
buraco	furo/vão/abertura/fenda
burgo	municipalidade/município
burguesia	estrato/classe
busca	inspecionar/examinar
buscar	atividade/ocupação
bênção	reza/oração/petição
cabeça	cognição/líder/noção/chefe/conhecimento/compreensão
cabimento	intercorrência/opção/alternativa/eleição/escolha
cabo	apêndice
cache	cobre/divisa/moeda/dinheiro
cachimbo	aqueduto/conduto/ducto/duto/canal
cadeia	unidade
cadeira	alfaia/movéis/mobília/mobiliário/assento/móvel
cadáver	defunto/morto/corpo
café	bebida
caimento	maneira/estilo
cais	porto
caixa	contentor/contêiner/recipiente
calafrio	consternação/temor/terror/medo
calceteiro	artefato
calculadora	maquinaria/máquina
calefacção	instalação
calefação	instalação
calendário	estrutura/sistema/organização/ordem
calhambeque	auto/automóvel/viatura/carro/veículo/disfemismo
calibração	atividade/ocupação
caligrafia	escrita
calmante	medicamento/remédio
calor	energia
calçado	calçados/cobertura/capa
calçados	cobertura/capa
camada	cobertura/região/capa
camarada	alguém/indivíduo/alma/pessoa/amiga/conhecido/amizade/amigo
camaradagem	emoção/sentimento/impressão
camarilha	círculo/grupo/ordem
cambada	reunião
caminhada	travessia/locomoção/viagem
caminho	trâmite/conduta/via/rodovia/corrente/curso/estrada/artefato/efetuação/implementação/acção/via/trilha/atividade/ato/execução/ação/realização/estrada/fronteira
caminhos	trilha/estrada/caminho
camisa	vestuário/roupa
campanha	chão/relevo/manobra/solo/operação/terra
campo	infra-estrutura/instalação/gleba/terreno/conhecimento/região/saber
campos	gleba/terreno/região
camuflagem	envólucro/cobertor/cobertura/capa/ocultação
camundongo	roedor
canais	aqueduto/conduto/ducto/duto/canal
canal	aqueduto/conduto/transmissão/ducto/duto
canaleta	transmissão
cancelamento	anulação
candeeiro	alfaia/movéis/mobília/mobiliário/móvel/luminaria/luminária
candelabro	luminaria/luminária
canela	anatomia
cano	aqueduto/conduto/ducto/duto/canal
canoa	barco
canto	tomo/secção/porção/pedaço/parte/lugar
canídeo	carnívoro
capa	artefato/cobertura
capacho	tapete
capacidade	cognição/noção/conhecimento/compreensão
capataz	orientador/supervisor
capialço	abertura
capital	activos/ativos/bens/recursos/ativo/divisa/moeda/dinheiro
capitalista	alguém/indivíduo/alma/pessoa
capitel	topo
capitulação	derrota/perda
cara	alguém/indivíduo/alma/pessoa/varão/macho/homem
caracter	grafema/letra
caracterização	atuação/descrição/representação/interpretação
característica	conceito/atributo/concepção/idéia/propriedade/qualidade/ideia/abstração/qualidade
caractér	grafema/letra
caramelo	bala/doce
caraterização	descrição
carburante	substância
carga	mercadoria/produto/artigo
cargo	ofício/profissão/ocupação/emprego/função/serviço/trabalho/lugar
carinho	emoção/sentimento/impressão
carne	comida
carneiro	bovídeos
carnívoro	mamífero
carpete	tapete
carregamento	mercadoria/produto/artigo
carro	auto/automóvel/viatura/veículo
carta	texto/papel/documento
cartaz	anúncio
cartão	papel
carácter	grafema/letra
caráter	feição/peculiaridade
carência	estado/necessidade/situação/condição/estado
casa	endereço/morada/alojamento/aposento/moradia/prédio/domicílio/locação/residência/edifício/localização/abrigo/habitação/tecido/estrutura/lar/ponto/lugar
casaco	sobretudo
casademoinho	fábrica/usina/planta
casadeoração	prédio/edifício
casal	família
casamento	cerimónia/rito/cerimônia/ritual/festa/família
casco	pe/pata
caso	interesse/preocupação/ocorrente/ocorrência/circunstância/acontecimento
castelão	governante/governador
catedrático	acadêmico/professor
categoria	colecção/conceito/coleção/aglomeração/concepção/idéia/acúmulo/família/ideia/classe
catequizar	comunicado/comunicação
cativo	desafortunado/desventurado/infortunado
caule	órgão
causa	acção/feito/ato/ação/gênese/iniciação/origem/começo
causalidade	acção/feito/ato/ação
cavalheiro	homem
cavalo	égua/equino/equídeo/ungulados/macho
cave	pavimento/piso/andar
caça	criatura/animal/besta/bicho/ser
caçada	traslado/deslocamento/movimento
cefaleia	sintoma
celebração	acontecimento/festa/recreaçao/diversão
celebridade	honra
celenterados	invertebrados/invertebrado
cena	situação/condição/território/ambiente/área/região
central	laboratório/oficina/emprego/trabalho
centro	prédio/edifício/lugar
centúria	etapa/tempo/período
cenário	situação/condição
cerca	barreira/obstáculo
cereal	alimento
cerimónia	acontecimento/festa
cerimônia	acontecimento/festa/atividade/ocupação
cerque	região
certeza	convicção/crença/fé/opinião/segurança/qualidade
cesta	contentor/contêiner/recipiente
cesto	contentor/contêiner/recipiente/conteúdo
chance	oportunidade/existência/existência/possibilidade/ser
chapa	organização/artefato
chaparral	flora/vegetação
chapéu	vestimenta/vestuário/traje/fragmento/roupa/vestido/parte
charco	água
charneca	planície/campanha
chave	aparato/dispositivo/aparelho/equipamento/mecanismo/instrumento/ferramenta
chefe	alguém/líder/orientador/supervisor/indivíduo/alma/pessoa
chegada	acção/atividade/ato/ação
cheiro	atributo/percepção/propriedade
chibata	aparelho/instrumento/ferramenta
chicote	aparelho/instrumento/ferramenta
chilro	ruído/som
chinchilla	traço
chocolate	comida
choque	estupefação
chumbo	metal/metais
chute	porrada/golpe/esforço/tentativa
chuva	precipitação
chá	bebida
chácara	laboratório/oficina/emprego/trabalho
chão	relevo/objeto/solo/terra
ciclomotor	moto/mota/motocicleta
cidade	municipalidade/município
cidadã	súdito/cidadão
cidadão	alguém/indivíduo/alma/pessoa/súdito
cientista	alguém/indivíduo/alma/pessoa
cilindro	sólida/sólido
cimeira	reunião
cimento	materiais
cineasta	produtores/produtor
cinema	espectáculo/show/bens/produto/produção
cio	apetite/pretensão/anseio/desejo
cipó	traqueófitos
circulação	colecção/coleção/aglomeração/acúmulo
circunscrição	regiões/região
circunstância	estado/situação/condição/estado/ambiente/informação/conhecimento
circunstâncias	estado
ciência	disciplina/campo/domínio/conhecimento/saber
classe	colecção/status/conceito/coleção/aglomeração/categoria/concepção/idéia/acúmulo/população/condição/estado/gente/pessoal/família/ideia/povo/jogo/grupo/posição/taxon/taxón/táxon/categoria/espécies/raça/género/tipo/reunião
clava	bastão/pau/vara
clientela	população/gente/pessoal/povo
clube	prédio/associação/edifício/sociedade/união/organização/ordem
coalizão	organização/estado/união/ligação
cobertor	cobertura/capa
cobertura	artefato/capa
cobre	metal/metais/condutor
cobres	divisa/moeda/dinheiro
coerência	conexão/ligação
coesão	conexão/ligação
cognome	antenome/prenome/nome
coincidência	ocorrente/ocorrência/acontecimento
coisa	abstracção/entidade/ocorrente/abstracto/ocorrência/abstrato/acção/acontecimento/atividade/ato/ação
coisas	objeto
colapso	enfermidade/doença/ocorrente/ocorrência/acontecimento
colarinho	abertura/faixa
colectas	imposto
colecção	agrupação/conjunto/grupo
colega	amiga/camarada/conhecido/amizade/amigo
coletânea	publicação/edição
coleção	publicação/edição/agrupamento/agrupação/conjunto/grupo
colheita	rendimento
coligação	organização/estado/união/ligação
colina	elevação
colisão	toque
colocação	acumulação/acúmulo/atividade/ocupação
colonialismo	victimização/exploração
colorante	materiais
colégio	prédio/edifício
colônia	comunidade/grupo
comarca	regiões/região
combate	certame/concurso/competição/torneio/partida/batalha/jogo/boxe/pugilismo/conflito/luta
combinação	colecção/coleção/aglomeração/acúmulo/cáculo/operação
combustível	substância
comensalismo	organismo/ser
comentário	afirmação/declaração
comercialismo	transação
comerciante	empresário
comestivel	nutriente/comida/alimento
começo	ocorrente/ocorrência/acontecimento/instante/início/princípio/momento
comida	nutriente/alimento/substância
comissão	organização
comité	organização/ong
comitê	organização/ong
comoção	emoção/sentimento/impressão
compactação	compressão/pressão
compaixão	camaradagem/simpatia/emoção/sentimento/piedade/impressão
companheiro	parente/cara-metade/amiga/camarada/conhecido/amizade/amigo
companherismo	amizade
companhia	visitante/estabelecimento/instituição/visita/instituto/organização/corpo
comparação	inspecionar/conexão/examinar/relação
compensação	recompensa
competidor	alguém/indivíduo/alma/pessoa/contendor
competição	certame/concurso/torneio/partida/jogo
componente	conceito/categoria/concepção/idéia/porção/ideia/parte/porção/parte
comportamento	feição/peculiaridade/actividade/acção/atividade/ocupação/ação
compositor	musico/músico
composição	espaçamento/posição/atributo/criação/propriedade
compressão	prensada/pressão
computador	maquinaria/máquina
compêndio	publicação/edição
comunicado	acção/feito/ato/ação
comunicador	alguém/indivíduo/alma/pessoa
comunicação	acção/feito/ato/ação/abstração
comunidade	reunião
comércio	comercialismo/mercantilismo/transação
concavidade	sólida/sólido
conceito	idéia/pensamento/opinião
concentração	atenção/assembléia/reunião/crescimento/aumento
concepção	conceito/idéia/pensamento/opinião/criatividade/início/começo/princípio
concerto	atuação
concertos	atuação
concha	carapaça
conclusão	seção/parte
concorrente	competidor/contendor
concupiscência	apetite/pretensão/anseio/desejo
condado	região
condimento	aromatizante/ingrediente/tempero
condição	atributo/predicado/característica/situação/estado/propriedade
conduta	feição/peculiaridade/acção/atividade/ocupação/ato/ação
condutas	aqueduto/conduto/ducto/duto/canal
conduto	aqueduto/ducto/duto/canal
condutor	materiais
conector	apetrecho/equipamento/instrumento
conexão	conhecida/conhecido/amizade/amigo/abstração/provedor/fornecedor/estado/união/memória/ligação
confederação	coalizão/coligação/fusão/união
conferência	reunião
confiança	convicção/crença/fé/opinião
configuração	esquema/plano
confirmação	evidência
conflito	peleja/pugna/disputa/combate/batalha/luta/situação/condição/estado
conforto	estado/prazer/situação/condição/estado/socorro/ajuda/assistência
confronto	resistência/situação/condição/estado
conhaque	álcool
conhecida	alguém/indivíduo/alma/pessoa
conhecido	alguém/indivíduo/alma/pessoa
conhecimento	cognição/noção/compreensão/compreensão
conjunto	colecção/coleção/aglomeração/acúmulo/abstração
conjuntura	ocorrente/ocorrência/acontecimento
conquista	acção/atividade/ato/ação
consagração	santificação
consciência	compreensão
conselho	proposta
consenso	concórdia/harmonia/paz/conformidade/acordo
consequência	fenómeno/fenômeno
conseqüência	fenómeno/fenômeno/placar/resultado
conserto	melhoramento/melhoria
consideração	informação/conhecimento
consolação	socorro/ajuda/assistência
consolo	socorro/ajuda/assistência
consorte	parente/cara-metade
consternação	abalo/comoção/emoção/sentimento
constituição	leis/atributo/início/lei/começo/propriedade
constructor	contratador
construtor	contratador
construção	edificação
consulta	acção/atividade/ato/ação
consumidor	utente/utilizador/usuário
consumo	demanda/pedido/atividade
consórcio	associação/sociedade/união/organização/ordem
conta	número
contagem	número
contas	informação
contato	interação/acção/feito/ato/ação/toque
contendor	alguém/indivíduo/alma/pessoa/competidor
contentor	apetrecho/equipamento/instrumento
contexto	ambiente
conteúdo	mensagem/comunicação/coisa
continuidade	etapa/tempo/período/coerência/coesão/ligação
contrapeso	edifício/tecido/estrutura
controle	estado/situação/condição/estado/fiscalização/inspecção/vistoria/atividade/inspeção/ocupação/habilidade/teste
controlo	atividade/ocupação
controvérsia	desacordo/discordo/discrepância/discórdia/discordância
contêiner	apetrecho/equipamento/instrumento
contínuo	tempo
convencimento	comunicado/comunicação
convergência	ocorrente/ocorrência/acontecimento
conversa	debate/idioma/discussão
conversação	idioma
conversão	mudança
convexidade	sólida/sólido
convicção	crença/fé/opinião
convite	missiva/carta/requerimento/requisição/solicitação/pedido/petição/apelo
coorte	população/gente/pessoal/povo
copo	contentor/contêiner/recipiente
coque	carburante/combustível
cor	materiais/camada/capa/colorante/corante/tinta
corante	materiais/colorante/tinta/cor
corcova	edifício/tecido/estrutura
corda	artefato/fio/linha
cordados	criatura/animal/besta/bicho/ser
cordialidade	gosto/afeição
cordilheira	formação
corpo	defunto/cadáver/morto/exército/anatomia
correio	mensagem/comunicado/comunicação
correios	comunicado/comunicação
corrente	acção/água/atividade/ato/ação
corretor	empresário
correção	melhoramento/melhoria
corrida	certame/concurso/competição/torneio/partida/jogo/locomoção
corte	vianda/carne/assembleia/assembléia/maneira/abertura/estilo
cortina	mobília/mobiliário/móvel/proteção/capa
costa	orla/litoral/formação
costas	anatomia
costume	hábito/atividade/ocupação/emprego/hábito
cozedura	carburante/combustível
cozinha	aposento/quarto/sala/culinária/preparação
creador	alguém/indivíduo/alma/pessoa
creme	lacticínio/laticínio
crepe	têxteis/pano/tecido/fazenda
crescimento	alteração/modificação/variação/mudança
cria	criatura/animal/besta/bicho/ser
criado	trabalhador
criador	alguém/indivíduo/alma/pessoa
criancinha	criança/filho/menino
criança	alguém/descendência/indivíduo/alma/descendente/filho/pessoa/juvenil/menor/jovem
criatividade	capacidade/poder/habilidade/talento
criativo	alguém/indivíduo/alma/pessoa
criatura	alguém/indivíduo/alma/pessoa/organismo/ser
criação	artefato/atividade/início/ocupação/começo/princípio/produção
crime	ofensa/transgressão
crise	conjuntura/ocasião/ponto
cristal	sólida/sólido
cristalino	órgão
critica	acção/feito/ato/ação
crustáceo	artropode/artrópode/artrópodes
crustáceos	artropode/artrópode/artrópodes
cruz	edifício/tecido/estrutura
crédito	débito/dívida/dívidas/dívida/activos/ativos/bens/recursos/ativo
crónica	registro
crônica	registro
cubo	sólida/sólido
cuidado	protecção/proteção/endosso/tarefa/trabalho
culinária	cozinha/preparação
culpa	estado/situação/condição/estado
cultivo	produção
cultura	ontogenia/ontogénese/crescimento
curso	didáctica/ensinamento/itinerário/itinerários/percurso/rota/ensino/pedagogia/educação/instrução/formação/linha/estrada/caminho/rumo/direcção/acção/colocação/direção/localização/sequência/série/atividade/ato/ação/reunião/fronteira/posição
curva	segmento/seção/linha
curvas	linha
curvatura	contorno
custo	despesa/gasto/activos/ativos/gastos/bens/recursos/custos/preços/ativo/preço/qualidade
custos	despesa/gasto/preços/preço/qualidade
custódia	confinamento
cáculo	cálculo
cálculo	critica/juízo/procedimento/processo/julgamento
cárie	apodrecimento/putrefação/deterioração/decomposição
cão	carnívoro
célula	organismo/ser
cérebro	inteligência
céu	superfície/ar/atmosfera/região
cólera	abalo/zanga/comoção/ira/emoção/sentimento/raiva
cómoda	alfaia/movéis/mobília/mobiliário/móvel
cónjuge	parente/cara-metade
cópia	afiguração/representação/imagem/figura/ilustração/desenho
córrego	água
cômoda	alfaia/movéis/mobília/mobiliário/móvel
cônjuge	parente/cara-metade
cúmulo	colecção/coleção/aglomeração/acúmulo
cúpula	reunião
dado	datum/informação/conhecimento
dados	colecção/coleção/aglomeração/acúmulo
dama	mulher
dano	alteração/modificação/variação/mudança
dança	recreaçao/diversão
data	dia
datum	informação/conhecimento
debate	idioma/discussão
decadência	pecado
decisão	selecção/escolha/seleção
declaração	mensagem/afirmação/tópico/assunto/conteúdo
declive	formação
declives	formação
declínio	diminuição/abatimento
decomposição	atividade/ação
decoração	adorno/ornato/ornamento/artefato
decreto	ato
decréscimo	alteração/modificação/variação/mudança
decênio	etapa/tempo/período
dedo	dígito/membro
defeito	situação/condição/estado
defensor	alguém/indivíduo/alma/pessoa
deferência	atitude
defesa	edifício/tecido/estrutura/combate/batalha
deficiência	necessidade/carência
deflagração	ocorrente/ocorrência/acontecimento
defunto	cadáver/morto/corpo
degrau	encosto/apoio/suporte
deidade	espirito
deidades	espirito
delegação	organização/autorização/situação/condição/estado
deleite	prazer
delicadeza	acção/atividade/ato/ação
delimitação	fronteiras/fronteira/limite
delinquência	estado/situação/condição/estado
delito	atividade/ocupação
demissão	termino/terminação/conclusão
demolição	chegada/conclusão/resultado/fim/final
denominação	antenome/prenome/nome
dente	osso
dentes	osso
dentista	médico
departamento	prédio/edifício/divisão
depósito	matéria/substância/colocação/acumulação/acúmulo
derrota	chegada/conclusão/resultado/fim/final/fracasso/desastre/falha/erro
desabafo	atividade/ocupação
desafiante	competidor/contendor
desafortunado	alguém/indivíduo/alma/pessoa
desaparecimento	termino/terminação/conclusão
desastre	ocorrente/ocorrência/acontecimento
descendente	parente
descendência	parente/genealogia
descensão	traslado/deslocamento/movimento
descoberta	acção/feito/ato/ação
descobrimento	acção/feito/ato/ação
desconsideração	desfeita/ofensa/injúria
descrença	incerteza/dúvida
descrição	afirmação/declaração
descuido	equívoco/engano/falha/erro
desejo	apetite/pretensão/anseio/emoção/sentimento/impressão
desembaraço	certeza/segurança
desembocadura	formação
desempenho	acção/atividade/ato/ação
desenho	afiguração/representação/criação/imagem/figura/ilustração
desenvolvimento	uso/utilização/melhoramento/melhoria
desfeita	conduta/comportamento
desfile	romaria/procissão
desgosto	mágoa/tristeza/dor/pesar
desgraça	desonra/vergonha
designação	dever/obrigação/decisão/resolução
deslocamento	mudança
desmoralização	degradação
desolação	demolição/chegada/destruição/conclusão/resultado/fim/final
desonestidade	delito/transgressão
desordem	situação/condição/estado
despacho	partida
despedida	partida
desperdício	atividade/ocupação
desportista	competidor/contendor
desprezo	desconsideração
destino	causador/causa/ocorrente/ocorrência/acontecimento/estado
destruição	chegada/conclusão/resultado/fim/final/termino/terminação/situação/conclusão/condição/estado
desvantagem	passivo/risco/responsabilidade
desventurado	alguém/indivíduo/alma/pessoa
detalhe	facto/verdade
detenção	confinamento
deterioração	declínio/atividade/ação/diminuição
deus	espirito
deusa	espirito
devastação	termino/terminação/conclusão
dever	tarefa/trabalho
dia	oportunidade/etapa/chance/tempo/período/era/época/momento/tempo/período
dianteira	face/lado
diferença	flutuação/variação/mudança/qualidade
dificuldade	qualidade/problema/obstáculo
difusão	atividade/ação
dignidade	status/condição/estado/classe/posição
dimensão	grandeza/magnitude/número
diminuição	alteração/modificação/variação/mudança/abatimento
dinheiro	cobre/divisa/moeda/activos/ativos/bens/recursos/ativo/divisa/moeda/possessão/riqueza/bem
diocese	jurisdição
directiva	pronunciamento
director	administrador/gerente
direcção	itinerário/itinerários/percurso/rota/linha/estrada/caminho
direita	local/lugar/posição
direito	abstracção/abstracto/abstrato
diretiva	pronunciamento
diretor	administrador/gerente/executivo
diretriz	pronunciamento
direção	itinerário/itinerários/percurso/rota/linha/estrada/caminho
dirigente	administrador/gerente
disciplina	feição/peculiaridade/conhecimento/saber
discordância	desacordo/discordo/discrepância/discórdia
discurso	mensagem/comunicação/comunicado/faculdade/comunicação/talento
discussão	comunicado/desacordo/discordo/discrepância/comunicação/debate/discórdia/idioma/discordância
discípulo	seguidor
dispositivo	apetrecho/linguagem/discurso/equipamento/instrumento/língua/estilo
disposição	feição/peculiaridade/acção/feito/ato/ação/índole/natureza
disputa	peleja/pugna/combate/batalha/luta/desacordo/discordo/discrepância/conflito/discórdia/discordância/luta
dissimulação	adulteração/falsificação
distinção	diferença
distracção	entretenimento/diversão/entreterimento/divertimento
distração	entretenimento/diversão/entreterimento/divertimento
distribuição	acção/feito/ato/ação
districto	regiões/região
distrito	regiões/região/municipalidade/município
distância	espaçamento
ditado	locução/provérbio/expressão/idioma
diversão	recreaçao/atividade/ocupação
divertimento	entretenimento/diversão/entreterimento/recreaçao/diversão/atividade/ocupação
divindade	espirito
divinidade	espirito
divisa	cobre/moeda/dinheiro/moeda
divisão	distribuição/separação/corpo
divisória	edifício/tecido/estrutura
divulgador	booker
diário	livros/livro
doação	aquisição/partilha/partição
doce	petisco/guloseima/prato
documentação	documentos
documento	mensagem/comunicação/afiguração/documentos/representação/imagem/figura/ilustração/desenho
doença	enfermidade/transtorno/distúrbio/bagunça
doenças	enfermidade/doença
dom	aquisição
domicílio	endereço/alojamento/abrigo/casa
dominancia	estado/situação/condição/estado
doméstico	servidor
domínio	regiões/estado/situação/condição/estado/região/ambiente/conhecimento/saber
dona	mulher
dona-de-casa	esposa/mulher
dono	alguém/homemdenegócios/indivíduo/empresário/negociante/alma/comerciante/pessoa
dor	sintoma/desgosto/emoção/mágoa/sentimento/tristeza/impressão/pesar
doutor	médico
doutrina	convicção/crença/fé/opinião
dr.	médico
dramaturgia	comunicado/comunicação
drinque	porção
droga	agente
drogaria	boutique/loja/venda
drograria	boutique/loja/venda
ducto	aqueduto/conduto/duto/canal
dupla	reunião
duração	etapa/tempo/período
duto	aqueduto/conduto/ducto/canal
dádiva	aquisição
débito	dívida/obrigação
década	etapa/tempo/período
dígito	membro
dívida	obrigação
dívidas	dívida/obrigação
dólar	divisa/peça/moeda/prata
dúvida	incerteza
economia	sistema/organização/acção/atividade/ato/ação
edifício	tecido/estrutura/artefato
edição	obra/trabalho
educacionista	profissional
educador	profissional
efeito	consequência/fenómeno/fenômeno/conseqüência/resultado/fim/causalidade/causa
efeitos	consequência/conseqüência/efeito/resultado/fim/poder/força
efeméride	dia
efetividade	poder
efetuação	acção/feito/ato/ação
eficiência	poder
eficácia	poder
egocentrismo	feição/peculiaridade
egoísmo	feição/peculiaridade
electricidade	energia
elegância	qualidade
eleição	selecção/decisão/escolha/seleção
elemento	categoria/porção/componente/parte
elenco	organização
eletricidade	energia
elevação	propulsão/traslado/deslocamento/impulsão/formação/movimento
eliminação	acção/feito/ato/ação
elipse	cónica/cônica
embaixada	organização
embalagem	colecção/coleção/aglomeração/acúmulo/contentor/contêiner/recipiente
embalagens	cobertura/capa
embarcação	embarcações/navios/navio/barco
emblema	ornamento/sinal/símbolo
embrulho	colecção/coleção/aglomeração/acúmulo
emigração	migração
emissão	espectáculo/show
emoção	sentimento/impressão
empatia	camaradagem/simpatia/compaixão/piedade
empenho	mão-de-obra/trabalho
empregado	servidor/trabalhador
empregador	líder/chefe
emprego	costume/hábito
empreiteiro	contratador
empresa	comercialismo/mercantilismo/estabelecimento/instituição/comércio/instituto/organização/companhia
empresas	empresa
empresário	booker/capitalista
empréstimo	débito/dívida/dívidas/dívida
empurrão	propulsão/impulsão
enaltecimento	aumento
encabeçamento	melodia/linha
encargo	designação/dívida/tarefa/obrigação
encendedor	aparato/dispositivo/aparelho/equipamento/mecanismo/instrumento/ferramenta
encepamento	colecção/coleção/aglomeração/acúmulo
enchido	defunto/cadáver/morto/corpo
enchimento	artefato
encontro	assembléia/reunião/convergência
encosta	formação
encosto	aparato/dispositivo/aparelho/equipamento/mecanismo/instrumento/ferramenta
endosso	apoio/suporte
enfermeira	médico
enfermeiro	médico
enfermeiros	médico
enganação	adulteração/falsificação
engano	insucesso/falha
engenharia	disciplina/campo/domínio
engenheiro	alguém/indivíduo/alma/pessoa
engrandecimento	aumento
enjôo	nojo/asco/repugnância/náusea/abominação/repulsa/aversão
ensejo	fenómeno/fenômeno
entendimento	faculdade/talento
enterro	cerimónia/cerimônia/festa
entorno	região
entorpecente	agente
entrada	via/rodovia/estrada/caminho/chegada/vinda
entrega	transporte/transferência
entretenimento	recreaçao/diversão
entreterimento	recreaçao/diversão
entusiasmo	emoção/sentimento/impressão
envelope	contentor/contêiner/recipiente
envio	partida
envolvente	região
envólucro	cobertura/capa
epidemia	ocorrente/ocorrência/acontecimento
epifitismo	flora/planta/vegetal
episódio	ocorrente/ocorrência/acontecimento
epífito	flora/planta/vegetal
equilíbrio	edifício/tecido/estrutura
equino	perissodáctilos/ungulados
equinodermo	invertebrados/invertebrado
equinodermos	invertebrados/invertebrado
equipamento	ferramenta/artefato/apetrecho/instrumento
equídeo	perissodáctilos/ungulados
equívoco	insucesso/falha
era	etapa/século/idade/época/tempo/período
eros	apetite/pretensão/anseio/desejo
erro	equívoco/engano/falha/insucesso/falha
erupção	ocorrente/ocorrência/acontecimento
erva	aromatizante/traqueófitos/condimento/tempero
ervas	erva
escadas	escadaria/escada
escalada	ascensão/elevação
escaler	embarcações/embarcação/navios/navio/barco
escapada	escapatória/escape/fuga
escapatória	acção/feito/ato/ação/abertura
escape	acção/feito/ato/ação/escapatória/fuga
escapismo	recreaçao/diversão
escassez	ausência/necessidade/deficiência/falta/carência
escola	prédio/edifício
escolas	prédio/edifício
escolha	acção/selecção/decisão/seleção/atividade/ato/ação
esconderijo	área/região
escova	implemento/instrumento/ferramenta
escravidão	costume/hábito
escrita	atividade/ocupação
escritor	comunicador
escrivaninha	mesa
escudeiro	folhas/folha
escudo	proteção/capa
escuridão	iluminação
escuta	percepção
esdrúxulo	mutante/mutantes/mutação
esfera	ambiente
esforço	mão-de-obra/tentativa/trabalho/atividade/ocupação
esgrima	acção/atividade/ato/ação
esmagamento	compressão/pressão
esnobada	desconsideração
espanto	emoção/sentimento/impressão
espaçamento	posição/colocação/localização/posição
espaço	colocação/localização/posição
especialista	alguém/indivíduo/alma/pessoa
espectador	gente/povo/massa
esperança	alguém/indivíduo/alma/pessoa/emoção/expectativa/sentimento/impressão
espiga	fruto/fruta
espirito	convicção/crença/fé/opinião
esporte	jogo/recreaçao/diversão
esposa	cónjuge/consorte/cônjuge/esposo/marido/parente/companheiro/mulher/cara-metade
esposo	parente/cara-metade
espécie	taxon/taxón/táxon/categoria/espécies/raça/género/tipo/classe
espécies	categoria/família/classe/taxon/taxón/táxon
espírito	abalo/comoção/emoção/sentimento/espirito
espólio	compra/aquisição
esqueleto	sistema
esquema	afiguração/representação/imagem/figura/ilustração/desenho
estabelecimento	edifício/tecido/estrutura/início/começo
estacada	barreira/obstáculo
estado	autoridades/regime/governo/atributo/predicado/característica/situação/condição/propriedade
estafeta	corrida
estanho	metal/metais
estante	alfaia/movéis/mobília/mobiliário/móvel
estação	etapa/infra-estrutura/instalação/tempo/período
estigma	simbolo/símbolos/aceno/emblema/símbolo/sinal
estilo	mensagem/comunicação/atributo/categoria/espécies/raça/sabor/género/propriedade/tipo/classe
estimativa	critica/juízo/julgamento
estimulante	informação/conhecimento
estio	sazão/estação/tempo/período
estoque	acumulação
estrada	artefato/via/fronteira/caminho
estrago	alteração/modificação/variação/mudança
estrangeira	turista/viajante
estrangeiro	turista/viajante
estrato	população/gente/pessoal/povo/região
estratégia	programa
estrela	astro
estrondo	problema/triunfo/êxito/sucesso
estrutura	constituição/composição/artefato/atributo/propriedade
estudante	alguém/indivíduo/alma/pessoa/seguidor
estudo	documentação/documento
estufa	prédio/edifício
estupefação	espanto/admiração/surpresa
estupor	estupefação
estádio	edifício/tecido/estrutura
estágio	etapa/tempo/período
estímulo	informação/conhecimento
estômago	anatomia
etapa	travessia/viagem
europeu	habitante/morador
evento	ocorrente/ocorrência/circunstância/acontecimento
eventualidade	ocorrente/ocorrência/acontecimento
evidência	agouro/indício/presságio/indicação/sinal
exame	comunicado/comunicação
examinar	investigação
exaustor	aparato/dispositivo/aparelho/equipamento/mecanismo/instrumento/ferramenta
excedente	categoria/porção/componente/parte
excepção	instância/exemplo/representante
exceção	instância/exemplo/representante
excrescência	projeção
excursão	jornada/viagem
excêntrico	anomalia
executivo	administrador/gerente
execução	acção/feito/ato/ação/acção/atividade/ato/ação
exemplo	líder/chefe/ocorrente/ocorrência/acontecimento/informação/conhecimento
exercício	treinamento/treino/preparação
exibição	entretenimento/diversão/entreterimento/divertimento/apresentação
existência	situação/condição/estado/ser
expatriação	migração
expectativa	emoção/sentimento/impressão
expedição	industria/empresa/negócio/comércio/partida
experiente	especialista
experiência	educação/instrução/ocorrente/ocorrência/acontecimento
explanação	afirmação/declaração
explicação	afirmação/declaração
exploração	maltrato/uso/utilização
explosivo	química/substância
explosão	ruído/ocorrente/ocorrência/acontecimento
exportação	bens/mercadoria/fazenda/produto/artigo/bem
exposição	colecção/coleção/aglomeração/acúmulo/exibição/apresentação
exposições	colecção/coleção/aglomeração/acúmulo
expressão	comunicado/semblante/comunicação/idioma/rosto/aparência
extensão	grandeza/espaço/magnitude/número/alcance
exterior	região
extremidade	região
exército	turba/montão/multidão
fabricante	fazedor
fabricação	edificação/construção
face	alguém/semblante/indivíduo/aspecto/superfície/alma/pessoa/aparência
faceta	característica/qualidade
facto	informação/conhecimento
faculdade	capacidade/poder/habilidade/talento
fado	causador/causa/ocorrente/ocorrência/acontecimento
faixa	banda
falecimento	alteração/modificação/variação/mudança
falha	acção/feito/ato/ação/insucesso
falsificação	delito/transgressão
falta	necessidade/carência
falésia	formação
falência	insolvência
fama	honra
família	clã/colecção/familia/conceito/coleção/parente/aglomeração/concepção/tribo/idéia/acúmulo/ideia/taxon/taxón/táxon/genealogia/sangue/descendência/linhagem
fanatismo	intolerância
fantasma	espirito
farda	vestimenta/vestuário/traje/roupa/vestido
fardamento	vestimenta/vestuário/traje/roupa/vestido
farinhas	alimento
farmacia	boutique/loja/venda
farmácia	boutique/loja/venda
farol	torres/roque/torre
fase	etapa/tempo/período/situação/condição/estado
fatia	porção/tomo/secção/porção/pedaço/parte
fato	informação/vestuário/roupa
fator	componente/causa
fazedor	creador/criador/criativo
fazenda	laboratório/oficina/emprego/trabalho/artefato/imobiliária/imóvel
façanha	feito/conquista/realização/proeza/acção/feito/atividade/ato/ação/realização
federação	união
feitio	maneira/estilo
feito	conquista/façanha/realização/acção/acontecimento/evento/fato/atividade/ato/ação
feiura	semblante/aspecto/aparência
feição	atributo/predicado/característica/propriedade
feiúra	semblante/aspecto/aparência
felicidade	espírito/humor/emoção/sentimento/impressão
fenda	espaço/vão/abertura
fenestra	infra/estrutura/abertura
feriado	dia
ferimento	danificação/deterioração
fermentação	álcoois/álcool
ferramenta	efetuação/aparato/apetrecho/dispositivo/implementação/implemento/aparelho/equipamento/mecanismo/execução/instrumento/realização
ferro	metal/metais
festa	acontecimento/recreaçao/diversão/balada
festival	celebração/festividade/festa
festividade	recreaçao/diversão
fiasco	equívoco/engano/falha/erro
fibra	materiais
fibras	materiais
ficheiro	registro
fichário	registro
figura	adulto/afiguração/formato/forma/representação/criação/imagem/ilustração/desenho
fila	formação
fileira	bicha
filha	criança/filho/menino/fêmea
filho	descendência/parente/descendente/rapaz/menino
filhote	criatura/animal/besta/bicho/ser
filme	espectáculo/show/bens/produto/produção
filo	taxon/taxón/táxon
filosofia	convicção/crença/fé/opinião
fim	fenómeno/fenômeno/meta/alvo/objectivo/intenção/extremidade
final	extremidade
finança	industria/empresa/negócio/comércio
finanças	activos/ativos/bens/recursos/ativo
fineza	dificuldade
fio	artefato/corda
firmamento	superfície
firmeza	feição/peculiaridade
fissura	vão/fenda
fitopatologia	doenças/doença
flanco	sub-figura
flerte	brincadeira
flora	colecção/coleção/aglomeração/acúmulo/organismo/ser
floresta	flora/vegetação/chão/locação/relevo/localização/solo/terra/ponto/lugar/bioma/biomas
florestas	chão/relevo/solo/terra/bioma/biomas
floricultura	horticultura
fluido	matéria/substância
flutuação	alteração/modificação/variação/mudança
fluxos	atividade/ação
fluído	substância
foco	concentração/lugar
fofoca	contas/reporte/relato/relatório
fogo	ocorrente/ocorrência/acontecimento
folha	folhas/papel/jornalismo/imprensa/órgão/jornal
folhagem	órgão
folhas	verdura/hortaliça/legume/vegetal/papel/folha
fonte	infra-estrutura/instalação/lugar
forca	laço/propulsão/impulsão
forma	atributo/predicado/característica/propriedade
formato	atributo/predicado/característica/propriedade
formação	objeto/arranjo
fornada	comida
fornecedor	provedor/empresário
fornecimento	atividade/ocupação
fortuna	fenómeno/fenômeno
força	causador/agressão/hostilidade/causa/intensidade/atributo/poder/propriedade
fossil	resto
foto	afiguração/representação/imagem/figura/ilustração/desenho
fotografia	afiguração/representação/imagem/figura/ilustração/desenho
foz	formação
fracasso	insucesso/falha
fractura	traumatismo/dano/machucado/lesão/mal
fragância	odor/cheiro
fraqueza	impotência/atributo/propriedade
frasco	vasilhame/vasilha/vaso
fraternidade	estrato/classe/cordialidade
fratura	traumatismo/dano/machucado/lesão/mal
freguesia	população/gente/pessoal/povo
frente	face/lado/local/lugar/posição
fresta	vão/abertura/fenda
frete	mercadoria/produto/artigo
fricção	recontro/confronto/conflito
fronte	local/lugar/posição
fronteira	locação/localização/ponto/lugar/limite/fronteiras/extremidade/alcance/linha/extensão/limite
fronteiras	extremidade
frota	colecção/coleção/aglomeração/acúmulo
fruta	hortifruti/hortifruto/fruto
fruto	bens/produto/produção
fuelóleo	carburante/combustível/hidrocarboneto
fuga	acção/feito/ato/ação/escapatória/escape
fulgor	elegância
fundação	pressuposição/suposição/hipótese/conexão/relação
fundilhos	anatomia
fundo	depressão/face/possessão/lado/propriedade/divisa/superfície/moeda/dinheiro/região
fundos	activos/ativos/bens/recursos/ativo
funeral	cerimónia/cerimônia/festa
fungo	organismo/ser
fungos	organismo/ser
função	software/dever/obrigação/programa/utilidade
furo	abertura
furto	crime
fusão	estado/união/ligação
futuro	tempo
fábrica	usina/planta
fé	convicção/crença/opinião/certeza/segurança
fêmea	alguém/criatura/animal/besta/bicho/indivíduo/alma/pessoa/ser
física	ciência
fósseis	resto
fóssil	resto
fúria	zanga/ira/cólera/raiva
gafe	equívoco/engano/falha/erro
galardão	dádiva/brinde/dom/doação/presente
galera	população/gente/pessoal/povo
galho	caule/tronco
galhofa	atividade/ocupação
galáxia	colecção/coleção/aglomeração/acúmulo
gangue	associação/sociedade/união/organização/ordem/reunião
ganho	custo
garanhão	cavalo
garantia	declaração
garota	mulher/fêmea
garotinha	fêmea
garoto	rapaz/varão/menino/macho/homem
garrafa	vasilhame/vasilha/vaso/conteúdo
gasolina	carburante/combustível/hidrocarboneto
gastos	despesa/gasto
gaveteiro	alfaia/movéis/mobília/mobiliário/móvel
geek	anomalia
genealogia	clã/familia/tribo/família
genitor	progenitor
genitália	órgão
gente	população/pessoal/povo/agrupação/conjunto/grupo
gentileza	acção/atividade/ato/ação
geração	população/gente/pessoal/povo
gerenciamento	gestão/administração
gerente	líder/administrador/cabeça/chefe/liderança/responsável
gesto	mudança/gestos
gestor	administrador/gerente
gestão	administração
giba	projeção
giro	rotação
gleba	região
glória	honra
gola	faixa
golpe	mudança
gordura	lipido/lipídio/lípido/lípidos/macromolécula/lípidos
gorjeio	ruído/som
gosto	emoção/sentimento/sensação/impressão
gota	esfera/fragmento/pedaço
governador	alguém/indivíduo/alma/pessoa
governante	alguém/indivíduo/alma/pessoa
gozação	recreaçao/diversão
gradação	hierarquia/posto/classe/posição
grama	ervas/gramínea/gramíneas/erva
gramado	gleba/terreno/região
gramínea	erva
gramíneas	erva
grana	divisa/moeda/dinheiro
grandeza	atributo/propriedade
granja	laboratório/oficina/emprego/trabalho
gratidão	emoção/sentimento/impressão
grau	hierarquia/posto/classe/posição/atributo/situação/condição/estado/propriedade
greta	vão/fenda
grupo	colecção/coleção/aglomeração/acúmulo/abstração/aglomeração
guarda	protetor/aparato/designação/dispositivo/guardião/aparelho/defensor/equipamento/mecanismo/tarefa/instrumento/ferramenta
guarda-lama	barreira/obstáculo
guarda-roupas	alfaia/movéis/mobília/mobiliário/móvel
guardarroupas	alfaia/movéis/mobília/mobiliário/móvel
guerra	combate/batalha
guilda	associação/sociedade/união/organização/ordem
guito	divisa/moeda/dinheiro
guloseima	alimentação/nutriente/nutrição/comida/alimento
guria	fêmea
gás	líqüido/fluido
género	categoria/família/classe/taxon/taxón/táxon/categoria/espécies/raça/tipo/classe
gênese	início/começo/princípio
habilidade	cognição/meta/noção/técnica/conhecimento/compreensão/talento/situação/capacidade/condição/estado/poder/qualidade/talento
habitante	alguém/indivíduo/alma/pessoa
habitação	morada/alojamento/aposento/moradia/prédio/acção/domicílio/feito/residência/edifício/abrigo/ato/lar/ação/casa
hall	aposento/prédio/edifício/quarto/sala
hardware	componente/parte
hebraica	alguém/indivíduo/alma/pessoa
hebraico	alguém/indivíduo/alma/pessoa
hebreia	alguém/indivíduo/alma/pessoa
hebreu	alguém/indivíduo/alma/pessoa
hemisfério	região
hemípteros	artropode/artrópode/artrópodes
herança	compra/aquisição
herbívoro	criatura/animal/besta/bicho/ser
hidrófita	traqueófitos
hierarquia	status/condição/estado/classe/posição
himenópteros	insectos/insetos/hemípteros/insecto/inseto
hipótese	conceito/concepção/possibilidade/idéia/suposição/teoria/ideia
historieta	contas/reporte/relato/relatório
história	mensagem/tópico/assunto/conteúdo/contínuo
hobby	recreaçao/diversão
hoje	tempo
homem	alguém/adulto/indivíduo/alma/amante/humano/pessoa/agrupação/conjunto/varão/macho/grupo
homemdenegócios	empresário
homicídio	termino/terminação/conclusão
hominídeo	primata/primatas
honestidade	moralidade/moral/virtude
hora	etapa/tempo/período/dado/instante/leitura/momento/segundo
horda	turba/montão/multidão
hormona	secreção
hormônio	secreção
hormônios	secreção
hortaliça	hortifruti/hortifruto
horticultura	agricultura/pecuária/cultivo
hortifruti	comida
hortifruto	comida
horto	campos
horário	intervalo/tempo
hospedaria	hotel
hospedeiro	adulto/organismo/ser
hostelalbergue	alojamento/abrigo/casa
hostilidade	acção/ódio/atividade/situação/ato/condição/estado/aversão/ação
hotel	prédio/edifício
humanidade	humano/agrupação/conjunto/grupo
humano	hominídeo
humor	abalo/comoção/emoção/sentimento/emoção/sentimento/impressão
hábito	costume/atividade/ocupação/costume/emprego
iate	embarcações/embarcação/navios/navio/barco
idade	etapa/tempo/período/atributo/época/propriedade/período
ideia	conceito/idéia/pensamento/opinião/perspicácia/pensamento/opinião
identidade	temperamento/personalidade/pessoa/similardidade/semelhança
identificação	evidência/indicação
ideologia	orientação
idioma	mensagem/comunicação/linguagem/discurso/língua/faculdade/talento
idoso	adulto
idéia	conceito/pensamento/opinião
ignomínia	desonra/vergonha
igreja	prédio/edifício/estabelecimento/instituição/instituto/casadeoração/templo
igrejas	estabelecimento/instituição/instituto/casadeoração/igreja/templo
ilha	chão/relevo/zona/solo/terra
iluminação	situação/condição/estado
ilustração	afiguração/representação/criação/imagem/figura/desenho
imagem	afiguração/representação/criação/figura/ilustração/desenho
imaginação	criatividade
imaturidade	situação/condição/estado
imitação	atuação/representação/personificação/interpretação
imobiliária	possessão/propriedade
imoralidade	transgressão
impedimento	acção/feito/edifício/tecido/estrutura/ato/ação
imperfeição	situação/condição/estado
implementação	acção/feito/ato/ação
implemento	apetrecho/equipamento/instrumento/ferramenta
importação	bens/mercadoria/fazenda/produto/artigo/bem
importância	preços/preço/qualidade
impossibilidade	inexistência
imposto	dívida/encargo/taxa/obrigação
impostos	imposto
impotência	qualidade
impulso	propulsão/impulsão
impulsão	acção/feito/ato/ação/propulsão
imunidade	estado/situação/condição/estado
imóvel	possessão/propriedade
incapacidade	cognição/noção/conhecimento/compreensão
incidente	ocorrente/ocorrência/acontecimento
inclinação	mudança
incompatibilidade	característica/qualidade
incumbência	dever/obrigação
incêndio	ocorrente/ocorrência/acontecimento
indagação	pergunta/inquérito/questão
independência	liberdade/vitória
indicação	agouro/indício/mensagem/presságio/comunicação/sinal
indiferença	emoção/sentimento/impressão
indivíduo	causador/causa/organismo/ser
industria	comercialismo/mercantilismo/comércio
indício	mensagem/comunicação
indústria	industria/empresa/negócio/comércio
inflamação	sintoma
influência	consequência/conseqüência/efeito/resultado/fim/poder
informação	cognição/colecção/coleção/noção/aglomeração/acúmulo/conhecimento/compreensão/mensagem/tópico/assunto/conteúdo/conhecimento
infortunado	alguém/indivíduo/alma/pessoa
infortúnio	problema/azar
infra-estrutura	artefato/estoque
infracção	crime/ofensa
infraestructura	estoque
infraestrutura	estoque
infração	crime/ofensa
infância	imaturidade/época/período
ingestão	atividade
ingrediente	alimento
ingresso	chegada/vinda
iniciação	início/começo/princípio
inimigo	população/gente/pessoal/povo
inimizade	ódio/situação/condição/estado/aversão
iniqüidade	estado/situação/condição/estado
injúria	desfeita/conduta/ofensa/comportamento/maltrato
inovação	criatividade
inquérito	requerimento/requisição/solicitação/pedido/petição/investigação/apelo
inscrição	documentos/ingresso/entrada
insecto	artropode/artrópode/artrópodes
insectos	artropode/artrópode/artrópodes
inserção	movimento
inseto	artropode/artrópode/artrópodes
insetos	artropode/artrópode/artrópodes
inspecionar	investigação
inspeção	fiscalização/inspecção/vistoria/inspecionar/examinar/teste
instalação	infra-estrutura/artefato
instante	quantia/quantitativo/medida/quantidade/momento
instituição	associação/sociedade/união/organização/ordem/estabelecimento
instituto	associação/sociedade/união/organização/ordem
instrumentalista	intérprete
instrumentista	intérprete
instrumento	artefato/aparato/apetrecho/dispositivo/implemento/aparelho/equipamento/mecanismo/ferramenta
instância	ocorrente/ocorrência/acontecimento/informação/conhecimento
insucesso	acção/feito/ato/ação
insulto	desfeita/ofensa/injúria
insurreição	conflito/luta
intelecto	alguém/indivíduo/alma/pessoa
intelectual	alguém/indivíduo/alma/pessoa
inteligência	faculdade/capacidade/poder/habilidade/talento
intensidade	grau
intenção	conceito/meta/alvo/idéia/objectivo/pensamento/opinião/mensagem/tópico/assunto/conteúdo
interação	acção/atividade/ato/ação
intercessor	negociador
intercorrência	decisão
interesse	preocupação/curiosidade
interferencia	obstrução/impedimento/obstáculo
interferência	acção/feito/ato/ação
interior	região
intermediário	negociador/empresário
interpretação	atividade/ocupação
interrogatório	pergunta/inquérito/questão
interrogação	pergunta/inquérito/questão
interrupção	ocorrente/ocorrência/acontecimento/intervalo/tempo
interseção	conjunto
intervalo	ociosidade/quantia/quantitativo/medida/quantidade
intolerância	atitude
intoxicante	entorpecente/droga/medicamento/remédio
introdução	movimento
intérprete	artista
invenção	criatividade
inverno	sazão/estação/tempo/período
invertebrado	criatura/animal/besta/bicho/ser
invertebrados	criatura/animal/besta/bicho/ser
investigação	tarefa/trabalho
investimento	activos/ativos/bens/finança/recursos/ativo
invitação	missiva/carta/requerimento/requisição/solicitação/pedido/petição/apelo
invólucro	cobertura/capa
início	ocorrente/ocorrência/acontecimento/instante/começo/princípio/momento
ira	abalo/zanga/comoção/cólera/emoção/sentimento/raiva
irmandade	estrato/classe/cordialidade
irmã	membro
irmão	amiga/camarada/conhecido/amizade/amigo
isqueiro	aparato/dispositivo/aparelho/equipamento/mecanismo/instrumento/ferramenta
item	categoria/porção/componente/parte
itinerário	fronteira
itinerários	fronteira
janela	infra/estrutura/abertura
jardim	campos
jazida	território/ambiente/área/região
jeito	efetuação/implementação/execução/realização
jejum	abstinência
jipe	auto/automóvel/viatura/carro/veículo
joalharia	ornamento/decoração
joalheria	ornamento/decoração
jogada	proeza/feito/façanha/realização
jogar	uso/utilização
jogo	certame/colecção/concurso/coleção/competição/aglomeração/torneio/acúmulo/partida/actividade/recreaçao/quantia/acção/diversão/quantitativo/medida/atividade/ocupação/componente/quantidade/ação
jogos	actividade/acção/atividade/ação
jornada	etapa/tempo/período/travessia/viagem
jornal	publicação/edição/bens/jornalismo/imprensa/produto/produção
jornalista	autor/escritor
jovem	alguém/indivíduo/alma/pessoa/juvenil/menor
judeu	alguém/indivíduo/alma/pessoa
judia	alguém/indivíduo/alma/pessoa
juiz	alguém/funcionário/serventuário/indivíduo/alma/pessoa/adjudicator/árbitro
juizado	assembleia/assembléia
julgador	autoridade
julgamento	acção/feito/ato/ação
junção	composição/combinação/ligação
jurisdição	circunscrição/comarca/districto/distrito/território/domínio
jurisprudência	colecção/coleção/aglomeração/acúmulo
jurista	funcionário/serventuário/profissional/adjudicator/juiz/árbitro
justeza	honestidade/justiça
justificativa	circunstância/consideração
justificação	circunstância/consideração
justiça	moralidade/honestidade/moral/virtude
juvenil	alguém/indivíduo/alma/pessoa
juventude	etapa/tempo/período
juízo	acção/feito/ato/ação/perspicácia/pensamento/opinião
jóia	ornamento/decoração
júri	comunidade/grupo
lacticínio	alimento
ladeira	elevação/formação
lado	superfície/região
lagarta	larva
lago	água
laje	bloco
lança	implemento/instrumento/ferramenta
lar	alojamento/domicílio/locação/residência/localização/abrigo/ponto/lugar/casa
largo	praça
larva	criatura/animal/besta/bicho/ser
lassidão	fraqueza
lata	contentor/contêiner/recipiente
laticínio	alimento
lauda	folhas/folha
lealdade	afeição/amor
legenda	organização
legislatura	assembleia/assembléia
legislação	governação/governo/administração
legião	turba/montão/multidão
legume	hortifruti/hortifruto
lei	colecção/conceito/coleção/aglomeração/concepção/idéia/acúmulo/ideia
leite	bebida/lacticínio/laticínio
leito	depressão
leitura	datum/dado/informação
lenha	carburante/combustível
lente	órgão
lenço	pano
leque	aparato/dispositivo/aparelho/equipamento/mecanismo/instrumento/ferramenta
letargia	fraqueza
letra	grafema
letreiro	anúncio
leva	turba/montão/multidão
levantamento	propulsão/impulsão
levedura	substância
leveduras	substância
liberalismo	independência/liberdade
liberdade	situação/condição/estado
licença	etapa/tempo/período
liderança	status/líder/chefe/condição/estado/classe/posição/atividade/ocupação/capacidade/poder/habilidade/talento
liga	solução/mistura
ligação	interação/conexão/apetrecho/formato/equipamento/forma/situação/condição/estado/união/instrumento/conexão/relação
limitação	regulamentos/aparato/dispositivo/regulação/alcance/aparelho/equipamento/mecanismo/instrumento/extensão/ferramenta
limite	fronteira/fiscalização/fronteiras/inspecção/extremidade/alcance/vistoria/inspeção/linha/extensão/fronteira/teste
limpada	melhoramento/melhoria
limpeza	melhoramento/melhoria
linguagem	mensagem/comunicação/discurso/idioma/língua/faculdade/talento
linguística	ciência
lingüística	ciência
linha	texto/artefato/formato/forma/formação/fronteira
linhagem	agrupação/genealogia/conjunto/grupo
lipido	macromolécula
lipídio	macromolécula
liquidação	ocasião/vez/chance
lista	listagem
litoral	orla/costa/formação
liturgia	rito
litíase	rocha/pedra
livro	publicação/edição/bens/produto/produção
livros	bens/produto/produção
lixo	materiais
local	lugar
localidade	território/ambiente/área/região
localização	objeto
locação	objeto/gleba/terreno/região
locomoção	traslado/deslocamento/movimento
locução	idioma
loja	shopping
lombo	anatomia
lousa	artefato/chapa/placa
louça	artigo
lua	objeto/mês
luar	luz
lubrificante	substância
lubrificantes	substância
lucro	custo
lugar	status/locação/localização/objeto/condição/estado/ponto/classe/posição/gleba/local/terreno/situação/função/papel/região/posição
luminária	alfaia/movéis/mobília/mobiliário/móvel
lustre	luminaria/luminária
luta	certame/concurso/competição/torneio/esforço/tentativa/combate/partida/batalha/jogo/boxe/pugilismo/empenho/conflito/esforço
luxo	abundancia/riqueza/poder
luz	aparato/dispositivo/aparelho/equipamento/mecanismo/instrumento/ferramenta
lâmpada	aparato/dispositivo/aparelho/equipamento/mecanismo/instrumento/ferramenta
lã	corda
líder	alguém/indivíduo/alma/chefe/pessoa
língua	mensagem/comunicação/linguagem/discurso/idioma/órgão/faculdade/talento
lípido	macromolécula
lípidos	lipido/lipídio/lípido/macromolécula/gordura
líquen	fungo/fungos
líquenes	fungo/fungos
líquido	líqüido/fluido
líqüido	matéria/substância/fluído
macho	alguém/criatura/animal/besta/bicho/indivíduo/alma/pessoa/ser
maconha	traqueófitos
madame	mulher
madrugada	início/começo/princípio
magistrado	funcionário/serventuário/adjudicator/juiz/árbitro
magnete	aparato/dispositivo/aparelho/equipamento/mecanismo/instrumento/ferramenta
magnitude	grandeza/número/atributo/preços/preço/propriedade/qualidade
maioria	número
maioridade	número
maldade	estado/situação/condição/estado/transgressão
malha	têxteis/pano/tecido/fazenda
maltrato	costume/hábito
mamífero	vertebrado
mancha	equívoco/simbolo/símbolos/aceno/emblema/engano/símbolo/falha/sinal/erro
mandamento	comando/ordem
maneira	feição/peculiaridade/efetuação/implementação/atributo/conduta/comportamento/procedimento/execução/propriedade/realização
manequim	criado/ajudante/assistente/servidor
manhã	etapa/tempo/período/início/começo/princípio
manifestação	demo/demonstração
manipulador	causador/causa
manobra	operação/traslado/deslocamento/atividade/ocupação/passo/movimento
mansarda	pavimento/piso/andar
manteiga	lacticínio/laticínio/comida
manufatura	industria/fábrica/usina/empresa/negócio/planta/comércio
mapa	afiguração/representação/imagem/figura/ilustração/desenho
maquinaria	máquina/aparato/dispositivo/aparelho/equipamento/mecanismo/instrumento/ferramenta
maquinário	maquinaria/máquina
mar	água
marca	simbolo/símbolos/aceno/emblema/símbolo/sinal
marcador	número
marcadores	simbolo/símbolos/aceno/emblema/símbolo/sinal
marcha	romaria/procissão
margem	fronteiras/fronteira/limite
marido	parente/cara-metade
marina	local/lugar/posição
massa	turba/montão/multidão/agrupação/divisa/conjunto/moeda/dinheiro/grupo
mata	flora/vegetação/chão/relevo/solo/terra/bioma/biomas
matacão	rocha/pedra
matematica	ciência
matemática	ciência
materiais	informação/substância
material	equipamento/informação/ferramenta
matiz	tez/cor
matricula	ingresso/entrada
matrícula	ingresso/entrada
matéria	mensagem/tópico/assunto/conteúdo
matéria-prima	materiais
maçã	pomo/fruta
mecanica	desempenho/performance/execução/realização
mecanismo	desempenho/performance/execução/realização/aparato/apetrecho/dispositivo/aparelho/equipamento/instrumento/ferramenta
mecenato	aprovaçã0/aprovação
mediador	negociador
mediação	estado-maior/pessoal
medicamento	entorpecente/droga/remédio/agente
medida	grandeza/magnitude/número/atividade/ocupação
medição	atividade/ocupação
medo	abalo/comoção/consternação/emoção/sentimento/temor/terror/ânsia/ansiedade/preocupação
megalomania	psicopatia/psicopata
meio	efetuação/implementação/execução/região/realização
meio-dia	hora
melhora	estado/situação/condição/estado
melhoria	estado/situação/componente/condição/estado/parte/transmutação/transformação/mudança
melodia	texto
membro	categoria/porção/componente/parte/associado
memória	faculdade/talento
menina	fêmea
menininha	fêmea
menino	descendência/criança/descendente/filho/juvenil/menor/jovem/rapaz/varão/macho/homem
meninota	fêmea
menor	alguém/indivíduo/alma/pessoa
mensagem	comunicação/abstração
mensuração	atividade/ocupação
mentalidade	atitude
mente	cognição/noção/conhecimento/compreensão
mento	traço
mercado	estrato/classe/atividade/ocupação
mercadoria	produto/artigo/artefato/bens/fazenda/produto/artigo/bem
mercantilismo	transação
merecimento	importância/valor
mesa	alfaia/movéis/mobília/mobiliário/móvel
mestre	autoridade
meta	capacidade/poder/habilidade/talento
metade	componente
metodo	habilidade
metro	aparelho/instrumento/ferramenta
metrópole	municipalidade/município
metrópoles	municipalidade/município
micetes	fungo/fungos
microorganismo	organismo/ser
microrganismo	organismo/ser
migração	traslado/deslocamento/movimento
minarete	torres/roque/torre
mineral	materiais
ministro	executivo
ministério	prédio/edifício
minérios	materiais
mirada	orientação
miscelanea	colecção/coleção/aglomeração/acúmulo
misericórdia	socorro/ajuda/assistência
missiva	texto/documento
missão	organização/designação/tarefa
mistura	colecção/coleção/aglomeração/acúmulo/substância
mitologia	colecção/coleção/aglomeração/acúmulo
mobiliário	apetrecho/mobília/equipamento/móvel/instrumento
mobília	apetrecho/mobiliário/equipamento/móvel/instrumento
mocinha	fêmea
moda	sabor
modalidade	feição/peculiaridade
modelo	criado/líder/ajudante/assistente/chefe/servidor/afiguração/representação/imagem/figura/ilustração/desenho
modificação	ocorrente/ocorrência/acontecimento/mudança
modo	efetuação/implementação/conduta/comportamento/procedimento/maneira/execução/realização
moeda	cobre/divisa/dinheiro
mofo	fungo/fungos
mohair	têxteis/pano/tecido/fazenda
moinho	maquinaria/maquinário/máquina
moinhos	maquinaria/maquinário/máquina
molde	contentor/contêiner/recipiente
molho	condimento
molusco	invertebrados/invertebrado
moluscos	invertebrados/invertebrado
molécula	unidade
momento	etapa/tempo/período/quantia/quantitativo/instante/medida/quantidade
monstro	mutante/mutantes/mutação
montanha	elevação
montanhas	elevação
montante	soma/quantidade/número
monte	colecção/coleção/aglomeração/edifício/tecido/acúmulo/estrutura/elevação
montão	colecção/coleção/aglomeração/acúmulo/reunião
montículo	projeção
monumento	edifício/tecido/estrutura
monumentos	edifício/tecido/estrutura
morada	alojamento/abrigo/casa
moradia	alojamento/abrigo/casa
morador	alguém/indivíduo/alma/pessoa
morais	motivação/necessidade/motivo/intenção
moral	motivação/necessidade/motivo/intenção/qualidade
moralidade	motivação/necessidade/motivo/intenção/qualidade
morfina	analgésicos/opioides/analgésico
morro	elevação
mortalidade	velocidade/ritmo
morte	alteração/modificação/variação/mudança/termino/terminação/situação/conclusão/condição/estado
mostra	instância/exemplo/representante
mota	moto/motocicleta/moto/motocicleta
motivo	conceito/idéia/pensamento/opinião
moto	mota/motocicleta
motocicleta	moto/mota/moto/mota
motor	maquinaria/máquina/motores
motores	maquinaria/máquina/motor
mouse	roedor
movimento	ocorrente/ocorrência/acontecimento/decisão/situação/condição/estado/resolução/mudança
movéis	mobília/mobiliário/móvel
moça	mulher/fêmea
moço	varão/macho/homem
mudança	alteração/modificação/variação/ocorrente/ocorrência/acção/acontecimento/atividade/ato/ação
mulher	cónjuge/consorte/cônjuge/esposa/esposo/marido/adulto/companheiro/estrato/classe/fêmea
mulherio	estrato/classe
multidão	turba/montão/reunião
mundo	humano/população/gente/pessoal/povo/agrupação/conjunto/experiência/grupo
municipalidade	reunião
município	reunião
munição	apetrecho/armamento/equipamento/arma/instrumento
muro	divisória/paredes/parede
mus	roedor
musico	artista
mutante	organismo/ser
mutantes	organismo/ser
mutação	organismo/ser
mácula	equívoco/engano/falha/erro
mágoa	tristeza/pesar
máquina	maquinaria/aparato/dispositivo/motores/aparelho/equipamento/mecanismo/motor/instrumento/ferramenta
máscara	disfarce/cobertura/capa
mãe	genitor/progenitor/pai/genitor
mão	colecção/auxílio/coleção/socorro/aglomeração/ajuda/acúmulo/assistência
mão-de-obra	tarefa/trabalho
médico	profissional
mérito	importância/valor
método	habilidade
métodos	habilidade
mês	etapa/tempo/período
mídia	apetrecho/equipamento/instrumento
mímica	imitação/personificação
móvel	apetrecho/mobília/mobiliário/equipamento/instrumento
música	atividade/ocupação
músico	artista/intérprete
nacionalidade	status/condição/estado/classe/posição
naipe	ornamento
nalga	anatomia
narcótico	entorpecente/droga/medicamento/remédio
narrativa	mensagem/tópico/assunto/conteúdo
narração	mensagem/tópico/assunto/conteúdo
nascente	formação/lugar
nascimento	alteração/modificação/variação/mudança
nata	lacticínio/laticínio
natureza	feição/peculiaridade/qualidade
navio	embarcações/embarcação/navios/barco
navios	embarcações/embarcação/navio/barco
nação	população/gente/pessoal/povo
nebulosa	colecção/coleção/aglomeração/acúmulo
necessidade	estado/situação/condição/estado/carência
negligência	equívoco/engano/falha/erro/insucesso/falha
negociador	comunicador
negociante	empresário
negociação	negócio/debate/discussão
negócio	comercialismo/mercantilismo/comércio
nenê	criança/filho/menino
neoplasia	tumores
nevada	precipitação
neve	precipitação
nobreza	status/condição/estado/classe/posição
noitada	etapa/tempo/período
noite	etapa/tempo/período/jornada/dia
nojo	aversão
nome	antenome/prenome
nomeação	decisão/resolução
norma	instrução
norte	curso
nostalgia	saudade/anelo/anseio/desejo
notícia	informação
notícias	informação
nudez	estado/situação/condição/estado
numeral	simbolo/símbolos/aceno/emblema/símbolo/sinal
numerário	cobre/divisa/moeda/dinheiro
nupcias	rito/ritual
nutriente	comida/alimento/substância
nutrição	nutriente/comida/alimento
nádega	anatomia
nádegas	anatomia
náusea	nojo/asco/repugnância/abominação/repulsa/aversão
não-ficção	prosa
nível	situação/condição/estado
nó	laço
número	simbolo/símbolos/conceito/aceno/emblema/concepção/grandeza/soma/símbolo/idéia/magnitude/quantidade/ideia/sinal/atributo/atuação/periódico/revista/quantidade/jornal/propriedade
objetivo	meta/alvo/objectivo/intenção
obra	bens/produto/produção
obrigação	tarefa/trabalho
observação	afirmação/declaração
obstrução	edifício/tecido/estrutura/interferência/atrapalhação/impedimento/manobra
obstáculo	edifício/tecido/estrutura/obstrução/impedimento/dificuldade/problema
obtenção	feito/conquista/façanha/realização
ocasião	ocorrente/ocorrência/acontecimento
ociosidade	acção/feito/ato/ação
ocorrente	acontecimento/evento/fato
ocorrência	ocorrente/acontecimento/evento/fato
ocultação	atividade/ocupação
ocupação	acção/feito/ato/ação
odontólogo	médico
odor	atributo/percepção/propriedade
ofensa	desfeita/conduta/comportamento/injúria/transgressão
ofensiva	manobra/operação
oficial	militar
oficina	laboratório/emprego/trabalho
ofício	profissão/ocupação/emprego/função/serviço/trabalho/lugar
olhada	percepção
olhar	percepção
olimpo	região
ombro	anatomia
onda	movimento
operador	causador/causa
operação	atividade/cálculo/ocupação/tarefa/trabalho
operário	insectos/insetos/hemípteros/insecto/inseto/trabalhador
opinião	convicção/crença/fé/perspicácia/pensamento
oponente	competidor/contendor
oportunidade	possibilidade/chance
opositor	competidor/contendor
oposição	resistência/acção/atividade/ato/ação/conexão/relação
opulência	abundancia/riqueza/poder
opção	decisão
oração	requerimento/requisição/solicitação/pedido/petição/apelo
ordem	comando/estado/associação/estrato/situação/sociedade/condição/estado/união/organização/classe/arranjo
ordenado	prestação
ordenação	organização
organismo	ser
organização	agrupação/comunidade/atividade/conjunto/início/ocupação/começo/grupo
orgulho	emoção/sentimento/impressão
orientador	superior
orientação	atitude/controlo/controle
orifício	canal
origem	infra-estrutura/instalação/interseção/início/começo/princípio
orla	formação
ornamento	adorno/ornato/decoração/artefato/decoração
ornato	artefato
ouriço-do-mar	equinodermo/equinodermos
outono	sazão/estação/tempo/período
ouvida	percepção
ouvinte	oportunidade/chance
ouvintes	reunião
oval	cónica/cônica
ovelha	bovídeos
ovinos	bovídeos
ovo	alimento
pacote	colecção/coleção/aglomeração/acúmulo/contentor/contêiner/recipiente
pagamento	comercialismo/mercantilismo/comércio/gastos/custos/preço/custo
pai	genitor/progenitor/mãe/genitor
painho	genitor/progenitor/pai/mãe
paixão	objecto/objeto/objetivo
palestra	discurso
paliçada	barreira/obstáculo
palácio	autoridades/regime/governo
pano	têxteis/peça/tecido/fazenda/pedaço/artefato
papai	genitor/progenitor/pai/mãe
papel	materiais/dever/obrigação/caracterização
papá	genitor/progenitor/pai/mãe
par	jogo/grupo/reunião
parada	acção/chegada/feito/ato/conclusão/área/região/resultado/ação/fim/final/romaria/travessia/procissão/viagem
parafernália	equipamento/ferramenta
paragem	área/região
paralisação	acção/feito/ato/ação
paralização	acção/feito/ato/ação
paraquedismo	descensão
parasita	organismo/ser
paraíso	região
parcela	repartição/divisão
parede	edifício/tecido/estrutura/divisória/paredes
paredes	edifício/tecido/estrutura
parelha	jogo/grupo
parente	alguém/indivíduo/alma/pessoa
parentesco	conexão/relação
parlamento	legislatura
parque	gleba/terreno/região
parreira	traqueófitos
parte	alguém/fatia/indivíduo/música/objeto/alma/pessoa/documentos/repartição/porção/coisa/componente/divisão
partida	certame/concurso/acção/competição/feito/torneio/ato/ação/jogo/rodada/turno/jogo/tempo
partido	organização
partilha	distribuição
partição	distribuição/separação
partícula	materiais/corpo
partículas	corpo
parábola	cónica/cônica
paródia	mímica/imitação
passado	etapa/tempo/período/tempo
passagem	via/estrada/caminho
passatempo	recreaçao/diversão
passeata	romaria/procissão
passeio	travessia/jornada/viagem
passivo	maldade
passo	locomoção/decisão/resolução
pastel	fornada
pata	pe
patch	pano
paternidade	parentesco/relação
pau	implemento/instrumento/barra/ferramenta
pausa	ocorrente/ociosidade/ocorrência/acontecimento/intervalo/tempo
pavimento	edifício/tecido/estrutura
pecado	transgressão
peculiaridade	atributo/predicado/característica/propriedade
pecuária	cultivo
pedagogia	profissão
pedagogo	profissional
pedaço	porção/aglomeração/porção/coisa/parte
pedestal	encosto/apoio/suporte
pedra	materiais/rocha
pedregulho	rocha/pedra
pegada	contato/toque
pegar	contato/toque
peito	anatomia/colo/tórax
peleja	conflito/luta
película	espectáculo/show/bens/produto/produção
penhasco	formação
pensamento	convicção/crença/fé/opinião
pente	aparato/dispositivo/aparelho/equipamento/mecanismo/instrumento/ferramenta
percurso	fronteira
perda	chegada/conclusão/resultado/fim/final/fracasso/declínio/desastre/falha/custo/diminuição/erro
perfeição	situação/condição/estado
performance	acção/atividade/ato/ação
pergunta	requerimento/requisição/solicitação/pedido/petição/inquérito/questão/apelo
perigo	causador/estado/situação/condição/estado/causa
periodista	autor/escritor
perissodáctilos	ungulados
perito	especialista
periódico	publicação/edição/jornalismo/imprensa/jornal
permanência	acção/feito/ato/ação
perna	encosto/apoio/membro/suporte/calça/membro
perseguição	abuso/injúria/traslado/deslocamento/movimento
personagem	adulto/caracterização
personalidade	feição/peculiaridade/temperamento/pessoa/atributo/predicado/característica/propriedade
personificação	atuação/representação/interpretação
perspectiva	orientação
perspicácia	convicção/crença/fé/opinião
persuasão	comunicado/comunicação
pertinência	relação/ligação
período	etapa/século/continuidade/duração/era/idade/época/tempo
pesar	desgosto/emoção/mágoa/sentimento/tristeza/impressão/dor
peso	medida/medição/unidade
pesquisa	investigação
pessoa	alguém/causador/indivíduo/alma/causa/atributo/organismo/predicado/característica/propriedade/ser
pessoal	população/gente/organização/povo/agrupação/conjunto/grupo
petisco	alimentação/nutriente/nutrição/comida/alimento
petição	requerimento/requisição/solicitação/pedido/apelo
petróleo	carburante/combustível/hidrocarboneto
pezunho	pe/pata
peça	moeda/porção/parte
peçonha	substância
piada	contas/reporte/relato/relatório
piazza	praça
pico	fim/final
piedade	camaradagem/simpatia/socorro/emoção/sentimento/ajuda/compaixão/assistência/impressão
pigmento	camada/capa/colorante/corante/tinta/cor
pigmentos	colorante/corante/tinta/cor
pilha	colecção/coleção/aglomeração/acúmulo
pimenta	arvoreta/arbusto/mato/moita
pimentão	arvoreta/arbusto/mato/moita
pincel	implemento/instrumento/ferramenta
pintura	ofício/arte/camada/profissão/capa/colorante/corante/tinta/cor
pipeline	aqueduto/conduto/ducto/duto/canal
pirâmide	poliedro/poliedros
piso	edifício/tecido/estrutura
pista	infra-estrutura/evidência/instalação
pixel	componente/parte
pião	brinquedo
placa	artefato/chapa/lousa/bloco
placar	chegada/conclusão/resultado/fim/final
planejamento	ideia
planeta	astro/estrela
plano	conceito/idéia/pensamento/opinião/formato/forma
planos	programa
planta	organismo/ser
plantação	terras/fazenda
plantel	prédio/edifício
plantio	terras/fazenda
planície	chão/relevo/solo/terra/campanha
planícies	planície/campanha
plastico	sólida/sólido
plástico	sólida/sólido
plásticos	sólida/sólido
poder	causador/cognição/noção/conhecimento/causa/compreensão/qualidade
poeta	autor/escritor
poetas	autor/escritor
poetisa	autor/escritor
poliedro	sólida/sólido
poliedros	sólida/sólido
poluição	contaminação
política	argumentação/raciocínio/profissão
político	líder/chefe
ponta	fim/final
pontapé	porrada/golpe
pontaria	propulsão/impulsão
ponte	edifício/tecido/estrutura
ponto	objeto/área/região/ocorrente/ocorrência/fator/acontecimento/disco/componente/parte
popularidade	qualidade
população	gente/pessoal/povo/agrupação/conjunto/grupo
popô	anatomia
porrada	golpe
porrete	bastão/pau/vara
porta	abertura
porvir	tempo
porão	pavimento/piso/andar
porção	objeto/coisa/fragmento/pedaço
pose	certeza/segurança
posicionamento	atividade/ocupação
posição	status/estado/ofício/profissão/ocupação/situação/condição/emprego/estado/função/serviço/trabalho/lugar/classe/colocação/localização/orientação/local/função/posto/papel/lugar
posse	conexão/relação
possessão	propriedade/controlo/posse/conexão/propriedade/controle/relação/bem
possibilidade	intercorrência/opção/conceito/alternativa/concepção/eleição/escolha/idéia/ideia/existência/existência/ser
possuidor	alguém/indivíduo/alma/pessoa
poster	anúncio
posto	status/infra-estrutura/ofício/instalação/profissão/ocupação/condição/emprego/estado/função/serviço/trabalho/lugar/classe/posição
potencia	poder
potenciabilidade	possibilidade/chance
potencial	possibilidade/chance
potpourri	colecção/coleção/aglomeração/acúmulo
potência	força/poder
pousada	hotel
povo	humano/população/gente/pessoal/família/agrupação/conjunto/grupo
povoado	municipalidade/município/comunidade
poça	água
prata	moeda
prato	alimentação/nutriente/nutrição/comida/alimento
prazer	emoção/sentimento/impressão
prazo	etapa/tempo/período/instante/momento
praça	gleba/terreno/região
precipitação	clima/tempo/traslado/deslocamento/movimento
predadores	criatura/animal/besta/bicho/ser
predicado	abstração
predominância	vantagem/virtude/propriedade/recurso/bem
prefeito	político
prejuízo	alteração/modificação/variação/mudança/custo
preleção	discurso
prenome	antenome/nome
preocupação	abalo/comoção/emoção/sentimento/ânsia/ansiedade/interesse
preparação	ideia/atividade/ocupação
presa	criatura/animal/besta/bicho/ser
prescrição	instrução
presente	aquisição/tempo
presença	existência/existência/ser
presidente	líder/chefe/executivo
preso	desafortunado/desventurado/infortunado
pressuposição	possibilidade/suposição/teoria/hipótese
presságio	mensagem/comunicação
pressão	prensada
prestação	pagamento/recompensa
pretensão	apetite/anseio/desejo/emoção/sentimento/impressão
preço	despesa/gasto/importância/valor/gastos/custos/preços/custo/qualidade
preços	importância/valor/preço/qualidade
prima	parente
primata	mamífero
primatas	mamífero
primavera	sazão/estação/tempo/período
primeiro	hierarquia/posto/classe/posição
primo	parente
princípio	ocorrente/ocorrência/acontecimento/instante/início/começo/momento
prisioneiro	desafortunado/desventurado/infortunado
prisão	situação/condição
problema	dificuldade/obstáculo/ocorrente/ocorrência/acontecimento/dificuldade/obstáculo
procedimento	feição/peculiaridade/software/programa/atividade/ocupação/tarefa/trabalho
procedência	lugar
processo	atividade/ocupação
procissão	romaria
procurar	atividade/ocupação
produto	artefato/bens/bens/mercadoria/criação/fazenda/produção/artigo/bem
produtor	fazedor
produção	espectáculo/indústria/manufatura/show/bens/criação/produto
proeza	feito/conquista/façanha/realização/feito/façanha/realização
professor	autoridade/educacionista/pedagogo/educador/acadêmico
profissional	adulto
profissão	ofício/ocupação/emprego/função/serviço/trabalho/lugar
profundeza	região
progenitor	antecessor/ancestral/antepassado/genitor
progenitora	genitor/progenitor/pai/mãe
programa	espectáculo/projecto/software/conceito/programação/código/idéia/pensamento/show/projeto/opinião/intenção/plano
programação	conceito/idéia/pensamento/opinião
progresso	transmutação/transformação/mudança
progressão	traslado/deslocamento/movimento
projecto	conceito/idéia/pensamento/opinião
projeto	conceito/idéia/pensamento/opinião/tarefa/trabalho
projeção	convexidade
prole	criatura/animal/besta/bicho/ser
promoter	booker
promoção	ocasião/vez/chance/mudança
proponente	alguém/indivíduo/alma/pessoa
proporção	grandeza/magnitude/número
proposta	mensagem/tópico/assunto/conteúdo
propriedade	conceito/concepção/idéia/ideia/abstração/controlo/atributo/predicado/posse/característica/conexão/controle/relação/bem
proprietário	alguém/homemdenegócios/indivíduo/empresário/negociante/alma/comerciante/pessoa
propulsão	acção/feito/ato/ação
propósito	utilidade
protecção	atividade/ocupação/proteção/capa
protesto	resistência
proteção	aprovaçã0/combate/batalha/aprovação/cobertura/atividade/ocupação/capa
proteína	macromolécula
proto-plasma	substância
protoctista	microorganismo/microrganismo
protoplasma	substância
prototista	microorganismo/microrganismo
protozoário	protoctista/prototista
protuberância	projeção
prova	evidência
provedor	empresário
provimento	atividade/ocupação
provisões	nutriente/comida/alimento
provérbio	locução/ditado/expressão/idioma
prudência	sagacidade/sapiência/sabedoria/sensatez
prática	treinamento/treino/preparação
pré-história	etapa/tempo/período
prédio	edifício/tecido/estrutura
prémio	dádiva/brinde/dom/doação/presente
prêmio	dádiva/brinde/dom/doação/presente
psicologia	ciência
psicose	psicopatia/psicopata
psique	cognição/noção/conhecimento/compreensão
puberdade	época/período
publicação	obra/trabalho
pugna	conflito/luta
pulo	propulsão/impulsão/transição
pulsação	onda
pulverização	esmagamento/compactação
pupilo	estudante
putrefação	atividade/ação
puxão	propulsão/impulsão
página	folhas/folha
páramo	planície/campanha
pássaro	vertebrado
pânico	consternação/temor/terror/medo
pão	fornada
pãozinho	pão
pé	encosto/apoio/suporte/fundo/base/traseiro
pérola	esfera
píxel	componente/parte
pó	sólida/sólido
pôster	anúncio
público	reunião
quadra	território/ambiente/área/região
quadrado	número
quadrilha	associação/sociedade/união/organização/ordem
quadro	chapa/lousa/placa
qualidade	conceito/atributo/concepção/característica/idéia/importância/valor/propriedade/ideia/atributo/predicado/característica/propriedade
quantidade	conceito/concepção/grandeza/idéia/magnitude/ideia/número
quarteirão	território/ambiente/área/região
quartos	alojamento/abrigo/casa
quebra	ocorrente/ocorrência/acontecimento
queda	alteração/pecado/modificação/variação/mudança/descensão
queijo	lacticínio/laticínio/comida
queixa	objeção
queixo	traço
querela	desacordo/discordo/discrepância/discórdia/discordância
querosene	carburante/combustível/hidrocarboneto
quesito	pergunta/inquérito/questão
questão	requerimento/pergunta/requisição/solicitação/pedido/petição/inquérito/apelo
quimica	ciência
quinta	laboratório/oficina/emprego/trabalho
química	materiais/ciência
rabo	anatomia
racha	vão/fenda
raciocinio	ideia
raciocínio	ideia/raciocinio/razoamento/argumentação
radiação	energia
radiações	energia
radical	unidade
rainha	insectos/insetos/hemípteros/insecto/inseto
raiva	abalo/zanga/comoção/ira/cólera/emoção/sentimento
raiz	órgão/lugar
ralé	galera/vulgo/nação/gente/pessoal/povo
ramo	caule/departamento/divisão/tronco
ranhura	fresta/buraco/fenda
rapariga	mulher/fêmea
rapaz	criança/filho/menino/varão/macho/homem
rapidez	ritmo/passo
rasgo	vão/fenda
rasgão	vão/fenda
ratazana	roedor
rato	roedor
rattus	roedor
razoamento	ideia
razão	faculdade/talento
raça	categoria/família/classe/agrupação/conjunto/grupo
ração	nutriente/comida/alimento
raíz	órgão
reajuste	calibração
realidade	existência/existência/experiência/ser
realização	acção/feito/conquista/façanha/ato/ação/acção/atividade/ato/ação
reação	oposição/atividade
rebatida	proeza/feito/façanha/realização
rebelião	conflito/luta
recebimento	aquisição
recipiente	contentor/contêiner/apetrecho/equipamento/instrumento
reciprocidade	conexão/relação
recomendação	proposta
recompensa	gastos/custos/pagamento/preço/custo
reconhecimento	mensagem/tópico/assunto/conteúdo
recontro	situação/condição/estado
recorrência	repetição
recreaçao	atividade/ocupação
recta	linha
recuperação	acção/feito/ato/ação
recurso	convencimento/persuasão/catequizar
recém-nascido	criança/filho/menino
rede	têxteis/pano/tecido/fazenda
refeição	alimentação/nutriente/nutrição/comida/alimento
reflexão	demo/demonstração
reforma	melhoramento/melhoria
refutação	evidência
refém	desafortunado/desventurado/infortunado
refúgio	edifício/tecido/estrutura/território/ambiente/área/região
regato	córrego/corrente
registo	registro
registrador	registro
registro	ingresso/documento/evidência/indicação/entrada
região	regiões/locação/localização/ponto/lugar/anatomia/lugar
regiões	locação/localização/ponto/lugar
regra	instrução
regresso	traslado/chegada/deslocamento/vinda/movimento
regularidade	qualidade
regulação	calibração
reino	agrupação/conjunto/domínio/grupo
reivindicação	queixa
rejeição	acção/feito/ato/ação
relacionamento	situação/condição/estado/conexão/relação
relato	documentação/documento/informação
relatório	documentação/documento/informação
relação	abstração/situação/condição/estado/conexão/ligação
relevo	objeto
relevância	relação/ligação
religião	convicção/crença/estabelecimento/instituição/instituto/fé/opinião
relva	ervas/gramínea/gramíneas/erva
relógio	metro
relógios	relógio
remendo	pano
remo	esporte
remorso	tristeza/pesar
remuneração	prestação/recompensa
remédio	entorpecente/droga/medicamento/agente
rendimento	produção
rendição	derrota/perda
renome	honra
reorientação	mudança
reparação	melhoramento/melhoria
reparo	melhoramento/melhoria
repartição	distribuição
repasto	alimentação/nutriente/nutrição/comida/alimento
reporte	documentação/documento/informação
reposteiro	cortina/mobília/mobiliário/móvel
representante	alguém/indivíduo/alma/pessoa/negociador/informação/conhecimento
representação	colaboração/cooperação/atividade/ocupação/criação
reprodução	afiguração/representação/imagem/figura/ilustração/desenho
repugnância	aversão
repulsa	ódio/aversão
residuo	matéria/substância
residência	endereço/alojamento/abrigo/casa
resistência	oposição
resolução	selecção/escolha/seleção
respeito	atitude
respiração	atividade
responsabilidade	maldade
responsável	líder/chefe
resposta	afirmação/atividade/declaração
ressentimento	ódio/aversão
restante	categoria/porção/componente/parte
restaurante	prédio/edifício
restituição	compra/aquisição
resto	categoria/objeto/porção/componente/parte/pano
restrição	regulamentos/aparato/dispositivo/regulação/aparelho/equipamento/mecanismo/instrumento/ferramenta
resultado	fenómeno/fenômeno/placar/chegada/conclusão/fim/final/afirmação/declaração
resíduo	materiais/categoria/porção/componente/parte
reta	linha
retardar	ociosidade
retificação	melhoramento/melhoria
retorno	traslado/chegada/deslocamento/vinda/compra/aquisição/movimento
retrato	afiguração/representação/imagem/figura/ilustração/desenho
retribuição	prestação
reunião	assembléia/agrupamento/agregação/coleção/convergência
reversão	reorientação
reviravolta	mudança
revista	publicação/edição/bens/produto/produção
revisão	prática/exercício/inspecionar/examinar
revogação	sentença/julgamento
revolta	conflito/luta
revés	ocorrente/ocorrência/acontecimento
revólver	armamento/arma
revóvel	armamento/arma
reza	requerimento/requisição/solicitação/pedido/petição/apelo
ribeira	córrego/corrente
rigor	dificuldade
rio	córrego/corrente
riqueza	possessão/propriedade/abundancia/poder
risco	causador/causa/maldade
rito	costume/emprego/hábito
ritual	costume/hábito/costume/emprego/hábito
rival	competidor/contendor
rocha	materiais/pedra
rochedo	rocha/pedra
roda	máquina
rodada	quantia/quantitativo/medida/quantidade
rodovia	via/estrada/caminho
roedor	mamífero
rolamento	propulsão/impulsão
romance	relacionamento/relação
roque	edifício/tecido/estrutura
rosa	arvoreta/arbusto/mato/moita
rosas	arvoreta/arbusto/mato/moita
rosto	alguém/semblante/indivíduo/aspecto/alma/pessoa/aparência/semblante/aparência
rota	fronteira
rotação	mudança
rotina	atuação
rotulagem	acontecimento/festa
roubo	crime
roupa	vestimenta/cobertura/vestuário/traje/capa/vestido
rufo	ruído/som
ruga	impressão
ruminante	artiodáctilos/artiodátilos/artiodátilo/ungulados
ruminantes	artiodáctilos/artiodátilos/artiodátilo/ungulados
rumo	itinerário/itinerários/percurso/rota/linha/estrada/caminho
ruído	problema/ocorrente/ocorrência/acontecimento/som
ruína	demolição/destruição/desolação/apodrecimento/putrefação/deterioração/decomposição
récorde	obtenção/realização
répteis	vertebrado
réptil	vertebrado
sabedoria	feição/peculiaridade
saber	compreensão
sabonete	clareador
sabor	sensação
sabão	clareador
sacada	edifício/tecido/estrutura
sacanagem	recreaçao/diversão
saco	contentor/contêiner/recipiente
sacola	contentor/contêiner/recipiente
sacolejo	agitação
safra	rendimento
sagacidade	feição/peculiaridade/inteligência
saia	vestuário/roupa
sala	aposento/quarto
salada	prato
saliência	projeção
salto	propulsão/impulsão/transição
salvamento	recuperação
salvação	recuperação
salário	prestação
salão	prédio/edifício
sangue	genealogia
santo	deidade/deidades/divinidade/deus/deusa/divindade/deus
sapiência	feição/peculiaridade
saudade	apetite/pretensão/anseio/desejo/anelo/anseio/desejo
saudação	reconhecimento
sazão	etapa/tempo/período
saída	partida/instante/abertura/momento
secas	estado/situação/condição/estado
secretaria	agência/escritório
secretária	criado/ajudante/assistente/servidor/mesa
secretário	criado/ajudante/assistente/servidor
secura	estado/situação/condição/estado
secção	coisa
seda	têxteis/pano/tecido/fazenda
sedan	auto/automóvel/viatura/carro/veículo
sedativo	medicamento/remédio
sedimento	matéria/substância
sedã	auto/automóvel/viatura/carro/veículo
segmentação	separação
segmento	tomo/secção/porção/pedaço/parte
segredo	informação
seguidor	alguém/indivíduo/alma/pessoa
segundo	instante/momento
segurança	estado/situação/condição/estado
seguro	abrigo/proteção/activos/ativos/bens/recursos/ativo
seguros	abrigo/proteção
seio	anatomia
selecção	acção/decisão/atividade/ato/ação
seleção	acção/atividade/ato/ação
selo	simbolo/símbolos/aceno/emblema/símbolo/sinal
selva	chão/locação/relevo/localização/solo/terra/ponto/lugar/bioma/biomas
semana	etapa/tempo/período
semblante	aspecto/aparência/qualidade
semelhança	similardidade/qualidade
semestre	período
seminário	aula/curso
senda	trilha/estrada/caminho
senhor	homem/governante/governador
senhora	mulher
senhorita	mulher
sensatez	feição/peculiaridade
sensação	percepção/triunfo/êxito/sucesso
sentido	conceito/idéia/pensamento/opinião/faculdade/talento
sentimento	emoção/impressão
sentinela	guarda
sepultura	área/região
sequência	ordenação/ordem
ser	alguém/indivíduo/alma/pessoa/organismo/situação/condição/estado
serra	formação
servidor	funcionário/serventuário/trabalhador
serviço	dever/obrigação
sessão	encontro/reunião
sesta	etapa/tempo/período
sexo	atividade
seção	fatia/música/documentos/porção/parte
show	atuação
significado	conceito/idéia/pensamento/importância/magnitude/opinião/mensagem/tópico/assunto/conteúdo
significação	importância/magnitude/mensagem/tópico/assunto/conteúdo
significância	mensagem/tópico/assunto/conteúdo
simbolo	sinal
similardidade	semelhança/qualidade
simpatia	emoção/sentimento/impressão
sina	estado
sinal	mensagem/comunicação/mudança
sindicato	associação/sociedade/união/organização/ordem
sintoma	evidência
sistema	metodo/método/métodos/técnica/agrupação/anatomia/apetrecho/equipamento/conjunto/instrumento/grupo
situação	estado/condição/estado/atributo/predicado/característica/condição/estado/propriedade
sobra	categoria/porção/componente/parte/pano
sobrecarta	contentor/contêiner/recipiente
sobremesa	prato
sobrenome	antenome/prenome/nome
sobrescrito	contentor/contêiner/recipiente
sobretudo	vestuário/roupa
sociedade	associação/união/organização/ordem
socorro	auxílio/ajuda/assistência/atividade/ocupação
software	código
sol	luz
solenidade	ritual
solo	materiais/objeto
solos	objeto
soluto	solução/mistura
solução	substância/mistura
som	ocorrente/ocorrência/acontecimento/sensação
soma	conceito/concepção/idéia/quantidade/ideia/número/todo/unidade
sombreiro	chapéu
sonho	perfeição
sono	etapa/tempo/período
sopa	prato
soror	membro
sorte	fenómeno/fenômeno/ocorrente/ocorrência/acontecimento/estado
sota	insectos/insetos/hemípteros/insecto/inseto
sub-figura	figura
sub-rotina	software/programa
subida	formação
subrotina	software/programa
substância	materiais/categoria/matéria/porção/componente/parte
subtileza	dificuldade
sucesso	triunfo/êxito/obtenção/realização
sucessão	ordenação/sequência/série/atividade/ação
sujeito	varão/macho/homem
sulco	impressão
sumptuosidade	abundancia/riqueza/poder
suntuosidade	abundancia/riqueza/poder
superfície	camada/estrato/artefato/fronteiras/fronteira/limite
superior	líder/chefe
superioridade	estado/situação/condição/estado
supervisor	orientador/superior
suporte	encosto/apoio/auxílio/socorro/ajuda/assistência/aparato/dispositivo/aparelho/equipamento/atividade/mecanismo/ocupação/instrumento/ferramenta
suposição	conceito/concepção/possibilidade/idéia/teoria/hipótese/ideia
suprimentos	nutriente/comida/alimento
surpresa	alteração/modificação/variação/mudança/emoção/sentimento/impressão
surto	ocorrente/ocorrência/acontecimento
suspensão	solução/intervalo/mistura/tempo
sutileza	dificuldade
século	etapa/tempo/período
séculos	etapa/tempo/período
série	sequência/ordem
símbolo	simbolo/símbolos/aceno/emblema/sinal
símbolos	sinal
sítio	laboratório/oficina/emprego/trabalho/gleba/terreno/região
sólida	matéria/substância/formato/forma
sólido	matéria/substância/formato/forma
sótão	pavimento/piso/andar
súdito	alguém/indivíduo/alma/pessoa
súplica	requerimento/requisição/solicitação/pedido/petição/apelo
tabela	array/ordem
tabuleiro	superfície
tacada	esforço/tentativa
tacto	tempo
talento	cognição/noção/conhecimento/compreensão/capacidade/poder/habilidade
tamanco	calçados/calçado
tamanho	grandeza/magnitude/número
tampa	cobertura/capa
tapete	cobertura/capa
taramela	apêndice
tarde	etapa/tempo/período/jornada/dia
tarefa	dever/obrigação/atividade/ocupação/trabalho
taxa	gastos/custos/dívida/imposto/preço/custo/obrigação
taxação	imposto
taxi	auto/automóvel/viatura/carro/veículo
teatro	prédio/edifício/comunicado/comunicação
tecido	anatomia/artefato
tecla	aparato/dispositivo/aparelho/equipamento/mecanismo/instrumento/ferramenta
tecnologia	disciplina/campo/domínio
telefone	sinal
telegrama	mensagem
telhado	proteção/capa
tema	conceito/idéia/pensamento/opinião/mensagem/tópico/assunto/conteúdo
temor	abalo/comoção/emoção/sentimento/ânsia/ansiedade/preocupação
temperamento	índole/atributo/natureza/predicado/característica/propriedade
tempero	ingrediente
templo	prédio/edifício/casadeoração/igreja
tempo	etapa/período/quantia/atributo/predicado/quantitativo/característica/medida/quantidade/propriedade
temporada	etapa/tempo/período
tenda	asilo/refúgio
tendência	atitude
tendências	sabor
tentativa	esforço/atividade/ocupação
teoria	conceito/concepção/idéia/ideia/explanação/explicação
terapia	medicamento/remédio
terno	vestuário/roupa
terpena	tristeza/pesar
terra	chão/relevo/objeto/solo/solo
terras	imobiliária/imóvel
terreno	gleba/região
território	regiões/região
terror	abalo/comoção/consternação/emoção/sentimento/temor/medo
testa	traço
teste	esforço/tentativa/comunicado/comunicação
teto	proteção/capa
texto	documentos
thread	materiais
tinta	materiais/camada/capa/colorante/corante/cor
tintura	colorante/corante/tez/tinta/cor
tio	parente
tipo	adulto/categoria/família/classe/categoria/espécies/raça/género/classe
tira	tomo/secção/porção/pedaço/parte
tiro	ataque/propulsão/impulsão
tocador	intérprete
todo	objeto
tom	tez/cor
tomo	coisa
topo	região
toque	acção/feito/ato/ação/ocorrente/ocorrência/acontecimento/som
torneio	certame/concurso/competição/partida/jogo
torre	edifício/tecido/estrutura
torres	edifício/tecido/estrutura
torrão	aglomeração
torso	anatomia
torção	rotação
totalidade	conceito/concepção/idéia/ideia/todo/unidade
totalizar	soma/quantidade/número
toxinas	substância
trabalhador	alguém/indivíduo/alma/pessoa
trabalho	bens/atividade/ocupação/tarefa/produto/produção
traição	desonestidade
traje	vestimenta/cobertura/vestuário/capa/roupa/vestido
trama	têxteis/pano/tecido/fazenda
tramitação	debate/discussão
transa	atividade
transação	negócio
transferência	movimento
transformação	alteração/modificação/variação/mudança
transgressão	delito/atividade/ocupação
transito	colecção/coleção/aglomeração/acúmulo
transição	alteração/modificação/variação/mudança
transmissão	comunicado/comunicação
transmutação	alteração/modificação/variação/mudança
transportação	industria/empresa/negócio/comércio
transporte	industria/empresa/negócio/comércio/movimento
trapeira	pavimento/piso/andar
traqueófitos	flora/planta/vegetal
traseiro	anatomia/componente/região
traslado	mudança
tratamento	assintência/gestão/cuidado/administração
trava	obstrução/impedimento/obstáculo
travessia	traslado/deslocamento/movimento
travessura	recreaçao/diversão
traço	anatomia
tração	propulsão/impulsão
trecho	continuidade/duração
treinamento	atividade/ocupação
treino	atividade/ocupação
tremedeira	consternação/temor/terror/medo
tremor	consternação/temor/terror/medo
tremura	consternação/temor/terror/medo
trevas	iluminação
tribunal	assembleia/assembléia
tributo	imposto
trilha	evidência/curso/caminho/via/estrada/caminho
trilho	trilha/estrada/caminho
trilhos	trilha/estrada/caminho
trimestre	etapa/tempo/período
trinado	ruído/som
trinco	apêndice
tristeza	desgosto/emoção/mágoa/sentimento/impressão/dor/pesar
trituração	esmagamento/compactação
triunfo	obtenção/realização
tronco	anatomia/órgão
tropa	turba/montão/multidão
trote	recreaçao/diversão
tráfego	colecção/coleção/aglomeração/acúmulo
tránsito	colecção/coleção/aglomeração/acúmulo
trâmite	acção/atividade/ato/ação
trânsito	colecção/coleção/aglomeração/acúmulo
tubo	aqueduto/conduto/ducto/duto/canal
tumba	área/região
tumor	tumores
tumores	enfermidade/doença
turba	montão/multidão/reunião
turfa	húmus
turista	alguém/indivíduo/alma/pessoa
turma	reunião
turno	quantia/quantitativo/medida/componente/quantidade
tutela	protecção/proteção
tábua	chapa/lousa/placa
táctica	programa
tática	programa
táxi	auto/automóvel/viatura/carro/veículo/carruagem
tâmara	fruta
técnica	capacidade/poder/habilidade/talento
términio	chegada/conclusão/resultado/fim/final
têmpora	traço
têxteis	artefato
título	antenome/prenome/nome/denominação/antenome/prenome/nome
tópico	mensagem/comunicação/mensagem/assunto/conteúdo/coisa
tóxico	substância
túmulo	área/região
umbigo	lugar
ungulados	perissodáctilos/mamífero
unidade	categoria/objeto/porção/componente/parte/totalidade/coisa
unificação	composição/combinação
uniforme	vestimenta/vestuário/traje/roupa/vestido
universidade	estabelecimento
universo	colecção/coleção/aglomeração/acúmulo
união	organização/jogo/grupo/situação/condição/estado/ligação
ursídeos	brinquedo
usina	fábrica/planta
uso	acção/feito/ato/ação/atividade/ocupação
utensílio	implemento/instrumento/ferramenta
utilização	uso/atividade/ocupação
vaga	movimento
vale	depressão
validade	legalidade
valor	qualidade
valência	poder
vantagem	virtude/propriedade/recurso/bem
vapor	embarcação/navios/navio/barco/suspensão
vara	implemento/instrumento/ferramenta
varanda	edifício/tecido/estrutura
variante	espécie/variedade/género/tipo/classe
variação	alteração/modificação/mudança/ocorrente/ocorrência/acontecimento
variedade	categoria/espécies/raça/género/tipo/classe
varão	alguém/indivíduo/alma/pessoa
vasilha	contentor/contêiner/recipiente
vasilhame	contentor/contêiner/recipiente
vaso	condutas/tubo/contentor/contêiner/recipiente
vegetal	hortifruti/hortifruto/verdura/hortaliça/legume/organismo/ser
vegetação	colecção/coleção/aglomeração/acúmulo
vela	pano
velhice	época/período
velho	adulto
velocidade	ritmo/passo/ritmo
vencimento	chegada/conclusão/resultado/fim/final/desastre
venda	comercialismo/shopping/mercantilismo/comércio
veneno	substância
ventilador	aparato/dispositivo/aparelho/equipamento/mecanismo/instrumento/ferramenta
vento	clima/tempo
ventre	anatomia
verdade	informação/conhecimento
verdura	hortifruti/hortifruto
vergonha	desonra/emoção/sentimento/impressão
verificação	fiscalização/inspecção/vistoria/inspeção/teste
verme	invertebrados/invertebrado/larva
vermelho	custo
versão	espécie/variedade/género/tipo/classe
vertebrado	cordados
verão	sazão/estação/tempo/período
vespa	himenópteros
vestido	vestimenta/cobertura/vestuário/traje/capa/roupa
vestimenta	cobertura/capa
vestuário	vestimenta/cobertura/traje/capa/roupa/vestido
vez	ocorrência/instância/ocasião/caso/exemplo/atividade/ocupação
veículo	apetrecho/equipamento/instrumento
via	artefato/estrada/caminho
viagem	travessia/traslado/deslocamento/movimento
viajante	alguém/indivíduo/alma/pessoa
vianda	comida
viatura	veículo
victimização	maltrato
vida	alguém/etapa/indivíduo/motivação/alma/necessidade/motivo/pessoa/intenção/tempo/período/existência/existência/organismo/experiência/ser
videira	traqueófitos
vidro	louça/sólida/sólido
vigia	designação/tarefa
vigor	força
vigília	guarda
vila	municipalidade/município/comunidade
vinda	acção/chegada/atividade/ato/ação
vindouro	tempo
vinho	álcoois/álcool
violência	agressão/hostilidade/intensidade
virada	conjuntura/ocasião/ponto
virtude	importância/valor/qualidade
visita	visitante/turista/viajante
visitante	visita/turista/viajante
visitação	visita
vistoria	inspecionar/examinar
visão	orientação
vitória	chegada/conclusão/resultado/fim/final/ocorrente/ocorrência/acontecimento
viveiro	prédio/edifício
viveirodeplantas	terras/fazenda
vivenda	morada/aposento/moradia/prédio/domicílio/residência/edifício/habitação/lar/casa
vizinhança	circunscrição/comarca/districto/distrito/território/domínio/comunidade
vizinho	alguém/indivíduo/alma/pessoa
vocação	comunidade/grupo
volta	chegada/vinda
vontade	faculdade/talento
votação	selecção/escolha/seleção
voto	comunidade/selecção/escolha/seleção/grupo
vovozinha	avós/avó/avô
vovó	avós/avó/avô
vovô	avós/avó/avô
voz	mensagem/comunicação/som
vulgo	população/gente/pessoal/povo
vácuo	região
vão	espaço/abertura
vértice	lugar
véspera	jornada/dia
víscera	órgão
zanga	abalo/comoção/emoção/sentimento
zona	área/região
ábside	nicho
água	infra-estrutura/instalação/líquido/coisa
álcool	álcoois
ápice	nível/fase/situação/condição/estado/grau
árbitro	alguém/indivíduo/alma/pessoa
área	regiões/região/matéria/tópico/assunto/tema/lugar
ático	pavimento/piso/andar
átomo	materiais/substância
âmbito	ambiente
ângulo	espaço
ângulos	espaço
ânimo	caráter/personalidade
ânsia	abalo/comoção/emoção/sentimento
ânus	anatomia
égua	equino/equídeo/ungulados
época	etapa/tempo/período
ética	motivação/necessidade/motivo/intenção
êxito	obtenção/realização
íman	aparato/dispositivo/aparelho/equipamento/mecanismo/instrumento/ferramenta
ímã	aparato/dispositivo/aparelho/equipamento/mecanismo/instrumento/ferramenta
índices	registro
índole	feição/peculiaridade
ódio	abalo/comoção/emoção/sentimento
óleo	lipido/lipídio/lípido/lípidos/gordura
ópio	narcótico
órgão	anatomia/agência/escritório/fragmento/parte
ósculo	contato/toque
óvulo	gameta/gâmeta
