abaxial	biologia
abducente	fisiologia
ablativo	lingüística/linguística/lingüística
acusativo	gramática
acíclico	quimica/química/botanica/botânica
adiabático	física
aerodinâmico	física
aferente	fisiologia
ajustado	psicologia
alcalino	quimica/química
alienável	jurisprudência/lei
alternado	electricidade/eletricidade
alternativa	electricidade/eletricidade
alterno	electricidade/eletricidade
anal	psicanálise
analítico	matematica/matemática/lingüística/linguística/lingüística/lógica
analógico	electrónica/eletronica/eletrónica/eletrônica
anfotérico	quimica/química
anglicano	religião/fé
anidro	quimica/química
animado	lingüística/linguística/lingüística
anormal	psicologia
anti-ciclonico	meteorologia
antigo	lingüística/linguística/lingüística
anual	botanica/botânica
análogo	biologia
apegado	arquitetura/arquitectura
aprendido	psicologia
aracnídeo	zoologia
aromático	quimica/química
artificial	lógica
artiodátilo	zoologia
astragaler	anatomia
atonal	música
atractivo	drama
atrativo	física
atrial	anatomia
atómico	física/biologia
axial	botanica/botânica
axonal	neurociencia/neurociência/neurologia
aéreo	botanica/botânica
basal	botanica/botânica
basofílico	biologia
benigno	patologia
bi-anual	botanica/botânica
bicapsular	botanica/botânica
bienal	botanica/botânica
bimodal	estatística/estatísticas/estatística
binucleado	biologia
bivalente	genetica/genética
blindado	exército
caduco	biologia
cambial	botanica/botânica
canceroso	patologia
canino	zoologia
capsular	anatomia
carboxil	quimica/química
carboxílico	quimica/química
carnívoro	flora/planta/vegetal
catequismal	religião/fé
celular	organismo/ser
cenogenético	biologia
ciclíco	botanica/botânica
colorido	fotografia
comensal	biologia
compatível	calculadora/computador
composto	botanica/botânica
conectado	transportação/transporte/expedição
congressional	religião/fé
congruente	geometria
contínuo	matematica/matemática
coroado	odontologia
cosmopolita	ecologia
costal	anatomia
cristão	religião/fé
cromático	música
crítico	quimica/física/química
cíclico	quimica/química/botanica/botânica/termodinâmica/botânica
cômico	drama
desarmado	exército
descritivo	gramática
desligado	informática
desvinculado	arquitetura/arquitectura
diacrónico	linguagem/discurso/idioma/língua
diacrônico	linguagem/discurso/idioma/língua
diagonalizável	matematica/matemática
diferencial	matematica/matemática
digital	electrónica/eletronica/eletrónica/eletrônica
dinâmico	física
diplóide	genetica/genética
distal	anatomia
dominante	genetica/genética
dorsal	biologia
dramático	música
duradouro	biologia
ecológico	biologia
endêmico	ecologia
entalhado	literatura
equipado	alfaia/movéis/mobília/mobiliário/móvel
esculpido	literatura
específico	patologia
essencial	jurisprudência/lei
estrutural	geologia
etérico	quimica/química
extracelular	biologia
facultativo	biologia
federal	governação/governo/administração
federativo	governação/governo/administração
filial	genetica/genética
finito	gramática
fornecido	alfaia/movéis/mobília/mobiliário/móvel
funcional	patologia
futuro	gramática
físico	industria/empresa/negócio/comércio
galvânico	electricidade/eletricidade
genitiva	gramática
geomorfológico	geologia
greco-ortodoxo	religião/fé
gregário	criatura/flora/animal/besta/bicho/planta/vegetal/ser
guardado	contrato/acordo
haplóide	genetica/genética
heterológico	biologia
heteródino	electrónica/eletronica/eletrónica/eletrônica
hidrodinâmico	física
hidrofóbica	quimica/química
hidrossolúvel	quimica/química
idiografico	psicologia
ilíaco	anatomia
imanente	filosofia
imperativo	gramática
inanimado	lingüística/linguística/lingüística
incompatível	calculadora/computador
indevido	jurisprudência/lei
indicativo	gramática
indutivo	electricidade/eletricidade
inerme	exército
inespecífico	patologia
infinito	gramática
inflacionário	economia
intercostal	anatomia
interrogativo	gramática
intracelular	biologia
intransitivo	gramática
introvertido	psicologia
inverso	matematica/matemática
invertebrado	zoologia
involuntária	fisiologia
involuntário	fisiologia
irracional	matematica/matemática
isotônico	fisiologia
jogado	jogo
jovem	organismo/ser
lasso	fonética
legato	música
legendado	tv/televisão/tevê
lento	música
luterano	religião/fé
lírico	poema/verso/poesia/música
macho	biologia
magnético	física
maior	jurisprudência/música/lei
maligno	patologia
medido	música
mensurável	música
metabólico	zoologia
metaestável	física
meticuloso	microbiologia
metodista	religião/fé
mobilado	alfaia/movéis/mobília/mobiliário/móvel
mobiliado	alfaia/movéis/mobília/mobiliário/móvel
molecular	psicologia
mongol	antropologia
monoclínico	cristalografia
mononuclear	biologia
monotônico	matematica/matemática
morfológico	geologia
multi-fase	electricidade/eletricidade
médio	lingüística/linguística/lingüística
mórmon	religião/fé
nao-maduro	organismo/ser
natural	música
nocturno	biologia
nominal	gramática/economia
nominativo	gramática
normal	psicologia
normativo	gramática
noturno	biologia
novo	organismo/ser
nublado	meteorologia
nuclear	física/biologia
nítido	meteorologia
off-line	informática
on-line	informática
online	informática/transportação/transporte/expedição
optativo	gramática
opulento	quimica/química/metalurgia
oral	anatomia
orgânico	quimica/química/patologia
ortodoxo	religião/fé
ovíparo	zoologia
parental	genetica/genética
parietal	anatomia
participial	gramática
passivo	gramática
pentavalente	quimica/química
percutâneo	farmacologia
perene	botanica/botânica
plantígrados	mamífero
polifasico	electricidade/eletricidade
polifônico	música
polimórfica	biologia
polimórfico	quimica/química/biologia
polivalente	imunologia
primo	matematica/matemática
probatório	jurisprudência/lei
processual	jurisprudência/lei
progressivo	colectas/impostos/imposto/taxação/taxa/tributo
proporcionado	geometria
racional	matematica/matemática
reage	quimica/física/química
registado	criatura/animal/besta/bicho/ser
regular	exército
residual	jurisprudência/lei
retrógrado	astronomia
revivalista	religião/fé
rico	quimica/química/metalurgia
romano	antiguidade
rápido	música
saturado	quimica/química
saturação	quimica/química
segundo	música
sempre-verde	flora/planta/vegetal
serial	música
sinclinal	geologia
sincrônico	linguagem/discurso/idioma/língua
sintético	lingüística/linguística/lingüística/lógica
sistemático	biologia
staccato	música
subjetivo	filosofia
substancial	jurisprudência/lei
substantivo	jurisprudência/lei
talhado	literatura
tardio	lingüística/linguística/lingüística
taxonômico	biologia
tectônico	geologia
territorial	biologia
tonal	música
transitivo	gramática
triclínico	cristalografia
trágico	drama
unitário	governação/governo/administração
urceolado	biologia
varão	biologia
vertebrada	zoologia
vertebrado	zoologia
vocativo	lingüística/linguística/lingüística
voluntário	fisiologia
volátil	quimica/química
ácido	quimica/química
ígneo	geologia
