acessar	informática
acta	jurisprudência/lei
administrar	medicina
administração	industria/empresa/negócio/comércio
adquirir	comercialismo/mercantilismo/comércio
advogado	jurisprudência/lei
amanhar	agricultura/pecuária/cultivo
amoldar	arte
amputar	medicina
andada	basebol/beisebol
apagar	gravação
apanhar	basebol/beisebol
arco	arquitetura/arquitectura
articulação	anatomia
articulações	anatomia
ascender	astronomia
assento	dramaturgia/aeroplano/avião/teatro
assimetria	matematica/matemática
astucidade	industria/empresa/negócio/comércio
astúcia	industria/empresa/negócio/comércio
ataque	exército
atestar	jurisprudência/lei
atingir	comercialismo/mercantilismo/comércio
ato	jurisprudência/lei
avionar	aeronave/aeroplano/avião/aviação
baixar	música
batalha	exército
batida	basebol/beisebol
belas-artes	arte
biblioteca	programação
cadeia	quimica/química
cadeira	dramaturgia/aeroplano/avião/teatro
cair	música
calculadora	informática
calcular	matematica/matemática
caminhar	esporte
campanha	exército
cantar	música
capialço	embarcação/navios/navio/barco
capitalista	industria/empresa/negócio/comércio
capturar	basebol/beisebol
casa	dramaturgia/teatro
casal	jurisprudência/lei
casamento	jurisprudência/lei
chamar	telefonia
chutar	esporte
classe	biologia
colisão	física
colorido	fotografia
combate	exército
comensalismo	flora/planta/vegetal
comerciar	comercialismo/mercantilismo/comércio
companhia	exército
compor	autoria
comportamento	psicologia
comprar	comercialismo/mercantilismo/comércio
computador	informática
computar	matematica/matemática
condutas	anatomia
conexão	narcótico
congelar	física
conjunto	matematica/matemática
consagração	religião/fé
conservar	culinária/cozinha/preparação
constituição	jurisprudência/lei
consumo	economia
conúbio	jurisprudência/lei
corpo	criatura/animal/besta/bicho/humano/ser/exército
corromper	crime/ofensa
costa	rio/oceano/lago
costume	psicologia
crescimento	biologia
crónica	história
crônica	história
cultivar	agricultura/pecuária/cultivo
cultivo	agricultura/pecuária
cultura	biologia
curva	rio
cáculo	matematica/matemática
célula	biologia
cónica	geometria
cônica	geometria
dançar	dança/baile
decreto	jurisprudência/lei
deduzir	aritmética
defesa	exército
deletar	gravação
desenhar	arte
desoxidar	quimica/química
difusão	física
diminuir	culinária/cozinha/preparação
dirigir	condução
discurso	linguagem/música/arte/idioma/língua
dispensar	medicina
dividir	aritmética
dono	jurisprudência/lei
empenhar	comercialismo/mercantilismo/comércio
empresa	industria/negócio/comércio
encargo	colectas/impostos/imposto/taxação/taxa/tributo
energia	física
enlatar	culinária/cozinha/preparação
erosão	geologia
escavar	mineração/terraplenagem
escrever	autoria
espião	exército
espécie	biologia
espécies	biologia
esquiar	esporte
estabelecimento	industria/empresa/negócio/comércio
estacionar	condução
estilo	linguagem/música/arte/discurso/idioma/língua
estrela	astronomia
evidenciar	jurisprudência/lei
exposição	arte
exposições	arte
família	biologia
fazer	agricultura/pecuária/cultivo
ferver	culinária/cozinha/preparação
filmar	película/cinema/filme/produção
filo	biologia
flora	planta/vegetal/botanica/botânica
fone	fonética
fonema	fonética
formação	geologia
fornecedor	narcótico
força	física
fotografar	fotografia
frigir	culinária/cozinha/preparação
fritar	culinária/cozinha/preparação
fronte	meteorologia
função	matematica/matemática
galáxia	astronomia
gelar	física
gerar	biologia
gerenciamento	industria/empresa/negócio/comércio
gestão	industria/empresa/negócio/comércio
guerra	exército
género	biologia
hard-drive	informática
hardware	informática
hábito	psicologia
idioma	linguagem/discurso/língua
igreja	serviço
igrejas	serviço
imposto	colectas/impostos/taxação/taxa/tributo
incluir	quimica/química
indústria	manufatura
inferno	cristianismo
jogada	basebol/beisebol
jogo	esporte
julgamento	jurisprudência/lei
jurista	jurisprudência/lei
legislação	jurisprudência/lei
lei	jurisprudência
leis	jurisprudência/lei
limpar	quimica/química
linguagem	música/arte/discurso/idioma/língua
litoral	rio/oceano/lago
lugar	dramaturgia/aeroplano/avião/teatro
luta	exército
luz	física
língua	linguagem/música/arte/discurso/idioma
magnete	física
manobra	exército
marina	armada/marinha
matematica	ciência
matemática	ciência
matrimónio	jurisprudência/lei
matrimônio	jurisprudência/lei
meteoro	astronomia
meteoroide	astronomia
meteoróide	astronomia
microorganismo	criatura/flora/animal/besta/bicho/planta/vegetal/ser
microrganismo	criatura/flora/animal/besta/bicho/planta/vegetal/ser
militar	exército
minar	mineração/terraplenagem
minerar	mineração/terraplenagem
mistura	quimica/química
modelar	arte
molécula	quimica/física/química
mostrar	jurisprudência/lei
musico	música
mutante	biologia
mutantes	biologia
mutação	biologia
música	canção/canto
músico	música
nebulosa	astronomia
negócio	industria/empresa/comércio
obter	comercialismo/mercantilismo/comércio
oficial	exército
onda	física
ontogenia	biologia
ontogénese	biologia
operar	medicina
operação	informática/matematica/matemática/exército
ordem	exército
orla	rio/oceano/lago
ortodoxia	religião/fé
parasita	flora/planta/vegetal
parentesco	antropologia
parte	jurisprudência/música/lei
passear	esporte
pedagogia	didáctica/ensinamento/ensino/educação/instrução/formação
perseguição	religião/fé
pilotar	aeronave/aeroplano/avião/aviação
pincelar	arte
pintar	arte
pixel	informática
planeta	astronomia
plano	matematica/matemática
planta	botanica/botânica
plantar	agricultura/pecuária/cultivo
plasmar	arte
procriar	biologia
produzir	agricultura/pecuária/cultivo
produção	economia
programa	informática
proprietário	jurisprudência/lei
proteção	exército
provar	jurisprudência/lei
pulsação	electrónica/eletronica/eletrónica/eletrônica
píxel	informática
radical	quimica/química
raiz	botanica/botânica
raptar	crime/ofensa
raíz	botanica/botânica
rebatida	basebol/beisebol
reduzir	culinária/cozinha/preparação
registar	gravação
registrar	gravação
registro	jurisprudência/fotografia/lei
relação	antropologia
representar	arte
reproduzir	biologia
revogação	jurisprudência/lei
rodada	jogo
sagacidade	industria/empresa/negócio/comércio
sangue	vertebrado
semear	agricultura/pecuária/cultivo
sentença	jurisprudência/lei
sequestrar	crime/ofensa
seqüestrar	crime/ofensa
seção	música
simetria	matematica/matemática
software	informática
solidificar	física
solução	quimica/química
subir	astronomia
subornar	crime/ofensa
subtrair	aritmética
sucessão	ecologia
tacto	música
tanque	exército
tanques	exército
taxa	colectas/impostos/imposto/taxação/tributo
teatro	dramaturgia
telefonar	telefonia
templo	serviço
tempo	jogo
testemunhar	jurisprudência/lei
testificar	jurisprudência/lei
tocar	música
tostar	culinária/cozinha/preparação
tramitar	comercialismo/mercantilismo/comércio
transaccionar	comercialismo/mercantilismo/comércio
transacionar	comercialismo/mercantilismo/comércio
transladar	geometria
tubo	anatomia
tumores	patologia
turno	basebol/beisebol/jogo
universo	estatística/estatísticas/estatística
valência	quimica/química
vegetal	botanica/botânica
vegetação	flora/planta/vegetal
vender	comercialismo/mercantilismo/comércio
vez	jogo
voar	aeronave/aeroplano/avião/aviação
água	rio/oceano/lago
átomo	quimica/física/química
íman	física
ímã	física
